"","dbgap_study_id","male","female","total","date_study","repository"
"1","phs000219.v1.pht001093.v1.p1",661,1053,1714,"01/19/2010","dbgap"
"2","phs000888.v1.pht005555.v1.p1",2013,1969,3982,"08/12/2016","dbgap"
"3","phs000280.v7.pht004047.v5.p1",270,236,506,"2020/06/18","dbgap"
"4","phs000280.v7.pht004192.v2.p1",6784,8155,14939,"2020/06/18","dbgap"
"5","phs000390.v1.pht002327.v1.p1",408,1209,1617,"04/20/2012","dbgap"
"9","phs002067.v1.pht010409.v1.p1",38,27,65,"2020/10/21","dbgap"
"10","phs000933.v2.pht004776.v2.p1",169,121,290,"2018/03/09","dbgap"
"11","phs001572.v1.pht007842.v1.p1",195,117,312,"2018/04/20","dbgap"
"12","phs001328.v1.pht006311.v1.p1",52,36,88,"05/17/2017","dbgap"
"13","phs001279.v1.pht007207.v1.p1",15,23,38,"2017/12/08","dbgap"
"14","phs000722.v2.pht003900.v2.p2",266,410,676,"05/01/2017","dbgap"
"15","phs001800.v2.pht008928.v2.p1",13,2,15,"2020/12/16","dbgap"
"16","phs001196.v1.pht005699.v1.p1",2788,2408,5196,"2018/04/05","dbgap"
"18","phs000662.v1.pht003559.v1.p1",299,342,641,"12/17/2013","dbgap"
"20","phs000007.v32.pht004365.v5.p13",2543,3002,5545,"2020/12/21","dbgap"
"21","phs000286.v6.pht008736.v1.p2",359,650,1009,"2019/03/11","dbgap"
"22","phs002333.v1.pht010921.v1.p1",4,4,8,"2021/02/04","dbgap"
"23","phs000280.v7.pht006442.v1.p1",6691,7950,14641,"2020/06/18","dbgap"
"24","phs000974.v4.pht004909.v3.p3",1902,2253,4155,"2019/09/26","dbgap"
"26","phs000095.v4.pht001213.v4.p2",1896,2281,4177,"2021/09/13","dbgap"
"27","phs000946.v5.pht005719.v2.p1",23,57,80,"2021/05/07","dbgap"
"28","phs002457.v1.pht011518.v1.p1",1,24,25,"2021/08/30","dbgap"
"29","phs000286.v6.pht008772.v1.p2",1295,2163,3458,"2019/03/11","dbgap"
"30","phs000251.v2.pht001262.v2.p2",65,28,93,"11/22/2013","dbgap"
"31","phs001290.v1.pht010335.v1.p1",3202,2867,6069,"2020/07/29","dbgap"
"32","phs000911.v1.pht004980.v1.p1",8608,8852,17460,"05/06/2016","dbgap"
"33","phs002003.v1.pht010108.v1.p1",19,19,38,"2020/04/06","dbgap"
"34","phs001858.v1.pht009371.v1.p1",7956,9127,17083,"2019/10/25","dbgap"
"35","phs001917.v1.pht009548.v1.p1",454,370,824,"2019/10/22","dbgap"
"36","phs000701.v1.pht005508.v1.p1",37,30,67,"06/01/2017","dbgap"
"37","phs002212.v1.pht010983.v1.p1",16,2,18,"2021/02/22","dbgap"
"39","phs001554.v1.pht007608.v1.p1",1075,1817,2892,"2018/03/09","dbgap"
"40","phs001381.v1.pht006569.v1.p1",352,315,667,"06/19/2017","dbgap"
"41","phs000086.v3.pht000258.v1.p1",191,163,354,"11/04/2014","dbgap"
"42","phs000691.v2.pht003652.v2.p1",291,197,488,"03/11/2015","dbgap"
"43","phs000126.v2.pht005717.v1.p1",1005,985,1990,"08/29/2016","dbgap"
"44","phs001065.v1.pht005434.v1.p1",296,313,609,"05/24/2016","dbgap"
"45","phs001823.v1.pht009056.v1.p1",169,92,261,"2019/08/07","dbgap"
"46","phs001761.v1.pht009028.v1.p1",34,120,154,"2019/05/16","dbgap"
"47","phs001309.v1.pht007912.v1.p1",51,54,105,"2018/05/15","dbgap"
"48","phs001065.v1.pht005401.v1.p1",296,313,609,"05/24/2016","dbgap"
"49","phs000715.v1.pht003744.v1.p1",15,17,32,"03/13/2014","dbgap"
"50","phs000171.v1.pht000755.v1.p1",164,317,481,"12/11/2009","dbgap"
"51","phs000444.v1.pht002701.v1.p1",484,829,1313,"04/19/2012","dbgap"
"52","phs002319.v1.pht010925.v1.p1",716,813,1529,"2021/02/05","dbgap"
"53","phs001771.v1.pht008717.v1.p1",163,280,443,"2021/02/12","dbgap"
"54","phs000756.v1.pht007371.v1.p1",4392,4943,9335,"2018/12/27","dbgap"
"55","phs001348.v2.pht006233.v2.p1",24,21,45,"2017/09/25","dbgap"
"56","phs001342.v1.pht008051.v1.p1",30,16,46,"2018/06/01","dbgap"
"57","phs000219.v1.pht001102.v1.p1",664,1054,1718,"01/19/2010","dbgap"
"58","phs001252.v1.pht006402.v1.p1",1505,990,2495,"05/16/2017","dbgap"
"61","phs001661.v3.pht010558.v2.p1",2791,2673,5464,"2021/08/17","dbgap"
"62","phs001601.v2.pht010664.v2.p2",1271,939,2210,"2021/07/19","dbgap"
"63","phs001230.v1.pht009240.v1.p1",1164,1116,2280,"2019/07/19","dbgap"
"64","phs000983.v1.pht005006.v1.p1",93,419,512,"10/05/2015","dbgap"
"66","phs001245.v1.pht005932.v1.p1",3,2,5,"2018/01/29","dbgap"
"67","phs001318.v1.pht008017.v1.p1",27,13,40,"2018/05/31","dbgap"
"68","phs000998.v2.pht005055.v2.p1",14,20,34,"2020/08/26","dbgap"
"69","phs001787.v1.pht009046.v1.p1",23,28,51,"2020/06/18","dbgap"
"70","phs001594.v1.pht008144.v1.p1",15,23,38,"2018/06/18","dbgap"
"71","phs001814.v1.pht009004.v1.p1",149,130,279,"2019/06/03","dbgap"
"72","phs001848.v1.pht009204.v1.p1",1,2,3,"2019/06/24","dbgap"
"73","phs001852.v1.pht009275.v1.p1",225,192,417,"2019/07/26","dbgap"
"74","phs000404.v1.pht002366.v1.p1",81,88,169,"12/13/2011","dbgap"
"75","phs000128.v3.pht000503.v2.p3",2943,3500,6443,"04/29/2016","dbgap"
"76","phs000713.v1.pht004272.v1.p1",328,380,708,"10/16/2014","dbgap"
"77","phs000742.v1.pht008107.v1.p1",1497,1789,3286,"2018/07/23","dbgap"
"78","phs001407.v1.pht006665.v1.p1",1,10,11,"2017/08/25","dbgap"
"79","phs000574.v1.pht005870.v1.p1",41,938,979,"03/06/2017","dbgap"
"80","phs000285.v3.pht001752.v2.p2",45,63,108,"08/20/2013","dbgap"
"81","phs000209.v13.pht004323.v1.p3",2677,2924,5601,"11/05/2014","dbgap"
"82","phs001410.v1.pht008424.v1.p1",106,194,300,"2018/09/26","dbgap"
"83","phs001758.v1.pht008610.v1.p1",2,8,10,"2018/12/31","dbgap"
"84","phs001490.v1.pht008137.v1.p1",1065,1522,2587,"2018/06/13","dbgap"
"86","phs000286.v6.pht008786.v1.p2",939,1570,2509,"2019/03/11","dbgap"
"88","phs000948.v1.pht004849.v1.p1",684,1284,1968,"08/26/2015","dbgap"
"89","phs001071.v1.pht005347.v1.p1",21,16,37,"2017/09/27","dbgap"
"91","phs000228.v4.pht001184.v3.p1",149,151,300,"03/21/2017","dbgap"
"93","phs001095.v1.pht005619.v1.p1",421,437,858,"09/28/2016","dbgap"
"94","phs000718.v1.pht003839.v1.p1",1243,1187,2430,"06/09/2015","dbgap"
"96","phs001384.v1.pht006741.v1.p1",20,11,31,"2017/08/02","dbgap"
"97","phs000128.v3.pht000440.v2.p3",2943,3500,6443,"04/29/2016","dbgap"
"98","phs000086.v3.pht000276.v1.p1",746,674,1420,"11/04/2014","dbgap"
"99","phs001038.v1.pht005208.v1.p1",9,11,20,"02/23/2016","dbgap"
"100","phs001860.v1.pht009454.v1.p1",86,120,206,"2020/05/15","dbgap"
"102","phs001910.v1.pht009538.v1.p1",22,24,46,"2019/10/15","dbgap"
"103","phs000630.v1.pht003384.v1.p1",466,480,946,"04/29/2014","dbgap"
"104","phs001191.v1.pht006224.v1.p1",312,588,900,"03/29/2017","dbgap"
"106","phs001330.v2.pht007537.v2.p1",25,15,40,"2019/11/08","dbgap"
"107","phs000910.v1.pht004728.v1.p1",4063,3942,8005,"08/20/2015","dbgap"
"109","phs001718.v1.pht009424.v1.p1",1240,855,2095,"2019/09/16","dbgap"
"110","phs000609.v1.pht003283.v1.p1",18,9,27,"05/14/2013","dbgap"
"111","phs002315.v1.pht011314.v1.p1",6,2,8,"2021/08/18","dbgap"
"112","phs001803.v1.pht008939.v1.p1",223,696,919,"2019/04/04","dbgap"
"113","phs001519.v1.pht008433.v1.p1",4,6,10,"2018/10/02","dbgap"
"114","phs001736.v1.pht009330.v1.p1",1504,881,2385,"2019/07/29","dbgap"
"115","phs001881.v1.pht010564.v1.p1",2839,1545,4384,"2020/10/01","dbgap"
"116","phs000007.v32.pht000200.v4.p13",97,99,196,"2020/12/21","dbgap"
"117","phs000126.v2.pht000365.v2.p1",1032,1020,2052,"08/29/2016","dbgap"
"118","phs001575.v2.pht009606.v1.p1",16,26,42,"2019/11/12","dbgap"
"119","phs001649.v1.pht008517.v1.p1",299,170,469,"2019/02/19","dbgap"
"121","phs002377.v1.pht011115.v1.p1",19,17,36,"2021/04/07","dbgap"
"123","phs000343.v3.pht003150.v1.p1",579,332,911,"03/12/2013","dbgap"
"124","phs000687.v1.pht003693.v1.p1",905,921,1826,"06/13/2014","dbgap"
"126","phs000509.v1.pht004312.v1.p1",60,28,88,"02/18/2015","dbgap"
"127","phs001512.v1.pht007665.v1.p1",7,10,17,"2018/03/21","dbgap"
"128","phs000280.v7.pht004099.v2.p1",512,614,1126,"2020/06/18","dbgap"
"129","phs000824.v1.pht005138.v1.p1",37,63,100,"11/24/2015","dbgap"
"130","phs000280.v7.pht004100.v5.p1",1224,1399,2623,"2020/06/18","dbgap"
"131","phs001080.v1.pht005370.v1.p1",62,41,103,"04/06/2016","dbgap"
"132","phs001998.v1.pht010505.v1.p1",4,6,10,"2021/06/07","dbgap"
"133","phs000007.v32.pht004363.v4.p13",1267,1535,2802,"2020/12/21","dbgap"
"134","phs000263.v1.pht001236.v1.p1",40,54,94,"06/14/2010","dbgap"
"135","phs001154.v1.pht008375.v1.p1",7278,3340,10618,"2018/09/17","dbgap"
"136","phs000128.v3.pht000552.v2.p3",2943,3500,6443,"04/29/2016","dbgap"
"137","phs000416.v2.pht008143.v1.p1",1722,1844,3566,"2018/07/06","dbgap"
"138","phs000553.v1.pht003133.v1.p1",1,4,5,"06/26/2013","dbgap"
"139","phs000285.v3.pht001638.v2.p2",908,1032,1940,"08/20/2013","dbgap"
"140","phs001940.v2.pht009699.v2.p1",19,17,36,"2020/01/31","dbgap"
"141","phs000128.v3.pht000423.v2.p3",2943,3500,6443,"04/29/2016","dbgap"
"143","phs000007.v32.pht002429.v1.p13",702,943,1645,"2020/12/21","dbgap"
"144","phs000016.v2.pht000049.v2.p2",802,122,924,"11/27/2009","dbgap"
"145","phs000144.v1.pht000721.v1.p1",165,216,381,"Wed Jan 21 13:20:39 2009","dbgap"
"146","phs000007.v32.pht005153.v3.p13",1459,1552,3011,"2020/12/21","dbgap"
"147","phs001727.v2.pht010103.v1.p1",29,44,73,"2021/08/26","dbgap"
"148","phs000007.v32.pht010754.v1.p13",968,1185,2153,"2020/12/21","dbgap"
"150","phs001933.v1.pht011511.v1.p1",89,24,113,"2021/08/30","dbgap"
"151","phs001074.v1.pht005342.v1.p1",115,135,250,"03/15/2016","dbgap"
"152","phs000617.v1.pht005476.v1.p1",162,128,290,"05/19/2016","dbgap"
"153","phs001778.v1.pht009830.v1.p1",5,6,11,"2020/07/16","dbgap"
"154","phs001348.v2.pht006235.v2.p1",24,21,45,"2017/09/25","dbgap"
"155","phs000895.v1.pht005070.v1.p1",88,72,160,"04/01/2016","dbgap"
"156","phs000268.v1.pht002166.v1.p1",85,96,181,"02/24/2011","dbgap"
"157","phs001446.v2.pht009627.v1.p1",713,1144,1857,"2021/06/24","dbgap"
"158","phs000287.v7.pht001481.v1.p1",2375,3156,5531,"2020/01/23","dbgap"
"159","phs000286.v6.pht001947.v2.p2",1034,1810,2844,"2019/03/11","dbgap"
"160","phs001852.v1.pht009278.v1.p1",216,188,404,"2019/07/26","dbgap"
"161","phs000872.v1.pht004574.v1.p1",18,6,24,"03/24/2015","dbgap"
"162","phs000196.v3.pht004623.v1.p1",2128,1880,4008,"03/24/2015","dbgap"
"163","phs000594.v1.pht006497.v1.p1",3,1,4,"06/12/2017","dbgap"
"164","phs000219.v1.pht001104.v1.p1",664,1054,1718,"01/19/2010","dbgap"
"165","phs002048.v2.pht010314.v1.p1",4,54,58,"2021/03/17","dbgap"
"166","phs000007.v32.pht007771.v3.p13",1439,1696,3135,"2020/12/21","dbgap"
"167","phs000776.v1.pht003949.v1.p1",7,26,33,"08/04/2014","dbgap"
"168","phs001471.v1.pht009800.v1.p1",189,475,664,"2020/01/10","dbgap"
"169","phs001046.v1.pht005296.v1.p1",32,67,99,"2018/06/01","dbgap"
"170","phs000737.v1.pht004444.v1.p1",815,839,1654,"01/29/2015","dbgap"
"171","phs000222.v6.pht002872.v3.p2",535,950,1485,"2019/08/01","dbgap"
"173","phs001485.v2.pht007186.v2.p1",11,13,24,"2021/03/10","dbgap"
"175","phs000455.v1.pht002577.v1.p1",7,3,10,"06/20/2012","dbgap"
"176","phs000007.v32.pht004807.v3.p13",1145,1386,2531,"2020/12/21","dbgap"
"177","phs000128.v3.pht000416.v2.p3",2943,3500,6443,"04/29/2016","dbgap"
"178","phs000007.v32.pht001043.v7.p13",1872,2131,4003,"2020/12/21","dbgap"
"179","phs001045.v1.pht009260.v1.p1",169,154,323,"2019/07/25","dbgap"
"180","phs000086.v3.pht000252.v1.p1",738,650,1388,"11/04/2014","dbgap"
"181","phs000618.v1.pht003304.v1.p1",2046,2304,4350,"10/24/2013","dbgap"
"182","phs000094.v1.pht001134.v1.p1",4000,3507,7507,"04/12/2010","dbgap"
"186","phs001990.v1.pht010017.v1.p1",87,192,279,"2020/03/19","dbgap"
"187","phs000286.v6.pht008766.v1.p2",60,108,168,"2019/03/11","dbgap"
"188","phs001662.v2.pht010074.v1.p1",843,758,1601,"2021/08/19","dbgap"
"189","phs001168.v2.pht007577.v2.p2",755,623,1378,"2019/03/19","dbgap"
"190","phs001011.v2.pht005533.v1.p1",935,633,1568,"2020/07/21","dbgap"
"191","phs001900.v1.pht009632.v1.p1",123,96,219,"2020/03/02","dbgap"
"192","phs000286.v6.pht008788.v1.p2",850,1514,2364,"2019/03/11","dbgap"
"193","phs000571.v3.pht003178.v3.p2",148,100,248,"12/01/2015","dbgap"
"194","phs000007.v32.pht010738.v1.p13",89,75,164,"2020/12/21","dbgap"
"195","phs000916.v1.pht004736.v1.p1",516,283,799,"07/26/2016","dbgap"
"197","phs002417.v1.pht011273.v1.p1",1578,1507,3085,"2021/06/03","dbgap"
"198","phs000257.v3.pht001249.v3.p1",29,33,62,"2018/09/19","dbgap"
"199","phs001814.v1.pht009007.v1.p1",149,130,279,"2019/06/03","dbgap"
"200","phs000020.v2.pht000668.v1.p1",1291,2449,3740,"Mon Oct 27 16:32:34 2008","dbgap"
"201","phs001841.v1.pht009905.v1.p1",732,619,1351,"2020/06/02","dbgap"
"203","phs002023.v1.pht010194.v1.p1",3,11,14,"2020/05/06","dbgap"
"204","phs000171.v1.pht000764.v1.p1",636,1284,1920,"12/11/2009","dbgap"
"205","phs000999.v3.pht005182.v3.p1",130,112,242,"2019/11/22","dbgap"
"209","phs002433.v1.pht011258.v1.p1",22,16,38,"2021/05/27","dbgap"
"211","phs000128.v3.pht000505.v2.p3",2943,3500,6443,"04/29/2016","dbgap"
"212","phs001311.v1.pht007935.v1.p1",35,26,61,"2018/05/15","dbgap"
"213","phs001062.v5.pht005261.v3.p2",793,206,999,"2021/05/21","dbgap"
"215","phs000340.v3.pht002208.v2.p1",73,33,106,"04/10/2014","dbgap"
"216","phs000266.v4.pht001264.v4.p1",71,43,114,"09/09/2013","dbgap"
"217","phs001278.v1.pht006269.v1.p1",83,111,194,"06/16/2017","dbgap"
"220","phs001419.v1.pht007096.v1.p1",215,213,428,"2017/12/04","dbgap"
"221","phs001173.v1.pht005670.v1.p1",2521,812,3333,"2017/09/15","dbgap"
"222","phs000128.v3.pht000414.v2.p3",2943,3500,6443,"04/29/2016","dbgap"
"223","phs000767.v1.pht003929.v1.p1",37,12,49,"07/03/2014","dbgap"
"224","phs000652.v1.pht003456.v1.p1",4326,2485,6811,"09/03/2013","dbgap"
"225","phs002506.v1.pht011537.v1.p1",4037,3056,7093,"2021/09/29","dbgap"
"226","phs001278.v1.pht006267.v1.p1",85,111,196,"06/16/2017","dbgap"
"227","phs001769.v1.pht008627.v1.p1",4,2,6,"2019/01/17","dbgap"
"228","phs000789.v1.pht004291.v1.p1",998,1409,2407,"10/21/2015","dbgap"
"229","phs000949.v1.pht005225.v1.p1",1310,1847,3157,"02/08/2016","dbgap"
"231","phs000620.v1.pht003895.v1.p1",2722,3549,6271,"03/03/2015","dbgap"
"232","phs001021.v1.pht005265.v1.p1",136,274,410,"02/01/2016","dbgap"
"233","phs001899.v2.pht009568.v2.p1",915,1025,1940,"2020/11/02","dbgap"
"234","phs000286.v6.pht001942.v2.p2",92,176,268,"2019/03/11","dbgap"
"235","phs001607.v3.pht010149.v3.p2",2535,1114,3649,"2021/07/29","dbgap"
"236","phs001311.v1.pht007934.v1.p1",34,26,60,"2018/05/15","dbgap"
"237","phs001662.v2.pht010057.v1.p1",843,758,1601,"2021/08/19","dbgap"
"238","phs000902.v1.pht004668.v1.p1",607,177,784,"01/20/2016","dbgap"
"240","phs000128.v3.pht000436.v2.p3",2943,3500,6443,"04/29/2016","dbgap"
"242","phs001733.v1.pht008618.v1.p1",7,10,17,"2019/01/07","dbgap"
"243","phs001331.v2.pht006925.v2.p1",452,296,748,"2019/08/30","dbgap"
"244","phs000895.v1.pht005071.v1.p1",88,72,160,"04/01/2016","dbgap"
"245","phs001238.v2.pht006651.v1.p1",262,363,625,"2018/06/14","dbgap"
"246","phs000280.v7.pht004133.v2.p1",6120,7410,13530,"2020/06/18","dbgap"
"248","phs000983.v1.pht005007.v1.p1",93,419,512,"10/05/2015","dbgap"
"249","phs000128.v3.pht000544.v2.p3",2943,3500,6443,"04/29/2016","dbgap"
"250","phs001833.v1.pht009150.v1.p1",134,165,299,"2019/06/14","dbgap"
"251","phs000590.v1.pht008260.v1.p1",33,36,69,"2018/08/03","dbgap"
"252","phs000578.v1.pht007017.v1.p1",49,45,94,"2017/10/11","dbgap"
"253","phs001008.v1.pht005108.v1.p1",913,988,1901,"11/13/2015","dbgap"
"254","phs000362.v1.pht003228.v1.p1",13,2,15,"08/26/2013","dbgap"
"255","phs000987.v1.pht004967.v1.p1",101,83,184,"04/05/2017","dbgap"
"256","phs000128.v3.pht000478.v2.p3",2943,3500,6443,"04/29/2016","dbgap"
"257","phs000495.v1.pht002865.v1.p1",601,426,1027,"08/22/2012","dbgap"
"258","phs000459.v1.pht004746.v1.p1",64,51,115,"01/07/2016","dbgap"
"259","phs000588.v1.pht009306.v1.p1",2,6,8,"2019/07/26","dbgap"
"260","phs001272.v1.pht007303.v1.p1",550,481,1031,"2018/11/16","dbgap"
"261","phs000561.v1.pht003033.v1.p1",6,5,11,"11/05/2012","dbgap"
"262","phs000698.v1.pht007678.v1.p1",4,9,13,"2018/03/23","dbgap"
"263","phs000285.v3.pht001860.v2.p2",152,181,333,"08/20/2013","dbgap"
"264","phs000789.v1.pht004288.v1.p1",1065,1477,2542,"10/21/2015","dbgap"
"267","phs001682.v2.pht009762.v1.p1",220,212,432,"2021/08/06","dbgap"
"268","phs001552.v1.pht008393.v1.p1",1329,497,1826,"2018/09/21","dbgap"
"269","phs001721.v1.pht009720.v1.p1",2234,2574,4808,"2020/02/04","dbgap"
"270","phs000592.v1.pht006600.v1.p1",34,32,66,"07/12/2017","dbgap"
"271","phs001232.v4.pht006078.v4.p2",2069,2169,4238,"2021/08/23","dbgap"
"272","phs001373.v2.pht006701.v2.p2",18,15,33,"2019/10/16","dbgap"
"273","phs001619.v3.pht008176.v3.p1",210,215,425,"2021/03/10","dbgap"
"274","phs001424.v1.pht006999.v1.p1",7,5,12,"2017/10/10","dbgap"
"275","phs001512.v1.pht007668.v1.p1",7,10,17,"2018/03/21","dbgap"
"277","phs000336.v1.pht002218.v1.p1",9338,2179,11517,"04/21/2011","dbgap"
"278","phs001235.v1.pht008448.v1.p1",2,3,5,"2019/03/21","dbgap"
"279","phs000287.v7.pht003701.v2.p1",671,1512,2183,"2020/01/23","dbgap"
"281","phs000285.v3.pht001807.v2.p2",874,980,1854,"08/20/2013","dbgap"
"282","phs002464.v1.pht011332.v1.p1",12,4,16,"2021/07/21","dbgap"
"283","phs000285.v3.pht001874.v1.p2",1,6,7,"08/20/2013","dbgap"
"285","phs000128.v3.pht000452.v2.p3",2943,3500,6443,"04/29/2016","dbgap"
"286","phs000285.v3.pht001758.v2.p2",867,970,1837,"08/20/2013","dbgap"
"287","phs000701.v1.pht005517.v1.p1",48,43,91,"06/01/2017","dbgap"
"288","phs001927.v1.pht011580.v1.p1",1224,1075,2299,"2021/09/24","dbgap"
"289","phs000285.v3.pht001697.v2.p2",947,1065,2012,"08/20/2013","dbgap"
"290","phs001024.v5.pht005116.v2.p1",84,44,128,"2021/05/20","dbgap"
"291","phs000698.v1.pht007680.v1.p1",17,31,48,"2018/03/23","dbgap"
"292","phs000572.v8.pht004306.v5.p4",4582,6331,10913,"2019/11/19","dbgap"
"293","phs001793.v1.pht008900.v1.p1",21,12,33,"2020/08/04","dbgap"
"294","phs000804.v1.pht005376.v1.p1",53,49,102,"09/06/2016","dbgap"
"297","phs001522.v1.pht007728.v1.p1",1915,1898,3813,"2018/04/05","dbgap"
"298","phs000581.v1.pht003205.v1.p1",22,29,51,"06/04/2013","dbgap"
"299","phs002319.v1.pht010926.v1.p1",716,813,1529,"2021/02/05","dbgap"
"300","phs001576.v2.pht008218.v2.p2",35,17,52,"2019/09/27","dbgap"
"301","phs000206.v5.pht003729.v2.p3",4813,4624,9437,"08/18/2015","dbgap"
"302","phs001612.v1.pht009498.v1.p1",811,943,1754,"2019/11/13","dbgap"
"305","phs001331.v2.pht006936.v2.p1",542,362,904,"2019/08/30","dbgap"
"306","phs000888.v1.pht005584.v1.p1",6319,7428,13747,"08/12/2016","dbgap"
"309","phs001534.v1.pht008518.v1.p1",26,4402,4428,"2019/09/16","dbgap"
"310","phs001982.v1.pht010003.v1.p1",26,36,62,"2020/03/19","dbgap"
"311","phs001468.v3.pht009555.v1.p1",1298,1450,2748,"2021/09/23","dbgap"
"312","phs000007.v32.pht003462.v4.p13",1570,1782,3352,"2020/12/21","dbgap"
"313","phs000791.v2.pht004593.v1.p1",21,23,44,"2020/01/10","dbgap"
"314","phs000280.v7.pht004102.v5.p1",1224,1399,2623,"2020/06/18","dbgap"
"315","phs001272.v1.pht007302.v1.p1",550,481,1031,"2018/11/16","dbgap"
"316","phs000745.v1.pht003848.v1.p1",10,10,20,"05/19/2014","dbgap"
"317","phs000540.v1.pht003047.v1.p1",5,3,8,"11/08/2012","dbgap"
"318","phs000209.v13.pht003610.v1.p3",2747,2884,5631,"11/05/2014","dbgap"
"319","phs001398.v1.pht007140.v1.p1",1734,256,1990,"2018/08/06","dbgap"
"320","phs000888.v1.pht005560.v1.p1",423,429,852,"08/12/2016","dbgap"
"321","phs000343.v3.pht003146.v1.p1",66,34,100,"03/12/2013","dbgap"
"323","phs000007.v32.pht010750.v1.p13",4989,6140,11129,"2020/12/21","dbgap"
"324","phs002003.v1.pht010106.v1.p1",19,19,38,"2020/04/06","dbgap"
"325","phs001326.v1.pht007832.v1.p1",20,3,23,"2018/04/16","dbgap"
"326","phs000771.v2.pht003981.v2.p1",72,29,101,"2017/10/25","dbgap"
"327","phs000742.v1.pht008122.v1.p1",975,1000,1975,"2018/07/23","dbgap"
"328","phs000575.v2.pht005900.v2.p1",176,213,389,"2020/02/14","dbgap"
"329","phs000955.v1.pht005449.v1.p1",1744,2385,4129,"06/09/2016","dbgap"
"330","phs000007.v32.pht002347.v2.p13",242,203,445,"2020/12/21","dbgap"
"331","phs002392.v1.pht011254.v1.p1",18,23,41,"2021/07/13","dbgap"
"332","phs000007.v32.pht000903.v4.p13",666,745,1411,"2020/12/21","dbgap"
"333","phs000577.v1.pht007269.v1.p1",174,341,515,"2017/12/20","dbgap"
"334","phs000128.v3.pht000407.v2.p3",2943,3500,6443,"04/29/2016","dbgap"
"335","phs001065.v1.pht005412.v1.p1",160,186,346,"05/24/2016","dbgap"
"336","phs000101.v5.pht008311.v1.p1",7015,5214,12229,"2018/08/19","dbgap"
"337","phs000128.v3.pht000572.v2.p3",2943,3500,6443,"04/29/2016","dbgap"
"339","phs001455.v1.pht007760.v1.p1",1905,3890,5795,"2018/04/04","dbgap"
"340","phs001418.v1.pht007237.v1.p1",13,20,33,"2018/11/15","dbgap"
"341","phs000287.v7.pht001482.v1.p1",2375,3156,5531,"2020/01/23","dbgap"
"342","phs000286.v6.pht008784.v1.p2",934,1562,2496,"2019/03/11","dbgap"
"343","phs001284.v1.pht009032.v1.p1",125,92,217,"2019/05/09","dbgap"
"344","phs000280.v7.pht004115.v2.p1",4883,6019,10902,"2020/06/18","dbgap"
"345","phs001039.v1.pht005847.v1.p1",15144,20214,35358,"10/19/2016","dbgap"
"346","phs000219.v1.pht001098.v1.p1",359,500,859,"01/19/2010","dbgap"
"347","phs001375.v2.pht006520.v1.p1",408,628,1036,"2021/03/22","dbgap"
"348","phs001570.v2.pht007869.v2.p1",2,275,277,"2020/04/14","dbgap"
"349","phs001737.v2.pht008562.v2.p1",2,1,3,"2019/09/18","dbgap"
"350","phs000234.v2.pht007980.v1.p2",1609,2137,3746,"2018/05/29","dbgap"
"352","phs000209.v13.pht004326.v1.p3",456,494,950,"11/05/2014","dbgap"
"353","phs000001.v3.pht002478.v1.p1",1638,2124,3762,"02/24/2012","dbgap"
"354","phs000354.v1.pht003349.v1.p1",1,11,12,"06/25/2013","dbgap"
"357","phs000286.v6.pht008764.v1.p2",1009,1780,2789,"2019/03/11","dbgap"
"358","phs000144.v1.pht000722.v1.p1",165,216,381,"Wed Jan 21 13:20:40 2009","dbgap"
"359","phs000280.v7.pht006431.v1.p1",6700,7978,14678,"2020/06/18","dbgap"
"360","phs000287.v7.pht001462.v1.p1",2375,3156,5531,"2020/01/23","dbgap"
"361","phs001065.v1.pht005397.v1.p1",4,12,16,"05/24/2016","dbgap"
"362","phs000572.v8.pht003390.v5.p4",6887,8743,15630,"2019/11/19","dbgap"
"363","phs000285.v3.pht001776.v2.p2",16,24,40,"08/20/2013","dbgap"
"364","phs002291.v1.pht010802.v1.p1",4,1,5,"2021/01/21","dbgap"
"365","phs000670.v1.pht003555.v1.p1",194,335,529,"01/22/2014","dbgap"
"366","phs000007.v32.pht000682.v7.p13",1374,1628,3002,"2020/12/21","dbgap"
"367","phs000128.v3.pht000583.v2.p3",2943,3500,6443,"04/29/2016","dbgap"
"368","phs000007.v32.pht000146.v8.p13",1521,1754,3275,"2020/12/21","dbgap"
"371","phs001854.v1.pht009252.v1.p1",3,3,6,"2019/10/07","dbgap"
"372","phs000007.v32.pht010732.v1.p13",103,163,266,"2020/12/21","dbgap"
"373","phs000576.v1.pht006139.v1.p1",116,128,244,"05/24/2017","dbgap"
"374","phs001279.v1.pht007204.v1.p1",15,23,38,"2017/12/08","dbgap"
"375","phs000286.v6.pht001977.v2.p2",1293,2159,3452,"2019/03/11","dbgap"
"376","phs000751.v1.pht003866.v1.p1",1090,526,1616,"05/30/2014","dbgap"
"377","phs001943.v1.pht009712.v1.p1",14,20,34,"2019/12/17","dbgap"
"378","phs001748.v1.pht008577.v1.p1",7,14,21,"2021/02/04","dbgap"
"379","phs000199.v1.pht000890.v1.p1",922,1104,2026,"01/06/2010","dbgap"
"380","phs001266.v2.pht007222.v2.p1",384,261,645,"2020/03/09","dbgap"
"381","phs000622.v1.pht003954.v1.p1",1559,1948,3507,"07/25/2014","dbgap"
"382","phs001539.v1.pht007523.v1.p1",44,57,101,"2018/02/27","dbgap"
"383","phs000284.v2.pht001901.v1.p1",663,810,1473,"2018/09/26","dbgap"
"384","phs000592.v1.pht006591.v1.p1",171,141,312,"07/12/2017","dbgap"
"385","phs000928.v1.pht004937.v1.p1",3,8,11,"01/13/2016","dbgap"
"386","phs000280.v7.pht004135.v2.p1",4883,6019,10902,"2020/06/18","dbgap"
"387","phs001959.v1.pht009952.v1.p1",2,3,5,"2020/03/05","dbgap"
"389","phs000292.v1.pht001525.v1.p1",7,8,15,"07/15/2010","dbgap"
"390","phs000286.v6.pht008751.v1.p2",1009,1780,2789,"2019/03/11","dbgap"
"391","phs001498.v1.pht007323.v1.p1",346,332,678,"2018/03/20","dbgap"
"392","phs002407.v1.pht011356.v1.p1",31,31,62,"2021/09/20","dbgap"
"394","phs001664.v1.pht008438.v1.p1",827,392,1219,"2018/10/02","dbgap"
"395","phs000285.v3.pht001584.v2.p2",947,1065,2012,"08/20/2013","dbgap"
"397","phs001565.v1.pht007896.v1.p1",39,32,71,"2018/05/10","dbgap"
"401","phs001856.v1.pht009599.v1.p1",4948,4976,9924,"2020/08/05","dbgap"
"402","phs000280.v7.pht004236.v2.p1",6119,7408,13527,"2020/06/18","dbgap"
"405","phs001235.v1.pht008445.v1.p1",2,3,5,"2019/03/21","dbgap"
"406","phs000280.v7.pht004029.v2.p1",6784,8156,14940,"2020/06/18","dbgap"
"409","phs001425.v1.pht006754.v1.p1",22,12,34,"2017/08/09","dbgap"
"410","phs002410.v1.pht011553.v1.p1",500,313,813,"2021/09/14","dbgap"
"411","phs001647.v1.pht008198.v1.p1",331,183,514,"2018/08/19","dbgap"
"414","phs001327.v2.pht006558.v2.p1",16132,14584,30716,"2021/05/07","dbgap"
"415","phs002063.v1.pht010404.v1.p1",21,13,34,"2020/07/24","dbgap"
"416","phs000892.v2.pht004631.v2.p2",5,9,14,"09/29/2015","dbgap"
"417","phs002377.v1.pht011113.v1.p1",19,17,36,"2021/04/07","dbgap"
"419","phs000658.v1.pht003499.v1.p1",493,945,1438,"01/13/2014","dbgap"
"420","phs000712.v1.pht003710.v1.p1",382,251,633,"09/25/2015","dbgap"
"421","phs002015.v1.pht010388.v1.p1",235,339,574,"2020/09/18","dbgap"
"423","phs001624.v2.pht008229.v2.p2",1507,1159,2666,"2021/07/29","dbgap"
"424","phs000280.v7.pht004138.v2.p1",11,15,26,"2020/06/18","dbgap"
"425","phs000641.v1.pht003477.v1.p1",10,5,15,"08/21/2013","dbgap"
"427","phs000372.v1.pht002858.v1.p1",2595,3470,6065,"02/13/2014","dbgap"
"429","phs001662.v2.pht010059.v1.p1",843,758,1601,"2021/08/19","dbgap"
"430","phs000285.v3.pht001614.v2.p2",10,19,29,"08/20/2013","dbgap"
"432","phs001550.v2.pht007504.v1.p1",40,35,75,"2018/10/22","dbgap"
"433","phs000007.v32.pht010744.v1.p13",1755,1996,3751,"2020/12/21","dbgap"
"434","phs001858.v1.pht009372.v1.p1",7956,9127,17083,"2019/10/25","dbgap"
"435","phs001041.v1.pht005392.v1.p1",39,25,64,"06/09/2016","dbgap"
"436","phs000128.v3.pht000364.v2.p3",1849,2114,3963,"04/29/2016","dbgap"
"437","phs001743.v1.pht008922.v1.p1",23,3,26,"2019/03/28","dbgap"
"438","phs001058.v1.pht005235.v1.p1",306,197,503,"01/25/2016","dbgap"
"439","phs001195.v1.pht006860.v1.p1",10,3,13,"2018/03/27","dbgap"
"440","phs001435.v2.pht009874.v1.p1",79,41,120,"2021/06/23","dbgap"
"441","phs002015.v1.pht010379.v1.p1",1816,2387,4203,"2020/09/18","dbgap"
"443","phs000280.v7.pht004075.v2.p1",6105,7385,13490,"2020/06/18","dbgap"
"444","phs001005.v2.pht005038.v2.p1",3,1,4,"2019/11/01","dbgap"
"445","phs000961.v1.pht005332.v1.p1",1431,1634,3065,"03/07/2016","dbgap"
"446","phs000185.v7.pht003718.v2.p1",54,85,139,"2020/04/29","dbgap"
"447","phs002024.v1.pht010231.v1.p1",271,228,499,"2020/05/13","dbgap"
"448","phs000577.v1.pht007277.v1.p1",40,68,108,"2017/12/20","dbgap"
"449","phs000925.v1.pht005178.v1.p1",4946,8067,13013,"03/22/2017","dbgap"
"451","phs000414.v1.pht002730.v1.p1",9,8,17,"05/11/2012","dbgap"
"452","phs000280.v7.pht004074.v2.p1",6743,8110,14853,"2020/06/18","dbgap"
"453","phs000285.v3.pht001757.v2.p2",868,971,1839,"08/20/2013","dbgap"
"454","phs001551.v1.pht008347.v1.p1",49,52,101,"2018/09/07","dbgap"
"455","phs000657.v1.pht003494.v1.p1",6,3,9,"08/30/2013","dbgap"
"456","phs000936.v1.pht004891.v1.p1",3623,2240,5863,"11/10/2015","dbgap"
"457","phs002632.v1.pht011606.v1.p1",242,607,849,"2021/10/19","dbgap"
"458","phs000285.v3.pht001717.v2.p2",888,980,1868,"08/20/2013","dbgap"
"460","phs000888.v1.pht005563.v1.p1",2869,2866,5735,"08/12/2016","dbgap"
"461","phs000903.v1.pht004870.v1.p1",1395,1693,3088,"10/14/2015","dbgap"
"462","phs000280.v7.pht004028.v2.p1",6784,8156,14940,"2020/06/18","dbgap"
"464","phs000814.v1.pht004583.v1.p1",3187,405,3592,"01/07/2016","dbgap"
"467","phs000588.v1.pht009309.v1.p1",42,149,191,"2019/07/26","dbgap"
"468","phs000576.v1.pht006142.v1.p1",12,23,35,"05/24/2017","dbgap"
"469","phs000364.v2.pht002261.v2.p1",26,16,42,"09/24/2013","dbgap"
"470","phs001598.v2.pht009995.v1.p1",222,68,290,"2021/06/28","dbgap"
"471","phs000823.v1.pht005047.v1.p1",178,209,387,"05/11/2016","dbgap"
"473","phs000313.v4.pht002067.v4.p2",856,1249,2105,"2017/11/22","dbgap"
"474","phs000576.v1.pht006153.v1.p1",79,89,168,"05/24/2017","dbgap"
"475","phs000017.v3.pht000317.v1.p1",237,243,480,"Wed Nov 26 07:45:57 2008","dbgap"
"476","phs001194.v3.pht005820.v2.p2",61,67,128,"2020/07/24","dbgap"
"477","phs000171.v1.pht000760.v1.p1",636,1284,1920,"12/11/2009","dbgap"
"478","phs001432.v1.pht006979.v1.p1",4,2,6,"2017/10/05","dbgap"
"479","phs002428.v1.pht011268.v1.p1",72,137,209,"2021/06/02","dbgap"
"480","phs000287.v7.pht001470.v1.p1",2375,3156,5531,"2020/01/23","dbgap"
"481","phs000461.v1.pht003684.v1.p1",41,29,70,"02/12/2014","dbgap"
"482","phs001796.v1.pht008834.v1.p1",29,49,78,"2019/03/18","dbgap"
"483","phs001422.v2.pht006758.v2.p1",23,13,36,"2021/02/08","dbgap"
"484","phs001770.v1.pht008683.v1.p1",196,160,356,"2019/02/01","dbgap"
"485","phs001564.v3.pht007989.v3.p1",49,41,90,"2020/02/13","dbgap"
"486","phs000280.v7.pht004132.v2.p1",6783,8156,14939,"2020/06/18","dbgap"
"487","phs001327.v2.pht011189.v1.p1",13724,11941,25665,"2021/05/07","dbgap"
"488","phs002632.v1.pht011608.v1.p1",242,607,849,"2021/10/19","dbgap"
"489","phs001252.v1.pht006400.v1.p1",1691,1055,2746,"05/16/2017","dbgap"
"490","phs000832.v1.pht004423.v1.p1",199,182,381,"03/31/2015","dbgap"
"491","phs002327.v1.pht010915.v1.p1",11,13,24,"2021/02/02","dbgap"
"492","phs002048.v2.pht010316.v1.p1",4,54,58,"2021/03/17","dbgap"
"494","phs001232.v4.pht006076.v4.p2",2430,2384,4814,"2021/08/23","dbgap"
"495","phs002286.v1.pht010634.v1.p1",1,5,6,"2020/11/19","dbgap"
"496","phs000280.v7.pht004085.v2.p1",185,99,284,"2020/06/18","dbgap"
"498","phs001331.v2.pht006930.v2.p1",517,342,859,"2019/08/30","dbgap"
"499","phs000698.v1.pht007686.v1.p1",7,13,20,"2018/03/23","dbgap"
"503","phs000699.v1.pht004382.v1.p1",29,29,58,"12/12/2014","dbgap"
"504","phs000701.v1.pht005506.v1.p1",19,18,37,"06/01/2017","dbgap"
"506","phs000007.v32.pht002899.v6.p13",1426,1737,3163,"2020/12/21","dbgap"
"508","phs001488.v1.pht007395.v1.p1",260,293,553,"2018/02/08","dbgap"
"509","phs001065.v1.pht005437.v1.p1",296,313,609,"05/24/2016","dbgap"
"510","phs001694.v1.pht008492.v1.p1",6,2,8,"2018/10/24","dbgap"
"511","phs000348.v2.pht002230.v2.p1",26,12,38,"12/19/2014","dbgap"
"512","phs000179.v6.pht002259.v3.p2",1254,1194,2448,"2018/04/23","dbgap"
"513","phs001467.v2.pht009730.v2.p2",1691,3128,4819,"2021/08/10","dbgap"
"516","phs000280.v7.pht004231.v2.p1",6597,7829,14426,"2020/06/18","dbgap"
"517","phs002015.v1.pht010362.v1.p1",1637,2164,3801,"2020/09/18","dbgap"
"518","phs000450.v4.pht002525.v3.p1",171,153,324,"2020/10/29","dbgap"
"519","phs002283.v1.pht010684.v1.p1",856,467,1323,"2020/11/30","dbgap"
"521","phs001850.v1.pht009236.v1.p1",32,267,299,"2019/07/03","dbgap"
"522","phs001471.v1.pht009806.v1.p1",136,358,494,"2020/01/10","dbgap"
"523","phs001072.v1.pht005354.v1.p1",42,15,57,"03/31/2016","dbgap"
"524","phs000590.v1.pht008269.v1.p1",32,36,68,"2018/08/03","dbgap"
"525","phs000634.v1.pht003831.v1.p1",801,1519,2320,"06/25/2015","dbgap"
"526","phs001430.v2.pht008078.v2.p1",11,8,19,"2020/02/06","dbgap"
"527","phs001422.v2.pht006759.v2.p1",23,13,36,"2021/02/08","dbgap"
"528","phs000287.v7.pht001450.v1.p1",2140,2763,4903,"2020/01/23","dbgap"
"529","phs000286.v6.pht008782.v1.p2",1009,1780,2789,"2019/03/11","dbgap"
"530","phs001430.v2.pht008065.v2.p1",12,10,22,"2020/02/06","dbgap"
"531","phs000552.v2.pht003028.v1.p1",12,53,65,"04/08/2014","dbgap"
"532","phs000701.v1.pht005519.v1.p1",48,43,91,"06/01/2017","dbgap"
"533","phs001719.v1.pht008917.v1.p1",49,53,102,"2019/05/07","dbgap"
"534","phs000007.v32.pht000097.v3.p13",571,833,1404,"2020/12/21","dbgap"
"536","phs000729.v1.pht003776.v1.p1",4,5,9,"04/08/2014","dbgap"
"537","phs001942.v1.pht010586.v1.p1",13,3,16,"2020/10/21","dbgap"
"539","phs001316.v1.pht008001.v1.p1",2,1,3,"2018/05/31","dbgap"
"540","phs001931.v1.pht009677.v1.p1",10,26,36,"2020/02/03","dbgap"
"541","phs000729.v1.pht003775.v1.p1",4,5,9,"04/08/2014","dbgap"
"542","phs000590.v1.pht008275.v1.p1",24,26,50,"2018/08/03","dbgap"
"543","phs001194.v3.pht005830.v2.p2",3676,2871,6547,"2020/07/24","dbgap"
"544","phs001571.v1.pht009503.v1.p1",969,1274,2243,"2020/08/06","dbgap"
"545","phs001009.v1.pht005352.v1.p1",73,105,178,"03/28/2016","dbgap"
"549","phs000784.v3.pht004286.v1.p1",518,482,1000,"2019/11/15","dbgap"
"550","phs000956.v5.pht005001.v3.p1",559,552,1111,"2021/05/07","dbgap"
"551","phs001485.v2.pht007184.v1.p1",11,13,24,"2021/03/10","dbgap"
"552","phs001727.v2.pht010101.v1.p1",29,44,73,"2021/08/26","dbgap"
"553","phs000507.v2.pht002926.v2.p2",436,778,1214,"2018/11/05","dbgap"
"555","phs002088.v2.pht010651.v1.p1",22,18,40,"2021/06/16","dbgap"
"557","phs000343.v3.pht002728.v1.p1",353,188,541,"03/12/2013","dbgap"
"558","phs001238.v2.pht006649.v1.p1",262,363,625,"2018/06/14","dbgap"
"559","phs000698.v1.pht007690.v1.p1",18,32,50,"2018/03/23","dbgap"
"561","phs002046.v1.pht010626.v1.p1",69,129,198,"2020/11/02","dbgap"
"564","phs002292.v1.pht011108.v1.p1",11,12,23,"2021/04/09","dbgap"
"565","phs000185.v7.pht008410.v1.p1",4,7,11,"2020/04/29","dbgap"
"566","phs000252.v2.pht001267.v2.p1",7,4,11,"03/07/2011","dbgap"
"567","phs001701.v1.pht009378.v1.p1",425,884,1309,"2019/08/06","dbgap"
"568","phs000128.v3.pht000432.v2.p3",2943,3500,6443,"04/29/2016","dbgap"
"570","phs001424.v1.pht006998.v1.p1",7,5,12,"2017/10/10","dbgap"
"571","phs001733.v1.pht008616.v1.p1",7,10,17,"2019/01/07","dbgap"
"572","phs001911.v1.pht009516.v1.p1",7,12,19,"2019/10/08","dbgap"
"576","phs000280.v7.pht004083.v2.p1",103,43,146,"2020/06/18","dbgap"
"577","phs000588.v1.pht009283.v1.p1",1,8,9,"2019/07/26","dbgap"
"578","phs000285.v3.pht001763.v2.p2",12,11,23,"08/20/2013","dbgap"
"579","phs002301.v1.pht010814.v1.p1",50,30,80,"2020/12/22","dbgap"
"580","phs001480.v1.pht010833.v1.p1",80,194,274,"2021/01/13","dbgap"
"581","phs000285.v3.pht001851.v2.p2",947,1065,2012,"08/20/2013","dbgap"
"582","phs000876.v2.pht005184.v2.p1",1147,815,1962,"2020/03/04","dbgap"
"583","phs002331.v1.pht011100.v1.p1",1965,698,2663,"2021/05/21","dbgap"
"584","phs000920.v5.pht004900.v5.p3",1983,1988,3971,"2021/10/04","dbgap"
"585","phs000128.v3.pht000587.v2.p3",2943,3500,6443,"04/29/2016","dbgap"
"586","phs001227.v1.pht005834.v1.p1",70,95,165,"2020/02/18","dbgap"
"587","phs002364.v1.pht011061.v1.p1",2,1,3,"2021/03/17","dbgap"
"588","phs002068.v1.pht010873.v1.p1",807,637,1444,"2021/01/26","dbgap"
"589","phs001402.v3.pht008237.v2.p1",796,739,1535,"2021/06/16","dbgap"
"590","phs000595.v1.pht006638.v1.p1",286,328,614,"07/05/2017","dbgap"
"591","phs001651.v1.pht008235.v1.p1",36,15,51,"2018/07/18","dbgap"
"592","phs000142.v1.pht000639.v1.p1",1313,3124,4437,"07/21/2009","dbgap"
"593","phs001326.v1.pht007815.v1.p1",24,6,30,"2018/04/16","dbgap"
"594","phs001903.v1.pht009894.v1.p1",18421,19016,37437,"2020/09/03","dbgap"
"595","phs000607.v3.pht003444.v3.p2",4836,5159,9995,"2018/05/01","dbgap"
"596","phs000916.v1.pht004734.v1.p1",516,283,799,"07/26/2016","dbgap"
"597","phs000556.v1.pht003138.v1.p1",2,4,6,"07/09/2013","dbgap"
"598","phs000383.v1.pht002869.v1.p1",33,3794,3827,"12/11/2012","dbgap"
"599","phs000286.v6.pht001959.v2.p2",1289,2149,3438,"2019/03/11","dbgap"
"600","phs001653.v1.pht008705.v1.p1",278,347,625,"2019/04/10","dbgap"
"601","phs000590.v1.pht008264.v1.p1",3,1,4,"2018/08/03","dbgap"
"602","phs000219.v1.pht001064.v1.p1",664,1054,1718,"01/19/2010","dbgap"
"603","phs002015.v1.pht010384.v1.p1",1816,2387,4203,"2020/09/18","dbgap"
"604","phs000280.v7.pht004212.v2.p1",5167,1,5168,"2020/06/18","dbgap"
"605","phs000608.v1.pht003342.v1.p1",792,667,1459,"07/15/2013","dbgap"
"606","phs001065.v1.pht005439.v1.p1",296,313,609,"05/24/2016","dbgap"
"607","phs001201.v2.pht007557.v2.p1",87,99,186,"2019/08/18","dbgap"
"609","phs000808.v1.pht004464.v1.p1",117,128,245,"02/05/2015","dbgap"
"610","phs000007.v32.pht004375.v2.p13",850,1175,2025,"2020/12/21","dbgap"
"611","phs001497.v2.pht007240.v2.p1",1819,1354,3173,"2021/09/08","dbgap"
"612","phs000007.v32.pht002896.v6.p13",1428,1738,3166,"2020/12/21","dbgap"
"613","phs000409.v1.pht002737.v1.p1",64,29,93,"05/23/2012","dbgap"
"614","phs000285.v3.pht001633.v2.p2",899,1013,1912,"08/20/2013","dbgap"
"616","phs000249.v2.pht001877.v2.p1",254,128,382,"04/16/2014","dbgap"
"617","phs001956.v1.pht009788.v1.p1",8,7,15,"2020/01/10","dbgap"
"618","phs000615.v1.pht003307.v1.p1",5655,5429,11084,"08/14/2014","dbgap"
"619","phs000405.v1.pht002611.v1.p1",6,7,13,"11/15/2012","dbgap"
"621","phs000719.v1.pht003734.v1.p1",14,88,102,"04/15/2014","dbgap"
"623","phs001329.v2.pht007178.v2.p1",1,3,4,"2019/05/07","dbgap"
"626","phs002050.v1.pht010358.v1.p1",1113,1415,2528,"2020/11/19","dbgap"
"627","phs001065.v1.pht005405.v1.p1",296,313,609,"05/24/2016","dbgap"
"630","phs000007.v32.pht005174.v3.p13",2099,2426,4525,"2020/12/21","dbgap"
"631","phs000280.v7.pht004065.v2.p1",4883,6019,10902,"2020/06/18","dbgap"
"632","phs000128.v3.pht000434.v2.p3",2943,3500,6443,"04/29/2016","dbgap"
"633","phs001333.v2.pht006526.v2.p1",8,10,18,"2019/08/29","dbgap"
"634","phs000631.v1.pht003600.v1.p1",1746,1286,3032,"12/03/2013","dbgap"
"635","phs001313.v1.pht007969.v1.p1",1,4,5,"2018/05/17","dbgap"
"636","phs000185.v7.pht003274.v5.p1",95,138,233,"2020/04/29","dbgap"
"637","phs001810.v1.pht009067.v1.p1",831,716,1547,"2019/07/01","dbgap"
"639","phs000250.v1.pht002186.v1.p1",196,155,351,"07/06/2011","dbgap"
"640","phs000874.v1.pht004656.v1.p1",498,452,950,"04/13/2015","dbgap"
"641","phs000863.v1.pht004745.v1.p1",348,282,630,"06/03/2015","dbgap"
"642","phs001319.v1.pht006210.v1.p1",4456,3110,7566,"03/29/2017","dbgap"
"643","phs000577.v1.pht007268.v1.p1",172,340,512,"2017/12/20","dbgap"
"644","phs001252.v1.pht006389.v1.p1",1339,855,2194,"05/16/2017","dbgap"
"645","phs000007.v32.pht006019.v1.p13",104,169,273,"2020/12/21","dbgap"
"646","phs001753.v1.pht009016.v1.p1",91,132,223,"2019/05/01","dbgap"
"647","phs000017.v3.pht000058.v1.p1",237,243,480,"Wed Nov 26 07:41:22 2008","dbgap"
"648","phs000285.v3.pht001830.v2.p2",876,990,1866,"08/20/2013","dbgap"
"649","phs000285.v3.pht001777.v2.p2",532,577,1109,"08/20/2013","dbgap"
"651","phs002006.v2.pht010161.v2.p1",13,13,26,"2020/09/02","dbgap"
"652","phs000590.v1.pht008280.v1.p1",32,36,68,"2018/08/03","dbgap"
"653","phs001311.v1.pht007921.v1.p1",34,26,60,"2018/05/15","dbgap"
"655","phs001377.v1.pht006945.v1.p1",321,44,365,"2017/09/22","dbgap"
"656","phs000340.v3.pht002207.v2.p1",73,33,106,"04/10/2014","dbgap"
"657","phs001397.v1.pht006955.v1.p1",352,469,821,"2017/10/05","dbgap"
"658","phs001167.v1.pht005637.v1.p1",839,1206,2045,"07/08/2016","dbgap"
"659","phs000343.v3.pht002727.v1.p1",1366,776,2142,"03/12/2013","dbgap"
"662","phs000625.v1.pht003854.v1.p1",3361,2762,6123,"06/13/2014","dbgap"
"663","phs001735.v2.pht009981.v2.p1",2430,2119,4549,"2021/09/08","dbgap"
"664","phs000336.v1.pht002219.v1.p1",9338,2179,11517,"04/21/2011","dbgap"
"665","phs000768.v2.pht004479.v2.p1",31,22,53,"12/20/2016","dbgap"
"666","phs000537.v1.pht003025.v1.p1",2,2,4,"10/24/2012","dbgap"
"667","phs001820.v1.pht010242.v1.p1",74,44,118,"2020/05/26","dbgap"
"668","phs000592.v1.pht006587.v1.p1",179,145,324,"07/12/2017","dbgap"
"669","phs000286.v6.pht008787.v1.p2",1290,2154,3444,"2019/03/11","dbgap"
"671","phs001279.v1.pht007214.v1.p1",15,23,38,"2017/12/08","dbgap"
"672","phs000286.v6.pht008773.v1.p2",1295,2163,3458,"2019/03/11","dbgap"
"673","phs000929.v1.pht007981.v1.p1",15,7275,7290,"2018/05/24","dbgap"
"674","phs000017.v3.pht000318.v1.p1",237,243,480,"Wed Nov 26 07:46:05 2008","dbgap"
"675","phs000373.v1.pht007127.v1.p1",5135,4,5139,"2017/11/30","dbgap"
"676","phs000228.v4.pht001185.v4.p1",25338,30424,55762,"03/21/2017","dbgap"
"677","phs000524.v1.pht002916.v1.p1",1986,1612,3598,"12/27/2012","dbgap"
"678","phs000286.v6.pht008752.v1.p2",935,1561,2496,"2019/03/11","dbgap"
"679","phs001933.v1.pht011513.v1.p1",89,24,113,"2021/08/30","dbgap"
"680","phs000287.v7.pht001469.v1.p1",2375,3156,5531,"2020/01/23","dbgap"
"681","phs001278.v1.pht006280.v1.p1",76,99,175,"06/16/2017","dbgap"
"682","phs000658.v1.pht003497.v1.p1",493,945,1438,"01/13/2014","dbgap"
"683","phs001168.v2.pht007578.v2.p2",755,623,1378,"2019/03/19","dbgap"
"684","phs000171.v1.pht000779.v1.p1",330,670,1000,"12/11/2009","dbgap"
"685","phs000542.v1.pht003018.v1.p1",2,2,4,"10/24/2012","dbgap"
"687","phs000824.v1.pht005136.v1.p1",37,63,100,"11/24/2015","dbgap"
"689","phs001735.v2.pht009982.v2.p1",2430,2119,4549,"2021/09/08","dbgap"
"692","phs000280.v7.pht004103.v2.p1",6119,7409,13528,"2020/06/18","dbgap"
"693","phs000589.v1.pht009188.v1.p1",7,90,97,"2019/06/14","dbgap"
"694","phs000285.v3.pht001596.v2.p2",912,1037,1949,"08/20/2013","dbgap"
"695","phs001653.v1.pht008702.v1.p1",278,347,625,"2019/04/10","dbgap"
"696","phs001837.v1.pht009315.v1.p1",78,46,124,"2019/08/26","dbgap"
"697","phs000381.v1.pht002420.v1.p1",743,488,1231,"12/19/2011","dbgap"
"698","phs000486.v1.pht002806.v1.p1",1857,3481,5338,"12/17/2014","dbgap"
"699","phs001544.v2.pht009899.v1.p1",114,7,121,"2021/07/09","dbgap"
"700","phs000007.v32.pht000205.v8.p13",1951,2114,4065,"2020/12/21","dbgap"
"701","phs001862.v1.pht009746.v1.p1",278,380,658,"2019/12/26","dbgap"
"702","phs001430.v2.pht008083.v2.p1",13,9,22,"2020/02/06","dbgap"
"703","phs000280.v7.pht004202.v2.p1",6119,7410,13529,"2020/06/18","dbgap"
"704","phs001514.v2.pht009817.v1.p1",205,229,434,"2021/06/28","dbgap"
"706","phs000589.v1.pht009175.v1.p1",2,7,9,"2019/06/14","dbgap"
"707","phs000007.v32.pht010749.v1.p13",1595,1857,3452,"2020/12/21","dbgap"
"708","phs000892.v2.pht004629.v2.p2",5,41,46,"09/29/2015","dbgap"
"709","phs001683.v2.pht008911.v2.p1",372,363,735,"2020/07/15","dbgap"
"710","phs000388.v1.pht002353.v1.p1",1354,1513,2867,"08/23/2011","dbgap"
"712","phs000833.v7.pht004359.v7.p1",29,15,44,"2017/11/01","dbgap"
"714","phs001433.v1.pht006812.v1.p1",12,9,21,"2017/08/24","dbgap"
"715","phs000138.v2.pht000618.v1.p1",748,2240,2988,"06/01/2010","dbgap"
"716","phs000888.v1.pht005582.v1.p1",47,34,81,"08/12/2016","dbgap"
"717","phs001717.v1.pht008581.v1.p1",152,150,302,"2019/03/11","dbgap"
"719","phs000582.v1.pht003242.v1.p1",16,14,30,"05/16/2013","dbgap"
"720","phs001900.v1.pht009630.v1.p1",123,96,219,"2020/03/02","dbgap"
"724","phs000286.v6.pht008759.v1.p2",241,496,737,"2019/03/11","dbgap"
"725","phs001406.v1.pht007749.v1.p1",81,153,234,"2019/10/11","dbgap"
"726","phs001488.v1.pht007422.v1.p1",260,293,553,"2018/02/08","dbgap"
"727","phs001381.v1.pht006567.v1.p1",352,315,667,"06/19/2017","dbgap"
"728","phs001958.v1.pht009930.v1.p1",56,29,85,"2020/08/26","dbgap"
"729","phs000763.v1.pht004255.v1.p1",1243,1369,2612,"01/16/2015","dbgap"
"731","phs001889.v1.pht009738.v1.p1",10,7,17,"2019/12/26","dbgap"
"732","phs001195.v1.pht006858.v1.p1",10,3,13,"2018/03/27","dbgap"
"735","phs001212.v1.pht006562.v1.p1",26,27,53,"2017/10/13","dbgap"
"736","phs000616.v2.pht003369.v2.p2",797,765,1562,"07/15/2015","dbgap"
"737","phs001507.v1.pht008698.v1.p1",8,8,16,"2020/02/04","dbgap"
"738","phs000864.v1.pht004495.v1.p1",3976,16,3992,"05/08/2015","dbgap"
"739","phs001811.v1.pht009062.v1.p1",33,69,102,"2019/05/13","dbgap"
"740","phs001008.v1.pht005109.v1.p1",419,605,1024,"11/13/2015","dbgap"
"741","phs000410.v1.pht002448.v1.p1",30,135,165,"03/11/2014","dbgap"
"742","phs000086.v3.pht000346.v1.p1",10,8,18,"11/04/2014","dbgap"
"744","phs001712.v1.pht008682.v1.p1",61,91,152,"2019/01/31","dbgap"
"748","phs000086.v3.pht000344.v1.p1",2,2,4,"11/04/2014","dbgap"
"749","phs001662.v2.pht010072.v1.p1",843,758,1601,"2021/08/19","dbgap"
"750","phs001282.v2.pht006096.v2.p1",29,8,37,"2020/01/21","dbgap"
"752","phs001299.v2.pht007619.v1.p1",1733,1794,3527,"2020/03/09","dbgap"
"753","phs002377.v1.pht011114.v1.p1",19,17,36,"2021/04/07","dbgap"
"755","phs000128.v3.pht000402.v2.p3",2943,3500,6443,"04/29/2016","dbgap"
"756","phs000478.v1.pht002655.v1.p1",7,6,13,"05/02/2012","dbgap"
"757","phs001346.v1.pht006254.v1.p1",5,10,15,"2019/03/28","dbgap"
"759","phs001935.v1.pht009768.v1.p1",3,3,6,"2020/02/06","dbgap"
"760","phs001295.v2.pht006238.v2.p1",100,182,282,"2019/04/19","dbgap"
"761","phs000352.v1.pht002285.v1.p1",21,25,46,"10/28/2011","dbgap"
"762","phs000007.v32.pht000016.v3.p13",1143,1607,2750,"2020/12/21","dbgap"
"763","phs000595.v1.pht006641.v1.p1",219,262,481,"07/05/2017","dbgap"
"765","phs000007.v32.pht000909.v5.p13",1284,1627,2911,"2020/12/21","dbgap"
"766","phs000280.v7.pht004081.v2.p1",6105,7385,13490,"2020/06/18","dbgap"
"767","phs000298.v4.pht002584.v3.p3",7742,4936,12678,"2018/06/22","dbgap"
"769","phs000285.v3.pht001774.v2.p2",42,74,116,"08/20/2013","dbgap"
"770","phs000920.v5.pht004897.v5.p3",1985,1992,3977,"2021/10/04","dbgap"
"771","phs000007.v32.pht000077.v8.p13",1583,1791,3374,"2020/12/21","dbgap"
"772","phs000757.v1.pht003921.v1.p1",69,58,127,"06/30/2014","dbgap"
"773","phs000007.v32.pht000675.v4.p13",664,743,1407,"2020/12/21","dbgap"
"774","phs001252.v1.pht006375.v1.p1",1323,709,2032,"05/16/2017","dbgap"
"775","phs001546.v2.pht009974.v1.p1",5,1,6,"2021/07/14","dbgap"
"776","phs001238.v2.pht006661.v1.p1",535,704,1239,"2018/06/14","dbgap"
"777","phs001062.v5.pht005263.v3.p2",793,206,999,"2021/05/21","dbgap"
"778","phs000280.v7.pht006436.v1.p1",2255,2928,5183,"2020/06/18","dbgap"
"779","phs000907.v1.pht004697.v1.p1",1,4,5,"11/25/2016","dbgap"
"780","phs000753.v1.pht003876.v1.p1",1302,988,2290,"06/05/2014","dbgap"
"782","phs001890.v1.pht009544.v1.p1",10,7,17,"2020/05/01","dbgap"
"784","phs000783.v2.pht004279.v2.p1",267,199,466,"2018/03/09","dbgap"
"786","phs000954.v4.pht006297.v2.p2",580,710,1290,"2021/05/11","dbgap"
"787","phs001526.v1.pht007611.v1.p1",7,5,12,"2018/06/26","dbgap"
"789","phs001783.v2.pht008821.v2.p1",372,465,837,"2021/08/06","dbgap"
"790","phs001511.v1.pht007293.v1.p1",212,338,550,"2019/10/17","dbgap"
"792","phs000766.v1.pht003938.v1.p1",2383,2371,4754,"03/26/2015","dbgap"
"793","phs001430.v2.pht008075.v2.p1",12,10,22,"2020/02/06","dbgap"
"794","phs000448.v1.pht002509.v1.p1",2164,932,3096,"08/28/2012","dbgap"
"795","phs000286.v6.pht008762.v1.p2",875,1659,2534,"2019/03/11","dbgap"
"796","phs000394.v1.pht002651.v1.p1",647,354,1001,"05/24/2012","dbgap"
"797","phs000510.v1.pht010696.v1.p1",5,3629,3634,"2020/11/27","dbgap"
"798","phs001380.v1.pht009230.v1.p1",648,245,893,"2019/10/11","dbgap"
"799","phs000007.v32.pht000095.v8.p13",1517,1747,3264,"2020/12/21","dbgap"
"800","phs001958.v1.pht009939.v1.p1",56,29,85,"2020/08/26","dbgap"
"801","phs000589.v1.pht009186.v1.p1",9,127,136,"2019/06/14","dbgap"
"802","phs000606.v1.pht007573.v1.p1",9,8,17,"2018/03/09","dbgap"
"803","phs002025.v1.pht010238.v1.p1",2281,1718,3999,"2020/07/20","dbgap"
"804","phs000285.v3.pht001824.v2.p2",876,991,1867,"08/20/2013","dbgap"
"805","phs001363.v1.pht006793.v1.p1",34,28,62,"2017/08/18","dbgap"
"807","phs000588.v1.pht009299.v1.p1",42,151,193,"2019/07/26","dbgap"
"808","phs000086.v3.pht000246.v1.p1",751,670,1421,"11/04/2014","dbgap"
"809","phs000299.v2.pht001552.v2.p1",15,6,21,"02/27/2014","dbgap"
"810","phs001419.v1.pht007088.v1.p1",488,499,987,"2017/12/04","dbgap"
"811","phs002394.v1.pht011132.v1.p1",24,29,53,"2021/04/19","dbgap"
"812","phs000007.v32.pht000397.v3.p13",343,345,688,"2020/12/21","dbgap"
"813","phs000663.v3.pht003551.v3.p3",669,880,1549,"2021/08/31","dbgap"
"814","phs000188.v1.pht000977.v1.p1",1197,1824,3021,"10/05/2010","dbgap"
"815","phs002069.v1.pht010471.v1.p1",154,184,338,"2020/08/20","dbgap"
"816","phs001703.v3.pht008452.v1.p1",54,37,91,"2019/11/27","dbgap"
"817","phs000220.v2.pht002387.v2.p2",11686,13606,25292,"2018/06/11","dbgap"
"819","phs000649.v2.pht003760.v2.p2",360,399,759,"2021/01/08","dbgap"
"821","phs002071.v1.pht010456.v1.p1",14,10,24,"2020/12/10","dbgap"
"822","phs000783.v2.pht004281.v2.p1",267,199,466,"2018/03/09","dbgap"
"823","phs000285.v3.pht001737.v2.p2",882,965,1847,"08/20/2013","dbgap"
"824","phs001910.v1.pht009536.v1.p1",22,24,46,"2019/10/15","dbgap"
"826","phs000007.v32.pht005143.v3.p13",223,282,505,"2020/12/21","dbgap"
"827","phs000285.v3.pht001706.v2.p2",102,92,194,"08/20/2013","dbgap"
"828","phs000280.v7.pht006481.v1.p1",2349,3143,5492,"2020/06/18","dbgap"
"830","phs000285.v3.pht001711.v2.p2",873,956,1829,"08/20/2013","dbgap"
"831","phs000007.v32.pht000089.v7.p13",1052,1241,2293,"2020/12/21","dbgap"
"834","phs001299.v2.pht007620.v1.p1",1733,1794,3527,"2020/03/09","dbgap"
"835","phs000626.v1.pht003431.v1.p1",1,1,2,"08/21/2015","dbgap"
"836","phs001222.v1.pht005910.v1.p1",476,938,1414,"2019/05/30","dbgap"
"837","phs000571.v3.pht003191.v3.p2",1654,1222,2876,"12/01/2015","dbgap"
"838","phs000435.v3.pht002523.v3.p1",104,65,169,"02/27/2017","dbgap"
"839","phs000285.v3.pht001724.v2.p2",877,976,1853,"08/20/2013","dbgap"
"840","phs001026.v1.pht005119.v1.p1",68,57,125,"11/16/2015","dbgap"
"841","phs000007.v32.pht002350.v6.p13",1219,1482,2701,"2020/12/21","dbgap"
"842","phs000007.v32.pht000080.v8.p13",1671,1770,3441,"2020/12/21","dbgap"
"843","phs001317.v1.pht008043.v1.p1",25,34,59,"2018/06/01","dbgap"
"844","phs000996.v2.pht005750.v1.p1",698,687,1385,"2019/10/11","dbgap"
"845","phs001304.v1.pht008312.v1.p1",65,86,151,"2018/10/05","dbgap"
"846","phs000976.v2.pht005685.v2.p1",1534,1717,3251,"2020/11/09","dbgap"
"847","phs001309.v1.pht007915.v1.p1",51,54,105,"2018/05/15","dbgap"
"848","phs001662.v2.pht010069.v1.p1",843,758,1601,"2021/08/19","dbgap"
"849","phs001124.v1.pht009258.v1.p1",47,228,275,"2019/07/22","dbgap"
"851","phs000583.v1.pht003292.v1.p1",860,756,1616,"03/21/2014","dbgap"
"852","phs000171.v1.pht000774.v1.p1",50,65,115,"12/11/2009","dbgap"
"853","phs002185.v1.pht010968.v1.p1",2025,914,2939,"2021/08/24","dbgap"
"854","phs002222.v1.pht010528.v1.p1",3,8,11,"2020/09/17","dbgap"
"855","phs002416.v1.pht011232.v1.p1",3,16,19,"2021/05/18","dbgap"
"856","phs000007.v32.pht000145.v5.p13",668,746,1414,"2020/12/21","dbgap"
"857","phs000209.v13.pht003373.v1.p3",941,901,1842,"11/05/2014","dbgap"
"858","phs000128.v3.pht000406.v2.p3",2943,3500,6443,"04/29/2016","dbgap"
"860","phs000365.v1.pht002266.v1.p1",2,1,3,"08/11/2011","dbgap"
"861","phs001982.v1.pht010004.v1.p1",26,36,62,"2020/03/19","dbgap"
"862","phs001797.v1.pht008891.v1.p1",5,2,7,"2019/03/28","dbgap"
"864","phs000095.v4.pht004353.v1.p2",1863,2252,4115,"2021/09/13","dbgap"
"865","phs001875.v1.pht009653.v1.p1",3,3,6,"2019/12/06","dbgap"
"866","phs001330.v2.pht007531.v2.p1",4,2,6,"2019/11/08","dbgap"
"868","phs001881.v1.pht010563.v1.p1",2839,1545,4384,"2020/10/01","dbgap"
"869","phs000219.v1.pht001094.v1.p1",42,44,86,"01/19/2010","dbgap"
"870","phs000588.v1.pht009292.v1.p1",42,151,193,"2019/07/26","dbgap"
"872","phs000575.v2.pht005888.v2.p1",146,166,312,"2020/02/14","dbgap"
"873","phs001410.v1.pht008421.v1.p1",137,214,351,"2018/09/26","dbgap"
"874","phs001329.v2.pht007177.v2.p1",1,4,5,"2019/05/07","dbgap"
"875","phs000292.v1.pht001524.v1.p1",1066,810,1876,"07/15/2010","dbgap"
"878","phs000285.v3.pht001762.v2.p2",867,971,1838,"08/20/2013","dbgap"
"879","phs001761.v1.pht009027.v1.p1",34,120,154,"2019/05/16","dbgap"
"880","phs000779.v1.pht003962.v1.p1",1193,1209,2402,"07/25/2014","dbgap"
"881","phs001829.v1.pht010167.v1.p1",10,7,17,"2020/04/24","dbgap"
"882","phs000413.v2.pht002733.v2.p1",7,8,15,"11/16/2012","dbgap"
"883","phs000777.v1.pht003972.v1.p1",4,6,10,"08/20/2014","dbgap"
"885","phs000484.v1.pht002684.v1.p1",5,2,7,"06/01/2012","dbgap"
"886","phs001487.v1.pht007138.v1.p1",518,249,767,"2018/08/02","dbgap"
"887","phs001559.v1.pht007660.v1.p1",162,31,193,"2018/03/20","dbgap"
"888","phs000209.v13.pht001109.v1.p3",1730,2005,3735,"11/05/2014","dbgap"
"889","phs000290.v1.pht002275.v1.p1",16,78,94,"08/23/2011","dbgap"
"890","phs001251.v1.pht005950.v1.p1",2,2,4,"11/21/2016","dbgap"
"891","phs000551.v1.pht003064.v1.p1",387,207,594,"12/03/2013","dbgap"
"892","phs000302.v1.pht002177.v1.p1",200,150,350,"08/18/2011","dbgap"
"893","phs000209.v13.pht004316.v1.p3",1636,1749,3385,"11/05/2014","dbgap"
"894","phs001311.v1.pht007933.v1.p1",35,26,61,"2018/05/15","dbgap"
"896","phs000543.v1.pht002938.v1.p1",7,8,15,"10/31/2014","dbgap"
"897","phs000592.v1.pht006593.v1.p1",110,106,216,"07/12/2017","dbgap"
"898","phs000280.v7.pht006414.v1.p1",2140,2772,4912,"2020/06/18","dbgap"
"899","phs002346.v1.pht011577.v1.p1",134,26,160,"2021/09/24","dbgap"
"900","phs000209.v13.pht002300.v1.p3",115,136,251,"11/05/2014","dbgap"
"902","phs000963.v1.pht004856.v1.p1",3771,2119,5890,"05/11/2016","dbgap"
"904","phs001641.v1.pht010034.v1.p1",4,39,43,"2020/03/24","dbgap"
"905","phs000285.v3.pht001677.v2.p2",905,1012,1917,"08/20/2013","dbgap"
"906","phs000277.v2.pht002795.v2.p1",3640,2889,6529,"2020/04/02","dbgap"
"907","phs000219.v1.pht001075.v1.p1",664,1054,1718,"01/19/2010","dbgap"
"908","phs000577.v1.pht007279.v1.p1",34,149,183,"2017/12/20","dbgap"
"909","phs001380.v1.pht009229.v1.p1",648,245,893,"2019/10/11","dbgap"
"910","phs001788.v1.pht008814.v1.p1",3910,867,4777,"2019/03/05","dbgap"
"911","phs000284.v2.pht001899.v2.p1",1830,1681,3511,"2018/09/26","dbgap"
"912","phs000972.v5.pht005681.v2.p1",532,800,1332,"2021/05/20","dbgap"
"913","phs000228.v4.pht001193.v3.p1",25338,30424,55762,"03/21/2017","dbgap"
"917","phs002015.v1.pht010377.v1.p1",206,164,370,"2020/09/18","dbgap"
"919","phs000007.v32.pht000092.v8.p13",1664,1768,3432,"2020/12/21","dbgap"
"921","phs001310.v1.pht006865.v1.p1",29,25,54,"2017/09/18","dbgap"
"923","phs000127.v2.pht000651.v1.p1",231,201,432,"09/03/2010","dbgap"
"924","phs001487.v1.pht007136.v1.p1",518,249,767,"2018/08/02","dbgap"
"925","phs001894.v1.pht009521.v1.p1",419,305,724,"2020/04/15","dbgap"
"927","phs001491.v2.pht007252.v2.p1",164,188,352,"2020/03/09","dbgap"
"928","phs000760.v1.pht004265.v1.p1",8,7,15,"02/18/2015","dbgap"
"929","phs000280.v7.pht004080.v2.p1",6758,8122,14880,"2020/06/18","dbgap"
"930","phs001015.v1.pht005780.v1.p1",24,56,80,"09/30/2016","dbgap"
"931","phs000519.v1.pht003248.v1.p1",1916,1996,3912,"09/26/2013","dbgap"
"932","phs000581.v1.pht003203.v1.p1",61,59,120,"06/04/2013","dbgap"
"933","phs000007.v32.pht000027.v3.p13",216,455,671,"2020/12/21","dbgap"
"934","phs001426.v1.pht006915.v1.p1",125,121,246,"2017/09/19","dbgap"
"936","phs001645.v1.pht008212.v1.p1",16,9,25,"2018/07/18","dbgap"
"937","phs000700.v2.pht003649.v2.p1",2,1,3,"2019/11/15","dbgap"
"938","phs001213.v2.pht005836.v1.p1",1173,629,1802,"2020/02/27","dbgap"
"939","phs000655.v3.pht003491.v3.p1",383,324,707,"12/09/2016","dbgap"
"940","phs000286.v6.pht001926.v2.p2",1289,2151,3440,"2019/03/11","dbgap"
"941","phs000730.v1.pht005059.v1.p1",31,55,86,"11/13/2015","dbgap"
"942","phs001709.v1.pht009495.v1.p1",1,199,200,"2019/09/27","dbgap"
"943","phs000285.v3.pht001846.v2.p2",874,981,1855,"08/20/2013","dbgap"
"945","phs000719.v1.pht003736.v1.p1",14,88,102,"04/15/2014","dbgap"
"946","phs000461.v1.pht003685.v1.p1",41,29,70,"02/12/2014","dbgap"
"947","phs000007.v32.pht000033.v10.p13",1885,2030,3915,"2020/12/21","dbgap"
"950","phs000966.v2.pht005307.v2.p2",285,425,710,"2021/08/27","dbgap"
"951","phs000719.v1.pht003735.v1.p1",10,35,45,"04/15/2014","dbgap"
"952","phs001504.v2.pht007909.v2.p1",489,487,976,"2021/03/05","dbgap"
"953","phs000497.v3.pht002714.v3.p2",252,164,416,"10/07/2016","dbgap"
"954","phs000101.v5.pht001147.v1.p1",1167,1062,2229,"2018/08/19","dbgap"
"956","phs001229.v1.pht006549.v1.p1",25,14,39,"06/15/2017","dbgap"
"957","phs001406.v1.pht007741.v1.p1",1170,1785,2955,"2019/10/11","dbgap"
"958","phs001490.v1.pht008136.v1.p1",1065,1522,2587,"2018/06/13","dbgap"
"959","phs000096.v4.pht001424.v4.p1",2205,6884,9089,"11/16/2011","dbgap"
"960","phs000128.v3.pht000567.v2.p3",2943,3500,6443,"04/29/2016","dbgap"
"961","phs002328.v1.pht010854.v1.p1",178,90,268,"2021/03/05","dbgap"
"962","phs002255.v1.pht010672.v1.p1",210,181,391,"2020/11/20","dbgap"
"963","phs001997.v1.pht010217.v1.p1",113,111,224,"2020/05/07","dbgap"
"964","phs001376.v1.pht006554.v1.p1",4,5,9,"06/15/2017","dbgap"
"965","phs001252.v1.pht006398.v1.p1",102,47,149,"05/16/2017","dbgap"
"966","phs002067.v1.pht010411.v1.p1",38,27,65,"2020/10/21","dbgap"
"967","phs000285.v3.pht001572.v2.p2",593,638,1231,"08/20/2013","dbgap"
"968","phs000741.v2.pht003917.v2.p1",458,510,968,"11/14/2016","dbgap"
"970","phs001680.v1.pht008912.v1.p1",22,10,32,"2019/03/28","dbgap"
"971","phs000185.v7.pht003276.v5.p1",95,138,233,"2020/04/29","dbgap"
"972","phs000697.v1.pht007694.v1.p1",26,6,32,"2018/03/26","dbgap"
"973","phs001039.v1.pht005848.v1.p1",15144,20214,35358,"10/19/2016","dbgap"
"974","phs000480.v1.pht002904.v1.p1",120,247,367,"2020/07/17","dbgap"
"975","phs000625.v1.pht003855.v1.p1",3054,2458,5512,"06/13/2014","dbgap"
"976","phs000973.v1.pht004989.v1.p1",20,9,29,"11/16/2016","dbgap"
"977","phs000650.v1.pht003486.v1.p1",364,222,586,"08/27/2013","dbgap"
"980","phs000285.v3.pht001805.v2.p2",45,62,107,"08/20/2013","dbgap"
"983","phs001706.v1.pht008458.v1.p1",17,15,32,"2018/10/11","dbgap"
"984","phs000286.v6.pht008755.v1.p2",1295,2163,3458,"2019/03/11","dbgap"
"985","phs000353.v1.pht002250.v1.p1",755,1410,2165,"08/08/2011","dbgap"
"986","phs000545.v1.pht003765.v1.p1",482,282,764,"06/10/2015","dbgap"
"987","phs001554.v1.pht007610.v1.p1",1075,1817,2892,"2018/03/09","dbgap"
"988","phs000007.v32.pht000014.v3.p13",1339,1799,3138,"2020/12/21","dbgap"
"992","phs001279.v1.pht007216.v1.p1",15,23,38,"2017/12/08","dbgap"
"993","phs000209.v13.pht002193.v1.p3",2833,3070,5903,"11/05/2014","dbgap"
"994","phs000720.v4.pht003878.v2.p1",510,294,804,"2021/03/24","dbgap"
"995","phs000128.v3.pht000443.v2.p3",2943,3500,6443,"04/29/2016","dbgap"
"996","phs001947.v1.pht010138.v1.p1",15,8,23,"2020/04/14","dbgap"
"997","phs001305.v1.pht007111.v1.p1",5,7,12,"2017/11/01","dbgap"
"998","phs000987.v1.pht004970.v1.p1",101,83,184,"04/05/2017","dbgap"
"999","phs000128.v3.pht000537.v2.p3",2943,3500,6443,"04/29/2016","dbgap"
"1000","phs001826.v1.pht009138.v1.p1",2995,3119,6114,"2019/07/16","dbgap"
"1002","phs000128.v3.pht000456.v2.p3",2943,3500,6443,"04/29/2016","dbgap"
"1003","phs000001.v3.pht000372.v2.p1",2098,2656,4754,"02/24/2012","dbgap"
"1004","phs000440.v1.pht002495.v1.p1",416,565,981,"03/15/2012","dbgap"
"1005","phs002393.v1.pht011137.v1.p1",68,70,138,"2021/04/28","dbgap"
"1006","phs000095.v4.pht001211.v4.p2",2894,2663,5557,"2021/09/13","dbgap"
"1007","phs000007.v32.pht000022.v4.p13",499,802,1301,"2020/12/21","dbgap"
"1008","phs000280.v7.pht004076.v2.p1",5413,6593,12006,"2020/06/18","dbgap"
"1009","phs000086.v3.pht000281.v1.p1",348,317,665,"11/04/2014","dbgap"
"1010","phs001726.v2.pht009835.v2.p1",1137,1146,2283,"2021/09/24","dbgap"
"1011","phs000007.v32.pht000081.v8.p13",1533,1726,3259,"2020/12/21","dbgap"
"1012","phs000424.v8.pht002742.v8.p2",653,327,980,"2019/05/30","dbgap"
"1013","phs002001.v1.pht010096.v1.p1",6,9,15,"2021/09/28","dbgap"
"1014","phs001495.v2.pht007197.v1.p1",1,4,5,"2019/01/30","dbgap"
"1017","phs000280.v7.pht006443.v4.p1",6614,7790,14404,"2020/06/18","dbgap"
"1018","phs001576.v2.pht008213.v1.p2",35,17,52,"2019/09/27","dbgap"
"1020","phs000888.v1.pht005558.v1.p1",510,398,908,"08/12/2016","dbgap"
"1021","phs001020.v2.pht005784.v2.p1",784,467,1251,"2019/10/18","dbgap"
"1022","phs000901.v1.pht004673.v1.p1",44,13,57,"06/01/2015","dbgap"
"1023","phs000128.v3.pht000513.v2.p3",2943,3500,6443,"04/29/2016","dbgap"
"1024","phs002197.v1.pht010608.v1.p1",9,7,16,"2020/11/17","dbgap"
"1025","phs000007.v32.pht005147.v1.p13",20,20,40,"2020/12/21","dbgap"
"1026","phs000285.v3.pht001866.v2.p2",947,1065,2012,"08/20/2013","dbgap"
"1027","phs001795.v1.pht008951.v1.p1",27,35,62,"2019/06/24","dbgap"
"1028","phs001947.v1.pht010134.v1.p1",15,8,23,"2020/04/14","dbgap"
"1029","phs000086.v3.pht000250.v1.p1",753,669,1422,"11/04/2014","dbgap"
"1030","phs000404.v1.pht002368.v1.p1",631,896,1527,"12/13/2011","dbgap"
"1031","phs002208.v1.pht010500.v1.p1",104,77,181,"2021/06/11","dbgap"
"1032","phs001913.v1.pht009514.v1.p1",79,198,277,"2019/12/10","dbgap"
"1033","phs000920.v5.pht004898.v5.p3",1983,1988,3971,"2021/10/04","dbgap"
"1034","phs000571.v3.pht003182.v3.p2",132,111,243,"12/01/2015","dbgap"
"1035","phs000007.v32.pht000604.v5.p13",771,889,1660,"2020/12/21","dbgap"
"1036","phs000294.v1.pht001536.v1.p1",4620,1422,6042,"08/17/2010","dbgap"
"1037","phs000606.v1.pht007567.v1.p1",714,260,974,"2018/03/09","dbgap"
"1038","phs000349.v1.pht002189.v1.p1",848,220,1068,"05/02/2011","dbgap"
"1039","phs001177.v2.pht005664.v2.p1",1475,1882,3357,"2019/11/27","dbgap"
"1040","phs000674.v1.pht003640.v1.p1",32008,46478,78486,"01/27/2014","dbgap"
"1042","phs000007.v32.pht005157.v3.p13",1463,1550,3013,"2020/12/21","dbgap"
"1043","phs001933.v1.pht011512.v1.p1",89,24,113,"2021/08/30","dbgap"
"1044","phs001288.v1.pht006782.v1.p1",10,6,16,"2017/10/19","dbgap"
"1046","phs001551.v1.pht008345.v1.p1",49,52,101,"2018/09/07","dbgap"
"1047","phs001396.v1.pht006736.v1.p1",749,821,1570,"2018/05/14","dbgap"
"1048","phs000874.v1.pht004654.v1.p1",498,452,950,"04/13/2015","dbgap"
"1050","phs000007.v32.pht006025.v1.p13",188,214,402,"2020/12/21","dbgap"
"1051","phs002481.v1.pht011397.v1.p1",7,3,10,"2021/07/13","dbgap"
"1052","phs000431.v2.pht002484.v1.p1",1258,838,2096,"02/20/2015","dbgap"
"1053","phs002416.v1.pht011229.v1.p1",3,16,19,"2021/05/18","dbgap"
"1054","phs001485.v2.pht007187.v1.p1",11,13,24,"2021/03/10","dbgap"
"1055","phs000007.v32.pht004811.v4.p13",1366,1603,2969,"2020/12/21","dbgap"
"1056","phs000285.v3.pht001742.v2.p2",884,972,1856,"08/20/2013","dbgap"
"1058","phs001072.v1.pht005356.v1.p1",42,15,57,"03/31/2016","dbgap"
"1059","phs001958.v1.pht009938.v1.p1",56,29,85,"2020/08/26","dbgap"
"1060","phs000738.v1.pht003836.v1.p1",63,45,108,"05/07/2014","dbgap"
"1061","phs000576.v1.pht006140.v1.p1",112,125,237,"05/24/2017","dbgap"
"1062","phs000655.v3.pht003489.v3.p1",383,324,707,"12/09/2016","dbgap"
"1063","phs001775.v1.pht008807.v1.p1",24,16,40,"2019/03/01","dbgap"
"1064","phs001271.v1.pht006117.v1.p1",3208,2099,5307,"02/08/2017","dbgap"
"1065","phs000007.v32.pht000082.v8.p13",1520,1748,3268,"2020/12/21","dbgap"
"1066","phs000926.v1.pht004868.v1.p1",3,1,4,"08/04/2015","dbgap"
"1067","phs001032.v6.pht007135.v1.p2",1,1,2,"2021/05/20","dbgap"
"1068","phs000726.v1.pht003780.v1.p1",546,426,972,"10/27/2014","dbgap"
"1070","phs001252.v1.pht006377.v1.p1",1394,744,2138,"05/16/2017","dbgap"
"1071","phs000101.v5.pht001148.v4.p1",8719,6716,15435,"2018/08/19","dbgap"
"1073","phs002146.v1.pht011084.v1.p1",2,1,3,"2021/03/30","dbgap"
"1074","phs000984.v1.pht005010.v1.p1",96,106,202,"09/21/2016","dbgap"
"1075","phs000575.v2.pht005892.v2.p1",166,202,368,"2020/02/14","dbgap"
"1076","phs001934.v1.pht009776.v1.p1",81,91,172,"2020/01/31","dbgap"
"1077","phs001404.v1.pht010787.v1.p1",33,125,158,"2020/12/15","dbgap"
"1078","phs000286.v6.pht008724.v1.p2",1125,1953,3078,"2019/03/11","dbgap"
"1079","phs000285.v3.pht001803.v2.p2",828,845,1673,"08/20/2013","dbgap"
"1080","phs001318.v1.pht008028.v1.p1",28,13,41,"2018/05/31","dbgap"
"1082","phs000551.v1.pht003061.v1.p1",387,207,594,"12/03/2013","dbgap"
"1083","phs001730.v2.pht010133.v1.p1",24,17,41,"2021/08/26","dbgap"
"1085","phs000285.v3.pht001623.v2.p2",49,49,98,"08/20/2013","dbgap"
"1086","phs000711.v7.pht003722.v6.p2",1239,1193,2432,"2021/03/24","dbgap"
"1087","phs000285.v3.pht001704.v2.p2",40,52,92,"08/20/2013","dbgap"
"1088","phs000778.v1.pht003966.v1.p1",1,4,5,"07/28/2014","dbgap"
"1090","phs000971.v3.pht004919.v3.p1",646,831,1477,"2021/06/07","dbgap"
"1092","phs000287.v7.pht001475.v1.p1",2375,3156,5531,"2020/01/23","dbgap"
"1094","phs000007.v32.pht001894.v6.p13",1793,1676,3469,"2020/12/21","dbgap"
"1096","phs000007.v32.pht002572.v8.p13",1646,2015,3661,"2020/12/21","dbgap"
"1097","phs000007.v32.pht000394.v9.p13",1525,1762,3287,"2020/12/21","dbgap"
"1099","phs000016.v2.pht001038.v1.p2",1718,1040,2758,"11/27/2009","dbgap"
"1100","phs000774.v2.pht004700.v1.p1",7232,6682,13914,"2017/12/29","dbgap"
"1101","phs000755.v2.pht004992.v2.p1",34,27,61,"2019/01/04","dbgap"
"1103","phs000490.v1.pht002969.v1.p1",526,474,1000,"2018/05/07","dbgap"
"1104","phs001555.v1.pht007878.v1.p1",72,72,144,"2018/04/30","dbgap"
"1106","phs001316.v1.pht008003.v1.p1",2,1,3,"2018/05/31","dbgap"
"1107","phs000287.v7.pht001486.v1.p1",2375,3156,5531,"2020/01/23","dbgap"
"1108","phs001151.v1.pht005540.v1.p1",2,3,5,"06/21/2016","dbgap"
"1110","phs001392.v1.pht006888.v1.p1",17,9,26,"2017/09/22","dbgap"
"1111","phs002416.v1.pht011230.v1.p1",3,16,19,"2021/05/18","dbgap"
"1113","phs000690.v1.pht003620.v1.p1",15,45,60,"12/16/2013","dbgap"
"1114","phs000181.v1.pht000806.v1.p1",5307,5416,10723,"12/11/2009","dbgap"
"1115","phs001312.v1.pht007200.v1.p1",2045,3143,5188,"2017/12/07","dbgap"
"1116","phs001442.v3.pht010304.v2.p2",6522,7316,13838,"2021/08/13","dbgap"
"1117","phs001956.v1.pht009785.v1.p1",8,7,15,"2020/01/10","dbgap"
"1120","phs000778.v1.pht003970.v1.p1",1,4,5,"07/28/2014","dbgap"
"1121","phs000649.v2.pht008341.v1.p2",209,192,401,"2021/01/08","dbgap"
"1122","phs000267.v5.pht002355.v2.p2",4901,2979,7880,"03/02/2016","dbgap"
"1123","phs000280.v7.pht004162.v2.p1",6120,7410,13530,"2020/06/18","dbgap"
"1125","phs000896.v1.pht005123.v1.p1",5,7,12,"11/16/2015","dbgap"
"1126","phs000594.v1.pht006505.v1.p1",5,3,8,"06/12/2017","dbgap"
"1127","phs002046.v1.pht010624.v1.p1",1401,4157,5558,"2020/11/02","dbgap"
"1128","phs002499.v1.pht011446.v1.p1",6,3,9,"2021/08/05","dbgap"
"1129","phs001576.v2.pht008220.v2.p2",35,17,52,"2019/09/27","dbgap"
"1130","phs000577.v1.pht007285.v1.p1",17,41,58,"2017/12/20","dbgap"
"1131","phs001676.v1.pht009439.v1.p1",5431,3770,9201,"2020/04/24","dbgap"
"1132","phs000574.v1.pht005865.v1.p1",41,972,1013,"03/06/2017","dbgap"
"1134","phs000546.v1.pht003144.v1.p1",40,35,75,"07/09/2013","dbgap"
"1137","phs002146.v1.pht011085.v1.p1",2,1,3,"2021/03/30","dbgap"
"1138","phs001224.v1.pht005941.v1.p1",9,8,17,"11/18/2016","dbgap"
"1139","phs001064.v1.pht006832.v1.p1",3,3,6,"2018/02/27","dbgap"
"1140","phs001854.v1.pht009251.v1.p1",3,3,6,"2019/10/07","dbgap"
"1141","phs001736.v1.pht009329.v1.p1",1504,881,2385,"2019/07/29","dbgap"
"1142","phs001772.v2.pht008633.v2.p1",41,41,82,"2021/07/09","dbgap"
"1143","phs000687.v1.pht003695.v1.p1",905,921,1826,"06/13/2014","dbgap"
"1145","phs001271.v1.pht006116.v1.p1",3208,2099,5307,"02/08/2017","dbgap"
"1146","phs000964.v5.pht004840.v2.p1",1239,2084,3323,"2021/05/12","dbgap"
"1147","phs000092.v1.pht000116.v1.p1",1882,2239,4121,"Wed Nov 19 17:39:49 2008","dbgap"
"1148","phs000817.v1.pht004414.v1.p1",6,10,16,"01/05/2015","dbgap"
"1149","phs000564.v2.pht003060.v2.p1",141,137,278,"07/09/2015","dbgap"
"1151","phs001318.v1.pht008030.v1.p1",27,13,40,"2018/05/31","dbgap"
"1152","phs001253.v1.pht006164.v1.p1",486,77,563,"02/23/2017","dbgap"
"1153","phs000574.v1.pht005866.v1.p1",41,972,1013,"03/06/2017","dbgap"
"1154","phs000101.v5.pht002167.v1.p1",78,63,141,"2018/08/19","dbgap"
"1155","phs001596.v1.pht007964.v1.p1",15,22,37,"2018/05/17","dbgap"
"1156","phs002464.v1.pht011334.v1.p1",9,1,10,"2021/07/21","dbgap"
"1157","phs000240.v1.pht002279.v1.p1",470,602,1072,"08/03/2011","dbgap"
"1158","phs002614.v1.pht011588.v1.p1",5,7,12,"2021/09/30","dbgap"
"1159","phs001829.v1.pht010165.v1.p1",10,7,17,"2020/04/24","dbgap"
"1160","phs001407.v1.pht006667.v1.p1",1,10,11,"2017/08/25","dbgap"
"1161","phs002486.v1.pht011472.v1.p1",10,10,20,"2021/08/13","dbgap"
"1162","phs000101.v5.pht003747.v1.p1",156,136,292,"2018/08/19","dbgap"
"1163","phs000287.v7.pht001485.v1.p1",2375,3156,5531,"2020/01/23","dbgap"
"1164","phs000666.v1.pht003572.v1.p1",10,17,27,"01/13/2014","dbgap"
"1165","phs001600.v2.pht011020.v2.p2",653,618,1271,"2021/07/15","dbgap"
"1166","phs001876.v1.pht009387.v1.p1",611,405,1016,"2019/08/10","dbgap"
"1167","phs001488.v1.pht007379.v1.p1",2,2,4,"2018/02/08","dbgap"
"1168","phs001130.v1.pht008417.v1.p1",96,151,247,"2018/09/26","dbgap"
"1169","phs000019.v1.pht000180.v1.p1",39,38,77,"Thu Jan 17 21:45:41 2008","dbgap"
"1171","phs000744.v4.pht003980.v4.p2",1030,851,1881,"08/01/2016","dbgap"
"1173","phs001235.v1.pht008449.v1.p1",2,3,5,"2019/03/21","dbgap"
"1175","phs000742.v1.pht008111.v1.p1",89,77,166,"2018/07/23","dbgap"
"1176","phs000718.v1.pht003842.v1.p1",1058,1128,2186,"06/09/2015","dbgap"
"1177","phs001329.v2.pht007181.v2.p1",1,4,5,"2019/05/07","dbgap"
"1178","phs000280.v7.pht009479.v2.p1",4759,6028,10787,"2020/06/18","dbgap"
"1179","phs001662.v2.pht010071.v1.p1",843,758,1601,"2021/08/19","dbgap"
"1180","phs000343.v3.pht003154.v1.p1",1379,785,2164,"03/12/2013","dbgap"
"1181","phs001684.v1.pht008391.v1.p1",16,18,34,"2018/09/19","dbgap"
"1183","phs001571.v1.pht009504.v1.p1",969,1274,2243,"2020/08/06","dbgap"
"1184","phs000357.v2.pht002332.v1.p1",82,715,797,"2018/09/19","dbgap"
"1185","phs000257.v3.pht001250.v2.p1",11,13,24,"2018/09/19","dbgap"
"1186","phs001252.v1.pht006387.v1.p1",1686,1052,2738,"05/16/2017","dbgap"
"1187","phs000343.v3.pht003152.v1.p1",17,11,28,"03/12/2013","dbgap"
"1188","phs002015.v1.pht010381.v1.p1",1816,2386,4202,"2020/09/18","dbgap"
"1190","phs001889.v1.pht009740.v1.p1",10,7,17,"2019/12/26","dbgap"
"1191","phs000128.v3.pht000582.v2.p3",2943,3500,6443,"04/29/2016","dbgap"
"1192","phs000287.v7.pht003697.v2.p1",511,688,1199,"2020/01/23","dbgap"
"1193","phs002185.v1.pht010967.v1.p1",3713,2200,5913,"2021/08/24","dbgap"
"1194","phs001442.v3.pht010300.v1.p2",899,715,1614,"2021/08/13","dbgap"
"1196","phs000374.v1.pht002357.v1.p1",4,3,7,"08/31/2011","dbgap"
"1197","phs002197.v1.pht010610.v1.p1",9,7,16,"2020/11/17","dbgap"
"1198","phs000579.v1.pht003278.v1.p1",25,25,50,"11/04/2013","dbgap"
"1199","phs000280.v7.pht004139.v2.p1",5247,6456,11703,"2020/06/18","dbgap"
"1200","phs000086.v3.pht000235.v1.p1",761,680,1441,"11/04/2014","dbgap"
"1201","phs001855.v1.pht009249.v1.p1",382,501,883,"2019/07/29","dbgap"
"1203","phs000345.v1.pht002376.v1.p1",545,483,1028,"09/15/2011","dbgap"
"1205","phs000879.v1.pht005033.v1.p1",15,15,30,"10/14/2015","dbgap"
"1207","phs001326.v1.pht007810.v1.p1",22,4,26,"2018/04/16","dbgap"
"1208","phs001641.v1.pht010031.v1.p1",422,1024,1446,"2020/03/24","dbgap"
"1209","phs000254.v2.pht002226.v2.p1",210,206,416,"10/11/2012","dbgap"
"1211","phs002493.v1.pht011464.v1.p1",57,32,89,"2021/09/21","dbgap"
"1213","phs000578.v1.pht007007.v1.p1",24,20,44,"2017/10/11","dbgap"
"1214","phs000507.v2.pht008526.v1.p2",424,764,1188,"2018/11/05","dbgap"
"1215","phs000273.v1.pht001433.v1.p1",16,9,25,"07/08/2011","dbgap"
"1216","phs000007.v32.pht010740.v1.p13",183,238,421,"2020/12/21","dbgap"
"1217","phs001036.v1.pht005268.v1.p1",21,13,34,"02/27/2017","dbgap"
"1218","phs001253.v1.pht006167.v1.p1",486,77,563,"02/23/2017","dbgap"
"1219","phs000286.v6.pht008726.v1.p2",105,122,227,"2019/03/11","dbgap"
"1220","phs000339.v2.pht002135.v1.p1",49,91,140,"02/22/2013","dbgap"
"1221","phs000314.v1.pht002071.v1.p1",878,838,1716,"07/17/2012","dbgap"
"1222","phs001912.v1.pht009624.v1.p1",72,8,80,"2020/10/14","dbgap"
"1224","phs000280.v7.pht006446.v1.p1",707,999,1706,"2020/06/18","dbgap"
"1225","phs000406.v1.pht002406.v1.p1",31,26,57,"10/25/2011","dbgap"
"1227","phs000286.v6.pht008770.v1.p2",1295,2163,3458,"2019/03/11","dbgap"
"1228","phs000575.v2.pht005889.v2.p1",2,5,7,"2020/02/14","dbgap"
"1229","phs000287.v7.pht001460.v1.p1",2375,3156,5531,"2020/01/23","dbgap"
"1230","phs000414.v1.pht002729.v1.p1",9,8,17,"05/11/2012","dbgap"
"1231","phs001288.v1.pht006766.v1.p1",64,43,107,"2017/10/19","dbgap"
"1232","phs000171.v1.pht000772.v1.p1",636,1283,1919,"12/11/2009","dbgap"
"1233","phs000521.v2.pht007041.v2.p1",70,57,127,"2020/03/13","dbgap"
"1234","phs002245.v1.pht010532.v1.p1",338,246,584,"2020/10/16","dbgap"
"1236","phs000482.v1.pht002883.v1.p1",350,267,617,"12/07/2015","dbgap"
"1239","phs000292.v1.pht001527.v1.p1",1058,804,1862,"07/15/2010","dbgap"
"1241","phs001655.v1.pht008258.v1.p1",35,47,82,"2018/08/06","dbgap"
"1244","phs000007.v32.pht002152.v1.p13",258,439,697,"2020/12/21","dbgap"
"1249","phs002301.v1.pht010816.v1.p1",50,30,80,"2020/12/22","dbgap"
"1250","phs001616.v2.pht008545.v2.p2",10925,12627,23552,"2020/10/27","dbgap"
"1251","phs001432.v1.pht006976.v1.p1",4,2,6,"2017/10/05","dbgap"
"1252","phs001481.v1.pht008130.v1.p1",238,218,456,"2018/06/07","dbgap"
"1253","phs000285.v3.pht001829.v2.p2",876,989,1865,"08/20/2013","dbgap"
"1254","phs001288.v1.pht006783.v1.p1",64,43,107,"2017/10/19","dbgap"
"1255","phs000833.v7.pht004360.v6.p1",29,15,44,"2017/11/01","dbgap"
"1256","phs000021.v3.pht000068.v1.p2",668,774,1442,"10/25/2010","dbgap"
"1257","phs000445.v1.pht002506.v1.p1",17,3,20,"10/15/2012","dbgap"
"1259","phs001430.v2.pht008085.v2.p1",13,10,23,"2020/02/06","dbgap"
"1260","phs000153.v9.pht000836.v8.p8",4114,4819,8933,"07/16/2015","dbgap"
"1261","phs000279.v2.pht003003.v1.p1",405,322,727,"01/11/2016","dbgap"
"1262","phs001247.v1.pht008299.v1.p1",451,448,899,"2018/08/13","dbgap"
"1263","phs000285.v3.pht001759.v2.p2",867,971,1838,"08/20/2013","dbgap"
"1264","phs001295.v2.pht006239.v2.p1",100,182,282,"2019/04/19","dbgap"
"1265","phs001955.v1.pht009794.v1.p1",6666,6737,13403,"2020/07/06","dbgap"
"1266","phs000091.v2.pht000800.v2.p1",2591,3425,6016,"08/24/2009","dbgap"
"1267","phs002259.v1.pht011024.v1.p1",5,20,25,"2021/05/28","dbgap"
"1268","phs001415.v1.pht006685.v1.p1",15174,14566,29740,"2019/03/25","dbgap"
"1269","phs000285.v3.pht001780.v2.p2",868,970,1838,"08/20/2013","dbgap"
"1270","phs000376.v1.pht002308.v1.p1",23,21,44,"10/16/2014","dbgap"
"1271","phs000285.v3.pht001597.v2.p2",909,1033,1942,"08/20/2013","dbgap"
"1272","phs000710.v1.pht003987.v1.p1",1,2,3,"04/29/2015","dbgap"
"1273","phs000222.v6.pht006857.v2.p2",391,657,1048,"2019/08/01","dbgap"
"1274","phs001341.v1.pht006246.v1.p1",36,54,90,"2017/11/30","dbgap"
"1276","phs000007.v32.pht003312.v1.p13",109,176,285,"2020/12/21","dbgap"
"1278","phs001252.v1.pht006368.v1.p1",1688,1053,2741,"05/16/2017","dbgap"
"1279","phs000226.v2.pht002288.v1.p1",1567,2428,3995,"07/18/2011","dbgap"
"1280","phs001201.v2.pht007556.v1.p1",24,29,53,"2019/08/18","dbgap"
"1281","phs000007.v32.pht003629.v3.p13",1306,1325,2631,"2020/12/21","dbgap"
"1282","phs001580.v1.pht008291.v1.p1",15,26,41,"2018/08/06","dbgap"
"1283","phs001108.v1.pht007718.v1.p1",7,16,23,"2018/03/30","dbgap"
"1284","phs000622.v1.pht003956.v1.p1",1584,1973,3557,"07/25/2014","dbgap"
"1285","phs001488.v1.pht007374.v1.p1",260,293,553,"2018/02/08","dbgap"
"1286","phs000286.v6.pht008776.v1.p2",928,1552,2480,"2019/03/11","dbgap"
"1287","phs000170.v2.pht003533.v1.p1",1628,2319,3947,"02/27/2015","dbgap"
"1289","phs001867.v1.pht009353.v1.p1",6,7,13,"2019/08/05","dbgap"
"1290","phs000951.v5.pht005051.v5.p5",5660,4987,10647,"2021/09/27","dbgap"
"1292","phs000280.v7.pht004150.v2.p1",487,612,1099,"2020/06/18","dbgap"
"1293","phs000286.v6.pht008747.v1.p2",920,1532,2452,"2019/03/11","dbgap"
"1296","phs000007.v32.pht002235.v6.p13",1573,1777,3350,"2020/12/21","dbgap"
"1298","phs000670.v1.pht003556.v1.p1",194,335,529,"01/22/2014","dbgap"
"1299","phs000286.v6.pht008743.v1.p2",1295,2163,3458,"2019/03/11","dbgap"
"1300","phs000285.v3.pht001825.v2.p2",880,993,1873,"08/20/2013","dbgap"
"1301","phs001841.v1.pht009904.v1.p1",732,619,1351,"2020/06/02","dbgap"
"1302","phs000673.v4.pht003660.v4.p1",731,557,1288,"2020/03/12","dbgap"
"1303","phs001784.v1.pht009003.v1.p1",30,11,41,"2019/06/24","dbgap"
"1304","phs001169.v2.pht006186.v2.p1",104,28,132,"2020/06/10","dbgap"
"1305","phs001513.v1.pht007357.v1.p1",71,38,109,"2018/01/18","dbgap"
"1306","phs000349.v1.pht002191.v1.p1",848,220,1068,"05/02/2011","dbgap"
"1307","phs000222.v6.pht002873.v3.p2",535,950,1485,"2019/08/01","dbgap"
"1308","phs000578.v1.pht007009.v1.p1",49,45,94,"2017/10/11","dbgap"
"1310","phs001573.v1.pht010178.v1.p1",29,10,39,"2020/04/29","dbgap"
"1311","phs000280.v7.pht006468.v1.p1",1726,2326,4052,"2020/06/18","dbgap"
"1312","phs000286.v6.pht001964.v3.p2",1291,2154,3445,"2019/03/11","dbgap"
"1313","phs000007.v32.pht000605.v5.p13",882,1010,1892,"2020/12/21","dbgap"
"1315","phs001780.v1.pht008712.v1.p1",379,316,695,"2019/02/11","dbgap"
"1316","phs001469.v1.pht007167.v1.p1",12,5,17,"2018/02/27","dbgap"
"1317","phs000789.v1.pht004289.v1.p1",1065,1477,2542,"10/21/2015","dbgap"
"1318","phs000285.v3.pht001791.v2.p2",867,969,1836,"08/20/2013","dbgap"
"1320","phs001238.v2.pht006031.v1.p1",168,443,611,"2018/06/14","dbgap"
"1321","phs000637.v1.pht003537.v1.p1",650,617,1267,"10/21/2013","dbgap"
"1323","phs000101.v5.pht001149.v4.p1",8696,6694,15390,"2018/08/19","dbgap"
"1325","phs001820.v1.pht010239.v1.p1",75,45,120,"2020/05/26","dbgap"
"1327","phs000454.v1.pht003326.v1.p1",30,24,54,"06/17/2013","dbgap"
"1328","phs002393.v1.pht011138.v1.p1",68,70,138,"2021/04/28","dbgap"
"1329","phs000007.v32.pht000155.v2.p13",513,784,1297,"2020/12/21","dbgap"
"1330","phs001328.v1.pht006304.v1.p1",32,22,54,"05/17/2017","dbgap"
"1331","phs001298.v1.pht008646.v1.p1",2298,2504,4802,"2019/01/29","dbgap"
"1333","phs000401.v1.pht002476.v1.p1",153,54,207,"03/01/2012","dbgap"
"1334","phs002407.v1.pht011355.v1.p1",31,31,62,"2021/09/20","dbgap"
"1335","phs001805.v1.pht008955.v1.p1",2,2,4,"2019/04/09","dbgap"
"1336","phs000007.v32.pht010741.v1.p13",125,193,318,"2020/12/21","dbgap"
"1337","phs002486.v1.pht011470.v1.p1",10,10,20,"2021/08/13","dbgap"
"1338","phs000346.v2.pht004007.v1.p2",9054,2370,11424,"06/01/2015","dbgap"
"1339","phs000784.v3.pht004285.v1.p1",518,482,1000,"2019/11/15","dbgap"
"1340","phs002234.v1.pht010515.v1.p1",3,1,4,"2020/09/15","dbgap"
"1341","phs000128.v3.pht000542.v2.p3",2943,3500,6443,"04/29/2016","dbgap"
"1342","phs000285.v3.pht001657.v2.p2",28,44,72,"08/20/2013","dbgap"
"1344","phs001293.v3.pht008896.v1.p1",775,1329,2104,"2021/06/09","dbgap"
"1345","phs000007.v32.pht005158.v3.p13",1391,1513,2904,"2020/12/21","dbgap"
"1346","phs000518.v1.pht002849.v1.p1",7,17,24,"08/17/2012","dbgap"
"1347","phs001420.v1.pht009145.v1.p1",437,391,828,"2019/06/06","dbgap"
"1348","phs000219.v1.pht001091.v1.p1",664,1054,1718,"01/19/2010","dbgap"
"1349","phs001706.v1.pht008457.v1.p1",17,15,32,"2018/10/11","dbgap"
"1350","phs000629.v1.pht003387.v1.p1",585,968,1553,"04/24/2015","dbgap"
"1351","phs000674.v1.pht003641.v1.p1",32008,46478,78486,"01/27/2014","dbgap"
"1352","phs001473.v1.pht009690.v1.p1",38,23,61,"2020/12/15","dbgap"
"1353","phs001514.v2.pht009815.v1.p1",205,229,434,"2021/06/28","dbgap"
"1354","phs000791.v2.pht004591.v2.p1",21,23,44,"2020/01/10","dbgap"
"1356","phs000128.v3.pht000439.v2.p3",2943,3500,6443,"04/29/2016","dbgap"
"1357","phs000286.v6.pht008774.v1.p2",1295,2163,3458,"2019/03/11","dbgap"
"1358","phs001041.v1.pht005393.v1.p1",39,25,64,"06/09/2016","dbgap"
"1360","phs000684.v1.pht003643.v1.p1",2193,3128,5321,"05/14/2014","dbgap"
"1361","phs001392.v1.pht006887.v1.p1",17,9,26,"2017/09/22","dbgap"
"1362","phs000713.v1.pht004271.v1.p1",328,380,708,"10/16/2014","dbgap"
"1363","phs000367.v1.pht003264.v1.p1",326,373,699,"08/09/2013","dbgap"
"1364","phs002022.v1.pht010181.v1.p1",8,15,23,"2020/07/10","dbgap"
"1365","phs001584.v2.pht009071.v2.p2",42010,49552,91562,"2020/11/13","dbgap"
"1366","phs002185.v1.pht010969.v1.p1",1664,1266,2930,"2021/08/24","dbgap"
"1368","phs000280.v7.pht004200.v2.p1",4883,6019,10902,"2020/06/18","dbgap"
"1369","phs000916.v1.pht004737.v1.p1",516,283,799,"07/26/2016","dbgap"
"1370","phs000711.v7.pht003724.v6.p2",1239,1193,2432,"2021/03/24","dbgap"
"1371","phs001316.v1.pht008006.v1.p1",2,1,3,"2018/05/31","dbgap"
"1373","phs000361.v1.pht002222.v1.p1",3829,1794,5623,"05/04/2011","dbgap"
"1374","phs001488.v1.pht007415.v1.p1",260,293,553,"2018/02/08","dbgap"
"1375","phs001543.v2.pht009912.v1.p1",265,84,349,"2021/07/08","dbgap"
"1376","phs000343.v3.pht003148.v1.p1",1379,785,2164,"03/12/2013","dbgap"
"1377","phs000888.v1.pht005566.v1.p1",6230,6032,12262,"08/12/2016","dbgap"
"1378","phs000384.v1.pht002464.v1.p1",2,2,4,"06/01/2012","dbgap"
"1379","phs000757.v1.pht003924.v1.p1",33,21,54,"06/30/2014","dbgap"
"1380","phs001412.v3.pht006747.v1.p1",169,234,403,"2021/06/16","dbgap"
"1381","phs001748.v1.pht008576.v1.p1",7,14,21,"2021/02/04","dbgap"
"1383","phs000139.v1.pht000622.v1.p1",1247,1755,3002,"Thu Nov 20 13:23:05 2008","dbgap"
"1384","phs001328.v1.pht006305.v1.p1",9,9,18,"05/17/2017","dbgap"
"1385","phs000998.v2.pht005057.v2.p1",14,20,34,"2020/08/26","dbgap"
"1386","phs000280.v7.pht006439.v4.p1",1224,1399,2623,"2020/06/18","dbgap"
"1387","phs000793.v1.pht004020.v1.p1",13,5,18,"09/12/2014","dbgap"
"1388","phs001176.v3.pht005795.v2.p1",17,12,29,"2019/10/23","dbgap"
"1389","phs002335.v1.pht010942.v1.p1",6,6,12,"2021/02/08","dbgap"
"1390","phs001837.v1.pht009313.v1.p1",78,46,124,"2019/08/26","dbgap"
"1392","phs001326.v1.pht007814.v1.p1",25,5,30,"2018/04/16","dbgap"
"1393","phs000128.v3.pht000403.v2.p3",2943,3500,6443,"04/29/2016","dbgap"
"1394","phs000285.v3.pht001632.v2.p2",912,1037,1949,"08/20/2013","dbgap"
"1396","phs000089.v3.pht000178.v3.p2",560,377,937,"04/01/2010","dbgap"
"1397","phs002433.v1.pht011259.v1.p1",22,16,38,"2021/05/27","dbgap"
"1398","phs001858.v1.pht009373.v1.p1",7956,9127,17083,"2019/10/25","dbgap"
"1399","phs001890.v1.pht009546.v1.p1",10,7,17,"2020/05/01","dbgap"
"1400","phs002034.v1.pht010253.v1.p1",23,16,39,"2020/05/27","dbgap"
"1401","phs000346.v2.pht002184.v2.p2",9054,2370,11424,"06/01/2015","dbgap"
"1402","phs001788.v1.pht008816.v1.p1",3903,858,4761,"2019/03/05","dbgap"
"1403","phs000888.v1.pht005570.v1.p1",775,1135,1910,"08/12/2016","dbgap"
"1406","phs001207.v3.pht005792.v3.p1",376,957,1333,"2021/07/09","dbgap"
"1407","phs001688.v1.pht008593.v1.p1",23,12,35,"2018/12/06","dbgap"
"1408","phs001839.v1.pht009355.v1.p1",1,2,3,"2019/08/01","dbgap"
"1409","phs000285.v3.pht001817.v2.p2",561,583,1144,"08/20/2013","dbgap"
"1411","phs000128.v3.pht000465.v2.p3",2943,3500,6443,"04/29/2016","dbgap"
"1412","phs001332.v2.pht007460.v2.p1",154,188,342,"2019/11/08","dbgap"
"1413","phs001281.v2.pht006129.v2.p1",3,7,10,"2019/02/21","dbgap"
"1415","phs001903.v1.pht009895.v1.p1",18421,19016,37437,"2020/09/03","dbgap"
"1416","phs000888.v1.pht005572.v1.p1",2970,2597,5567,"08/12/2016","dbgap"
"1417","phs000007.v32.pht001415.v20.p13",4774,5679,10453,"2020/12/21","dbgap"
"1418","phs000007.v32.pht006009.v4.p13",1758,1997,3755,"2020/12/21","dbgap"
"1419","phs000603.v1.pht007547.v1.p1",5,10,15,"2018/03/06","dbgap"
"1420","phs001711.v1.pht008529.v1.p1",5,3,8,"2021/02/11","dbgap"
"1423","phs000209.v13.pht002198.v2.p3",944,911,1855,"11/05/2014","dbgap"
"1424","phs000504.v2.pht002822.v2.p2",55,37,92,"11/27/2013","dbgap"
"1425","phs000086.v3.pht000248.v1.p1",761,680,1441,"11/04/2014","dbgap"
"1426","phs000456.v1.pht002640.v1.p1",1441,1202,2643,"05/02/2012","dbgap"
"1427","phs002015.v1.pht010393.v1.p1",66,71,137,"2020/09/18","dbgap"
"1428","phs001741.v1.pht009162.v1.p1",573,332,905,"2020/01/07","dbgap"
"1429","phs000001.v3.pht000370.v2.p1",405,582,987,"02/24/2012","dbgap"
"1430","phs001808.v1.pht008972.v1.p1",4,10,14,"2019/04/19","dbgap"
"1431","phs001774.v1.pht008802.v1.p1",22,28,50,"2020/02/27","dbgap"
"1432","phs000636.v1.pht003426.v1.p1",32,44,76,"08/09/2013","dbgap"
"1433","phs001954.v1.pht009798.v1.p1",36,53,89,"2020/01/10","dbgap"
"1434","phs000128.v3.pht000471.v2.p3",2943,3500,6443,"04/29/2016","dbgap"
"1435","phs001108.v1.pht007715.v1.p1",10,36,46,"2018/03/30","dbgap"
"1436","phs000972.v5.pht005680.v2.p1",532,800,1332,"2021/05/20","dbgap"
"1437","phs000609.v1.pht003285.v1.p1",18,9,27,"05/14/2013","dbgap"
"1438","phs001662.v2.pht010060.v1.p1",843,758,1601,"2021/08/19","dbgap"
"1439","phs001573.v1.pht010177.v1.p1",29,10,39,"2020/04/29","dbgap"
"1440","phs000280.v7.pht004101.v5.p1",1019,1152,2171,"2020/06/18","dbgap"
"1441","phs000888.v1.pht004681.v1.p1",25246,29783,55029,"08/12/2016","dbgap"
"1443","phs000888.v1.pht005553.v1.p1",420,162,582,"08/12/2016","dbgap"
"1444","phs002408.v1.pht011161.v1.p1",4,3,7,"2021/04/28","dbgap"
"1445","phs000658.v1.pht003496.v1.p1",493,945,1438,"01/13/2014","dbgap"
"1448","phs000690.v1.pht003619.v1.p1",97,120,217,"12/16/2013","dbgap"
"1449","phs000337.v1.pht005336.v1.p1",56,38,94,"03/15/2016","dbgap"
"1450","phs000639.v1.pht004780.v1.p1",465,302,767,"11/02/2015","dbgap"
"1451","phs001084.v1.pht005327.v1.p1",8,10,18,"03/07/2016","dbgap"
"1452","phs000280.v7.pht004097.v2.p1",4408,5411,9819,"2020/06/18","dbgap"
"1454","phs000571.v3.pht003180.v3.p2",1653,1220,2873,"12/01/2015","dbgap"
"1455","phs001380.v1.pht009234.v1.p1",266,172,438,"2019/10/11","dbgap"
"1456","phs002055.v1.pht010345.v1.p1",177,99,276,"2020/07/10","dbgap"
"1457","phs001221.v1.pht007157.v1.p1",34944,461,35405,"2020/02/19","dbgap"
"1458","phs001895.v2.pht009443.v2.p1",184,102,286,"2020/01/02","dbgap"
"1459","phs001571.v1.pht009505.v1.p1",964,1270,2234,"2020/08/06","dbgap"
"1460","phs001879.v1.pht009455.v1.p1",92,77,169,"2019/09/19","dbgap"
"1461","phs000088.v1.pht000712.v1.p1",1427,1595,3022,"Tue Nov 18 09:14:37 2008","dbgap"
"1462","phs001318.v1.pht008036.v1.p1",27,13,40,"2018/05/31","dbgap"
"1463","phs000414.v1.pht002731.v1.p1",9,8,17,"05/11/2012","dbgap"
"1464","phs001697.v1.pht010576.v1.p1",57,175,232,"2021/01/12","dbgap"
"1465","phs001841.v1.pht009906.v1.p1",327,225,552,"2020/06/02","dbgap"
"1466","phs000280.v7.pht004037.v3.p1",6697,8046,14743,"2020/06/18","dbgap"
"1467","phs002632.v1.pht011605.v1.p1",242,607,849,"2021/10/19","dbgap"
"1469","phs000741.v2.pht003915.v2.p1",4251,4157,8408,"11/14/2016","dbgap"
"1470","phs001157.v1.pht005805.v1.p1",4331,4696,9027,"04/17/2017","dbgap"
"1471","phs000430.v1.pht003055.v1.p1",696,270,966,"06/20/2013","dbgap"
"1472","phs000669.v1.pht003730.v1.p1",34,6855,6889,"10/18/2016","dbgap"
"1474","phs001368.v3.pht007958.v3.p2",2068,2809,4877,"2021/08/24","dbgap"
"1475","phs000222.v6.pht007353.v1.p2",490,849,1339,"2019/08/01","dbgap"
"1476","phs000313.v4.pht002395.v3.p2",845,1232,2077,"2017/11/22","dbgap"
"1477","phs001389.v1.pht006602.v1.p1",6,7,13,"06/27/2017","dbgap"
"1478","phs000263.v1.pht001235.v1.p1",40,54,94,"06/14/2010","dbgap"
"1479","phs001792.v1.pht008931.v1.p1",92,372,464,"2019/04/15","dbgap"
"1480","phs001326.v1.pht007812.v1.p1",3,1,4,"2018/04/16","dbgap"
"1481","phs000285.v3.pht001698.v2.p2",947,1065,2012,"08/20/2013","dbgap"
"1482","phs001544.v2.pht009896.v1.p1",114,7,121,"2021/07/09","dbgap"
"1483","phs002493.v1.pht011463.v1.p1",57,32,89,"2021/09/21","dbgap"
"1484","phs000347.v1.pht003126.v1.p1",19,10,29,"07/09/2013","dbgap"
"1485","phs001368.v3.pht007957.v3.p2",2068,2809,4877,"2021/08/24","dbgap"
"1486","phs000697.v1.pht007703.v1.p1",21,4,25,"2018/03/26","dbgap"
"1487","phs001677.v1.pht008377.v1.p1",182,911,1093,"2018/09/17","dbgap"
"1488","phs000606.v1.pht007568.v1.p1",744,275,1019,"2018/03/09","dbgap"
"1490","phs001385.v1.pht007166.v1.p1",24,165,189,"2017/12/04","dbgap"
"1491","phs000304.v3.pht004468.v1.p1",437,729,1166,"2018/05/03","dbgap"
"1492","phs000748.v7.pht003887.v7.p4",606,400,1006,"2019/02/05","dbgap"
"1493","phs000971.v3.pht004917.v3.p1",646,831,1477,"2021/06/07","dbgap"
"1494","phs000007.v32.pht000078.v8.p13",1462,1708,3170,"2020/12/21","dbgap"
"1495","phs001712.v1.pht008680.v1.p1",2,1,3,"2019/01/31","dbgap"
"1496","phs001723.v1.pht009726.v1.p1",2384,2409,4793,"2020/02/04","dbgap"
"1497","phs000624.v1.pht009129.v1.p1",345,277,622,"2019/06/03","dbgap"
"1498","phs000710.v1.pht003986.v1.p1",1,2,3,"04/29/2015","dbgap"
"1499","phs000578.v1.pht007005.v1.p1",44,36,80,"2017/10/11","dbgap"
"1500","phs001400.v1.pht006822.v1.p1",2,2,4,"2017/11/09","dbgap"
"1501","phs001328.v1.pht006308.v1.p1",52,37,89,"05/17/2017","dbgap"
"1503","phs001419.v1.pht007087.v1.p1",489,501,990,"2017/12/04","dbgap"
"1504","phs002071.v1.pht010454.v1.p1",14,10,24,"2020/12/10","dbgap"
"1505","phs000756.v1.pht008613.v1.p1",4392,4943,9335,"2018/12/27","dbgap"
"1506","phs000265.v3.pht001275.v3.p1",34,31,65,"10/17/2011","dbgap"
"1507","phs001327.v2.pht011185.v1.p1",13721,11937,25658,"2021/05/07","dbgap"
"1508","phs001512.v1.pht007666.v1.p1",7,10,17,"2018/03/21","dbgap"
"1509","phs000209.v13.pht004321.v1.p3",2813,3040,5853,"11/05/2014","dbgap"
"1511","phs000128.v3.pht000517.v2.p3",2943,3500,6443,"04/29/2016","dbgap"
"1513","phs000824.v1.pht005137.v1.p1",37,63,100,"11/24/2015","dbgap"
"1514","phs000219.v1.pht001087.v1.p1",662,1048,1710,"01/19/2010","dbgap"
"1515","phs001491.v2.pht007254.v2.p1",134,171,305,"2020/03/09","dbgap"
"1517","phs000222.v6.pht009347.v1.p2",535,950,1485,"2019/08/01","dbgap"
"1518","phs000128.v3.pht000457.v2.p3",2943,3500,6443,"04/29/2016","dbgap"
"1519","phs001364.v1.pht007466.v1.p1",523,619,1142,"2018/02/27","dbgap"
"1520","phs001680.v1.pht008916.v1.p1",22,10,32,"2019/03/28","dbgap"
"1521","phs001007.v1.pht005067.v1.p1",19,4,23,"11/30/2015","dbgap"
"1522","phs001945.v1.pht010487.v1.p1",46,11243,11289,"2021/05/25","dbgap"
"1523","phs000280.v7.pht006462.v1.p1",2228,2905,5133,"2020/06/18","dbgap"
"1524","phs001519.v1.pht008434.v1.p1",4,6,10,"2018/10/02","dbgap"
"1525","phs000182.v2.pht000795.v1.p1",1341,1999,3340,"08/06/2010","dbgap"
"1526","phs000128.v3.pht000411.v2.p3",2943,3500,6443,"04/29/2016","dbgap"
"1527","phs001771.v1.pht008718.v1.p1",163,280,443,"2021/02/12","dbgap"
"1529","phs001828.v1.pht009370.v1.p1",799,593,1392,"2019/08/01","dbgap"
"1530","phs002327.v1.pht010916.v1.p1",11,13,24,"2021/02/02","dbgap"
"1531","phs001495.v2.pht007196.v2.p1",1,4,5,"2019/01/30","dbgap"
"1532","phs000285.v3.pht001670.v2.p2",904,1008,1912,"08/20/2013","dbgap"
"1533","phs000888.v1.pht005576.v1.p1",13,8,21,"08/12/2016","dbgap"
"1535","phs000219.v1.pht001049.v1.p1",358,498,856,"01/19/2010","dbgap"
"1536","phs001591.v1.pht009692.v1.p1",3437,3585,7022,"2021/08/03","dbgap"
"1537","phs000343.v3.pht003161.v1.p1",1379,785,2164,"03/12/2013","dbgap"
"1538","phs000280.v7.pht004215.v2.p1",1125,1,1126,"2020/06/18","dbgap"
"1539","phs001605.v2.pht010082.v2.p1",109,183,292,"2021/07/22","dbgap"
"1540","phs001108.v1.pht007712.v1.p1",10,36,46,"2018/03/30","dbgap"
"1542","phs001238.v2.pht006659.v1.p1",535,704,1239,"2018/06/14","dbgap"
"1547","phs001779.v1.pht010206.v1.p1",35,121,156,"2020/06/25","dbgap"
"1548","phs000185.v7.pht008409.v1.p1",46,57,103,"2020/04/29","dbgap"
"1549","phs000199.v1.pht000891.v1.p1",922,1104,2026,"01/06/2010","dbgap"
"1550","phs000285.v3.pht001785.v2.p2",868,962,1830,"08/20/2013","dbgap"
"1552","phs001442.v3.pht010299.v1.p2",461,365,826,"2021/08/13","dbgap"
"1553","phs001012.v1.pht005550.v1.p1",549,628,1177,"06/22/2016","dbgap"
"1554","phs001326.v1.pht007833.v1.p1",171,56,227,"2018/04/16","dbgap"
"1556","phs002311.v1.pht010932.v1.p1",41,67,108,"2021/03/30","dbgap"
"1557","phs001576.v2.pht008219.v2.p2",35,17,52,"2019/09/27","dbgap"
"1558","phs002259.v1.pht011026.v1.p1",5,20,25,"2021/05/28","dbgap"
"1559","phs002228.v1.pht010860.v1.p1",38,32,70,"2021/04/23","dbgap"
"1560","phs000560.v1.pht003068.v1.p1",333,510,843,"07/25/2014","dbgap"
"1562","phs001238.v2.pht006650.v1.p1",262,363,625,"2018/06/14","dbgap"
"1563","phs000007.v32.pht005145.v4.p13",464,522,986,"2020/12/21","dbgap"
"1565","phs000921.v4.pht004884.v3.p1",981,1122,2103,"2019/11/20","dbgap"
"1566","phs000287.v7.pht001492.v1.p1",2375,3156,5531,"2020/01/23","dbgap"
"1567","phs000272.v1.pht001444.v1.p1",1413,1080,2493,"09/20/2010","dbgap"
"1568","phs001287.v9.pht006104.v9.p5",941,818,1759,"2021/02/17","dbgap"
"1569","phs000128.v3.pht000600.v2.p3",2943,3500,6443,"04/29/2016","dbgap"
"1570","phs001328.v1.pht006309.v1.p1",53,35,88,"05/17/2017","dbgap"
"1571","phs000577.v1.pht007280.v1.p1",14,16,30,"2017/12/20","dbgap"
"1572","phs002015.v1.pht010363.v1.p1",919,1068,1987,"2020/09/18","dbgap"
"1573","phs000473.v2.pht002597.v2.p2",6600,5780,12380,"08/15/2016","dbgap"
"1574","phs001327.v2.pht011191.v1.p1",2408,2643,5051,"2021/05/07","dbgap"
"1575","phs000360.v3.pht003255.v2.p1",8474,10189,18663,"08/05/2016","dbgap"
"1576","phs000620.v1.pht003894.v1.p1",3135,3649,6784,"03/03/2015","dbgap"
"1578","phs001090.v1.pht009055.v1.p1",1134,2045,3179,"2019/05/21","dbgap"
"1579","phs000280.v7.pht006455.v1.p1",2369,3180,5549,"2020/06/18","dbgap"
"1581","phs000007.v32.pht000820.v7.p13",1579,1773,3352,"2020/12/21","dbgap"
"1582","phs000552.v2.pht003030.v1.p1",12,53,65,"04/08/2014","dbgap"
"1583","phs000128.v3.pht000538.v2.p3",2943,3500,6443,"04/29/2016","dbgap"
"1584","phs001744.v1.pht008570.v1.p1",2317,942,3259,"2020/08/24","dbgap"
"1586","phs001156.v2.pht007050.v1.p1",137,159,296,"2017/10/20","dbgap"
"1588","phs001009.v1.pht005349.v1.p1",75,107,182,"03/28/2016","dbgap"
"1589","phs000007.v32.pht000013.v3.p13",1216,1636,2852,"2020/12/21","dbgap"
"1590","phs000576.v1.pht006155.v1.p1",81,98,179,"05/24/2017","dbgap"
"1591","phs000678.v1.pht003566.v1.p1",570,2772,3342,"05/13/2014","dbgap"
"1592","phs000739.v1.pht003828.v1.p1",5,2,7,"05/02/2014","dbgap"
"1594","phs000516.v2.pht002829.v2.p1",34,25,59,"03/10/2015","dbgap"
"1598","phs000086.v3.pht000338.v1.p1",58,39,97,"11/04/2014","dbgap"
"1599","phs000285.v3.pht001818.v2.p2",880,993,1873,"08/20/2013","dbgap"
"1601","phs002059.v1.pht010426.v1.p1",925,887,1812,"2020/12/18","dbgap"
"1602","phs000660.v1.pht003508.v1.p1",5,7,12,"06/04/2014","dbgap"
"1604","phs000187.v1.pht000814.v1.p1",1814,1301,3115,"04/23/2010","dbgap"
"1607","phs000007.v32.pht000074.v13.p13",1896,2168,4064,"2020/12/21","dbgap"
"1609","phs000996.v2.pht005752.v1.p1",698,687,1385,"2019/10/11","dbgap"
"1610","phs001392.v1.pht006893.v1.p1",11,4,15,"2017/09/22","dbgap"
"1611","phs001701.v1.pht009375.v1.p1",425,884,1309,"2019/08/06","dbgap"
"1613","phs002437.v1.pht011431.v1.p1",8,9,17,"2021/07/29","dbgap"
"1614","phs001912.v1.pht009623.v1.p1",72,8,80,"2020/10/14","dbgap"
"1615","phs001518.v1.pht007331.v1.p1",1764,815,2579,"2020/01/07","dbgap"
"1617","phs000285.v3.pht001655.v2.p2",908,1014,1922,"08/20/2013","dbgap"
"1619","phs001459.v1.pht007309.v1.p1",7,29,36,"2020/09/28","dbgap"
"1620","phs000436.v1.pht002834.v1.p1",745,457,1202,"11/19/2013","dbgap"
"1621","phs000346.v2.pht002185.v2.p2",9054,2370,11424,"06/01/2015","dbgap"
"1623","phs001576.v2.pht008221.v2.p2",34,17,51,"2019/09/27","dbgap"
"1624","phs000391.v1.pht002995.v1.p1",332,334,666,"11/16/2012","dbgap"
"1627","phs002185.v1.pht010970.v1.p1",3687,2179,5866,"2021/08/24","dbgap"
"1628","phs001487.v1.pht007137.v1.p1",518,249,767,"2018/08/02","dbgap"
"1629","phs000997.v5.pht005688.v3.p2",118,55,173,"2021/05/20","dbgap"
"1632","phs001432.v1.pht006978.v1.p1",4,2,6,"2017/10/05","dbgap"
"1634","phs001055.v1.pht005911.v1.p1",1200,1197,2397,"2017/08/16","dbgap"
"1635","phs001005.v2.pht005039.v2.p1",3,1,4,"2019/11/01","dbgap"
"1636","phs001326.v1.pht007822.v1.p1",19,4,23,"2018/04/16","dbgap"
"1637","phs001288.v1.pht006781.v1.p1",56,40,96,"2017/10/19","dbgap"
"1639","phs000127.v2.pht000649.v1.p1",119,102,221,"09/03/2010","dbgap"
"1640","phs000166.v2.pht000706.v1.p1",2474,2176,4650,"09/03/2009","dbgap"
"1641","phs001339.v1.pht006789.v1.p1",712,748,1460,"2020/06/02","dbgap"
"1642","phs002176.v2.pht010947.v2.p1",18,20,38,"2021/05/10","dbgap"
"1643","phs000652.v1.pht003457.v1.p1",4326,2485,6811,"09/03/2013","dbgap"
"1645","phs000007.v32.pht000674.v7.p13",1509,1682,3191,"2020/12/21","dbgap"
"1646","phs000461.v1.pht003686.v1.p1",41,29,70,"02/12/2014","dbgap"
"1647","phs000997.v5.pht005088.v3.p2",118,55,173,"2021/05/20","dbgap"
"1648","phs000007.v32.pht000086.v3.p13",383,579,962,"2020/12/21","dbgap"
"1649","phs000219.v1.pht001055.v1.p1",162,250,412,"01/19/2010","dbgap"
"1650","phs000159.v9.pht002460.v7.p5",49,48,97,"2019/12/06","dbgap"
"1651","phs000285.v3.pht001648.v2.p2",138,131,269,"08/20/2013","dbgap"
"1653","phs000205.v6.pht001429.v6.p2",23970,16571,40541,"06/13/2016","dbgap"
"1654","phs000922.v2.pht004925.v2.p1",252,83,335,"2021/05/24","dbgap"
"1655","phs000179.v6.pht002238.v6.p2",5360,4643,10003,"2018/04/23","dbgap"
"1656","phs000128.v3.pht000515.v2.p3",2943,3500,6443,"04/29/2016","dbgap"
"1658","phs000144.v1.pht000726.v1.p1",165,216,381,"Wed Jan 21 13:20:50 2009","dbgap"
"1661","phs001108.v1.pht007717.v1.p1",10,36,46,"2018/03/30","dbgap"
"1662","phs000019.v1.pht000179.v1.p1",672,723,1395,"Thu Jan 17 21:45:40 2008","dbgap"
"1663","phs001855.v1.pht009248.v1.p1",277,323,600,"2019/07/29","dbgap"
"1664","phs000128.v3.pht000495.v2.p3",2943,3500,6443,"04/29/2016","dbgap"
"1665","phs000741.v2.pht003918.v2.p1",458,510,968,"11/14/2016","dbgap"
"1666","phs000370.v2.pht002383.v1.p1",69,23,92,"04/14/2014","dbgap"
"1667","phs000168.v2.pht000708.v2.p2",4221,5233,9454,"08/27/2012","dbgap"
"1668","phs000016.v2.pht000052.v2.p2",797,118,915,"11/27/2009","dbgap"
"1670","phs000007.v32.pht002074.v6.p13",1869,2141,4010,"2020/12/21","dbgap"
"1672","phs001723.v1.pht009728.v1.p1",2384,2409,4793,"2020/02/04","dbgap"
"1673","phs000459.v1.pht002543.v1.p1",737,684,1421,"01/07/2016","dbgap"
"1674","phs000007.v32.pht000689.v7.p13",1740,1896,3636,"2020/12/21","dbgap"
"1675","phs000576.v1.pht006156.v1.p1",115,128,243,"05/24/2017","dbgap"
"1676","phs000249.v2.pht003650.v1.p1",254,128,382,"04/16/2014","dbgap"
"1677","phs000280.v7.pht006440.v4.p1",1224,1399,2623,"2020/06/18","dbgap"
"1678","phs001802.v1.pht008960.v1.p1",3,2,5,"2019/04/09","dbgap"
"1680","phs001676.v1.pht009435.v1.p1",5431,3770,9201,"2020/04/24","dbgap"
"1681","phs000007.v32.pht000609.v5.p13",729,831,1560,"2020/12/21","dbgap"
"1682","phs001423.v3.pht006986.v3.p2",922,627,1549,"2021/05/13","dbgap"
"1683","phs001202.v1.pht005774.v1.p1",7438,2672,10110,"07/10/2017","dbgap"
"1684","phs002230.v1.pht010965.v1.p1",233,543,776,"2021/02/23","dbgap"
"1685","phs001918.v2.pht010050.v2.p1",5164,3924,9088,"2021/10/07","dbgap"
"1686","phs000906.v1.pht007149.v1.p1",4648,4362,9010,"2017/12/04","dbgap"
"1687","phs001430.v2.pht008059.v2.p1",13,10,23,"2020/02/06","dbgap"
"1688","phs001473.v1.pht009689.v1.p1",38,23,61,"2020/12/15","dbgap"
"1689","phs000737.v1.pht004446.v1.p1",600,805,1405,"01/29/2015","dbgap"
"1690","phs001296.v2.pht006359.v2.p1",11,30,41,"2019/05/31","dbgap"
"1691","phs001201.v2.pht007555.v2.p1",87,99,186,"2019/08/18","dbgap"
"1692","phs002023.v1.pht010197.v1.p1",3,11,14,"2020/05/06","dbgap"
"1693","phs000285.v3.pht001802.v2.p2",862,963,1825,"08/20/2013","dbgap"
"1694","phs001252.v1.pht006391.v1.p1",1691,1055,2746,"05/16/2017","dbgap"
"1695","phs000742.v1.pht008123.v1.p1",1232,1425,2657,"2018/07/23","dbgap"
"1696","phs002023.v1.pht010198.v1.p1",3,11,14,"2020/05/06","dbgap"
"1697","phs000539.v1.pht003021.v1.p1",3,5,8,"11/29/2012","dbgap"
"1698","phs001733.v1.pht008615.v1.p1",7,10,17,"2019/01/07","dbgap"
"1699","phs000089.v3.pht000802.v2.p2",896,845,1741,"04/01/2010","dbgap"
"1700","phs000595.v1.pht006643.v1.p1",287,328,615,"07/05/2017","dbgap"
"1701","phs000264.v2.pht001421.v1.p1",111,69,180,"03/04/2011","dbgap"
"1702","phs000219.v1.pht001085.v1.p1",40,41,81,"01/19/2010","dbgap"
"1703","phs001278.v1.pht006276.v1.p1",1,3,4,"06/16/2017","dbgap"
"1704","phs000280.v7.pht006486.v1.p1",588,671,1259,"2020/06/18","dbgap"
"1706","phs001814.v1.pht009005.v1.p1",149,130,279,"2019/06/03","dbgap"
"1707","phs000128.v3.pht000496.v2.p3",2943,3500,6443,"04/29/2016","dbgap"
"1708","phs000285.v3.pht001731.v2.p2",121,218,339,"08/20/2013","dbgap"
"1709","phs000519.v1.pht003246.v1.p1",1937,2015,3952,"09/26/2013","dbgap"
"1710","phs001572.v1.pht007841.v1.p1",195,117,312,"2018/04/20","dbgap"
"1711","phs001862.v1.pht009747.v1.p1",278,380,658,"2019/12/26","dbgap"
"1712","phs000758.v1.pht004001.v1.p1",15,13,28,"08/21/2014","dbgap"
"1717","phs000285.v3.pht001629.v2.p2",909,1032,1941,"08/20/2013","dbgap"
"1718","phs000416.v2.pht002747.v2.p1",1723,1844,3567,"2018/07/06","dbgap"
"1719","phs000343.v3.pht003145.v1.p1",1379,785,2164,"03/12/2013","dbgap"
"1720","phs000086.v3.pht000352.v1.p1",39,64,103,"11/04/2014","dbgap"
"1721","phs000384.v1.pht002461.v1.p1",2,2,4,"06/01/2012","dbgap"
"1722","phs001534.v1.pht008519.v1.p1",26,4395,4421,"2019/09/16","dbgap"
"1723","phs000285.v3.pht001693.v2.p2",139,134,273,"08/20/2013","dbgap"
"1724","phs000007.v32.pht002150.v5.p13",1749,2021,3770,"2020/12/21","dbgap"
"1726","phs000601.v1.pht003514.v1.p1",30,50,80,"09/10/2013","dbgap"
"1727","phs000209.v13.pht003374.v1.p3",1315,1503,2818,"11/05/2014","dbgap"
"1728","phs000007.v32.pht002349.v2.p13",223,201,424,"2020/12/21","dbgap"
"1729","phs002015.v1.pht010395.v1.p1",1618,2226,3844,"2020/09/18","dbgap"
"1731","phs001783.v2.pht008820.v2.p1",372,465,837,"2021/08/06","dbgap"
"1732","phs001384.v1.pht006739.v1.p1",20,11,31,"2017/08/02","dbgap"
"1733","phs000560.v1.pht003067.v1.p1",204,303,507,"07/25/2014","dbgap"
"1735","phs000285.v3.pht001705.v2.p2",875,954,1829,"08/20/2013","dbgap"
"1736","phs000280.v7.pht004089.v2.p1",1535,1325,2860,"2020/06/18","dbgap"
"1737","phs001942.v1.pht010585.v1.p1",13,3,16,"2020/10/21","dbgap"
"1738","phs000275.v1.pht002971.v1.p1",235,689,924,"09/28/2012","dbgap"
"1739","phs001670.v1.pht008881.v1.p1",23,25,48,"2019/03/27","dbgap"
"1740","phs000007.v32.pht004362.v1.p13",196,189,385,"2020/12/21","dbgap"
"1742","phs000916.v1.pht004735.v1.p1",516,283,799,"07/26/2016","dbgap"
"1745","phs001392.v1.pht006891.v1.p1",17,9,26,"2017/09/22","dbgap"
"1746","phs000007.v32.pht002144.v6.p13",2071,2391,4462,"2020/12/21","dbgap"
"1747","phs000007.v32.pht002343.v5.p13",555,491,1046,"2020/12/21","dbgap"
"1749","phs001754.v4.pht009111.v3.p2",3664,6253,9917,"2021/02/26","dbgap"
"1750","phs001713.v1.pht008525.v1.p1",722,1352,2074,"2019/12/19","dbgap"
"1751","phs001910.v1.pht009539.v1.p1",22,24,46,"2019/10/15","dbgap"
"1752","phs000238.v1.pht002006.v1.p1",2330,2786,5116,"11/15/2013","dbgap"
"1753","phs000935.v1.pht004816.v1.p1",93,66,159,"11/16/2016","dbgap"
"1754","phs001705.v1.pht009272.v1.p1",314,251,565,"2019/07/26","dbgap"
"1755","phs000655.v3.pht004377.v2.p1",383,324,707,"12/09/2016","dbgap"
"1756","phs000275.v1.pht002972.v1.p1",235,689,924,"09/28/2012","dbgap"
"1757","phs000308.v1.pht002084.v1.p1",1,2,3,"12/16/2010","dbgap"
"1758","phs000280.v7.pht006426.v1.p1",2354,3139,5493,"2020/06/18","dbgap"
"1760","phs001082.v1.pht005382.v1.p1",5,4,9,"02/09/2017","dbgap"
"1761","phs001130.v1.pht008419.v1.p1",96,151,247,"2018/09/26","dbgap"
"1762","phs000966.v2.pht005305.v2.p2",766,883,1649,"2021/08/27","dbgap"
"1763","phs001434.v2.pht009856.v1.p1",47,18,65,"2021/06/23","dbgap"
"1765","phs002417.v1.pht011276.v1.p1",1578,1507,3085,"2021/06/03","dbgap"
"1766","phs001058.v1.pht005236.v1.p1",306,197,503,"01/25/2016","dbgap"
"1767","phs000128.v3.pht000502.v2.p3",2943,3500,6443,"04/29/2016","dbgap"
"1768","phs001649.v1.pht008514.v1.p1",299,170,469,"2019/02/19","dbgap"
"1771","phs000732.v1.pht003802.v1.p1",12,8,20,"04/14/2014","dbgap"
"1772","phs000128.v3.pht000551.v2.p3",2943,3500,6443,"04/29/2016","dbgap"
"1773","phs000280.v7.pht004129.v2.p1",6783,8156,14939,"2020/06/18","dbgap"
"1775","phs000007.v32.pht005171.v1.p13",68,88,156,"2020/12/21","dbgap"
"1776","phs001488.v1.pht007396.v1.p1",225,267,492,"2018/02/08","dbgap"
"1778","phs001810.v1.pht009064.v1.p1",837,724,1561,"2019/07/01","dbgap"
"1779","phs001292.v2.pht007854.v2.p1",238,538,776,"2019/06/03","dbgap"
"1781","phs000128.v3.pht000547.v2.p3",2943,3500,6443,"04/29/2016","dbgap"
"1782","phs000290.v1.pht002277.v1.p1",16,80,96,"08/23/2011","dbgap"
"1783","phs000371.v2.pht002988.v1.p1",1212,1563,2775,"10/25/2016","dbgap"
"1784","phs000001.v3.pht000371.v2.p1",2098,2659,4757,"02/24/2012","dbgap"
"1785","phs000884.v1.pht004600.v1.p1",146,94,240,"03/17/2015","dbgap"
"1786","phs002073.v1.pht010828.v1.p1",18,22,40,"2021/01/07","dbgap"
"1787","phs000007.v32.pht003317.v9.p13",7046,8098,15144,"2020/12/21","dbgap"
"1788","phs000926.v1.pht004866.v1.p1",3,1,4,"08/04/2015","dbgap"
"1789","phs000187.v1.pht001218.v1.p1",52,52,104,"04/23/2010","dbgap"
"1790","phs001448.v1.pht007031.v1.p1",27,31,58,"2017/10/19","dbgap"
"1791","phs000285.v3.pht001615.v2.p2",94,177,271,"08/20/2013","dbgap"
"1792","phs000698.v1.pht007689.v1.p1",17,29,46,"2018/03/23","dbgap"
"1793","phs001998.v1.pht010502.v1.p1",4,6,10,"2021/06/07","dbgap"
"1796","phs001330.v2.pht007529.v2.p1",25,15,40,"2019/11/08","dbgap"
"1797","phs001815.v1.pht009012.v1.p1",573,1064,1637,"2020/08/05","dbgap"
"1799","phs000473.v2.pht002600.v2.p2",6600,5780,12380,"08/15/2016","dbgap"
"1800","phs001586.v1.pht008148.v1.p1",98,101,199,"2018/06/18","dbgap"
"1801","phs000279.v2.pht001436.v2.p1",405,322,727,"01/11/2016","dbgap"
"1802","phs001929.v1.pht010012.v1.p1",325,275,600,"2020/03/26","dbgap"
"1803","phs000143.v1.pht000645.v1.p1",692,1340,2032,"02/25/2011","dbgap"
"1804","phs000306.v4.pht001909.v1.p1",5,7,12,"04/10/2014","dbgap"
"1805","phs001471.v1.pht009804.v1.p1",146,374,520,"2020/01/10","dbgap"
"1807","phs001934.v1.pht009777.v1.p1",55,66,121,"2020/01/31","dbgap"
"1810","phs000592.v1.pht006588.v1.p1",64,59,123,"07/12/2017","dbgap"
"1811","phs000222.v6.pht009349.v1.p2",487,854,1341,"2019/08/01","dbgap"
"1812","phs001327.v2.pht011183.v1.p1",13724,11941,25665,"2021/05/07","dbgap"
"1813","phs000678.v1.pht003563.v1.p1",1506,4447,5953,"05/13/2014","dbgap"
"1814","phs000999.v3.pht005181.v3.p1",130,112,242,"2019/11/22","dbgap"
"1816","phs000895.v1.pht005073.v1.p1",88,72,160,"04/01/2016","dbgap"
"1817","phs000205.v6.pht001431.v6.p2",23970,16571,40541,"06/13/2016","dbgap"
"1818","phs001804.v1.pht008965.v1.p1",1635,330,1965,"2019/04/23","dbgap"
"1819","phs001868.v1.pht009780.v1.p1",5418,5814,11232,"2020/04/17","dbgap"
"1820","phs001067.v1.pht005287.v1.p1",2,1,3,"02/02/2016","dbgap"
"1822","phs002283.v1.pht010683.v1.p1",856,467,1323,"2020/11/30","dbgap"
"1823","phs001600.v2.pht011019.v2.p2",653,618,1271,"2021/07/15","dbgap"
"1824","phs000906.v1.pht007147.v1.p1",2725,2702,5427,"2017/12/04","dbgap"
"1825","phs001611.v1.pht009161.v1.p1",40,29,69,"2019/06/13","dbgap"
"1826","phs000462.v1.pht002845.v1.p1",242,365,607,"05/07/2013","dbgap"
"1828","phs002240.v1.pht010862.v1.p1",30,66,96,"2021/01/15","dbgap"
"1829","phs000007.v32.pht002153.v1.p13",238,390,628,"2020/12/21","dbgap"
"1830","phs000280.v7.pht006421.v1.p1",1605,2402,4007,"2020/06/18","dbgap"
"1831","phs000772.v1.pht003995.v1.p1",2,1,3,"08/21/2014","dbgap"
"1832","phs000435.v3.pht002524.v3.p1",104,65,169,"02/27/2017","dbgap"
"1834","phs001151.v1.pht005541.v1.p1",2,3,5,"06/21/2016","dbgap"
"1835","phs001076.v1.pht005363.v1.p1",2378,2102,4480,"04/24/2017","dbgap"
"1836","phs001426.v1.pht006917.v1.p1",43,39,82,"2017/09/19","dbgap"
"1838","phs000086.v3.pht000228.v1.p1",741,643,1384,"11/04/2014","dbgap"
"1839","phs001807.v1.pht008980.v1.p1",46,30,76,"2019/06/11","dbgap"
"1840","phs001279.v1.pht007217.v1.p1",15,23,38,"2017/12/08","dbgap"
"1841","phs000462.v1.pht002542.v1.p1",242,365,607,"05/07/2013","dbgap"
"1842","phs000616.v2.pht003368.v2.p2",797,765,1562,"07/15/2015","dbgap"
"1843","phs002323.v1.pht010882.v1.p1",3,3,6,"2021/05/24","dbgap"
"1844","phs001608.v2.pht009735.v1.p1",290,352,642,"2021/09/29","dbgap"
"1845","phs001718.v1.pht009426.v1.p1",1240,855,2095,"2019/09/16","dbgap"
"1846","phs000130.v1.pht000615.v1.p1",973,990,1963,"Mon Oct 27 17:24:52 2008","dbgap"
"1847","phs001093.v1.pht005612.v1.p1",908,160,1068,"07/06/2016","dbgap"
"1849","phs000988.v5.pht005248.v5.p1",2088,1960,4048,"2021/09/28","dbgap"
"1851","phs000086.v3.pht000347.v1.p1",16,14,30,"11/04/2014","dbgap"
"1852","phs001497.v2.pht007239.v2.p1",1819,1354,3173,"2021/09/08","dbgap"
"1853","phs000766.v1.pht003940.v1.p1",2383,2371,4754,"03/26/2015","dbgap"
"1854","phs000171.v1.pht000784.v1.p1",158,670,828,"12/11/2009","dbgap"
"1856","phs001392.v1.pht006890.v1.p1",17,9,26,"2017/09/22","dbgap"
"1857","phs001961.v1.pht011029.v1.p1",6,4,10,"2021/06/03","dbgap"
"1859","phs001395.v2.pht006627.v1.p1",3380,4713,8093,"2021/06/09","dbgap"
"1860","phs000582.v1.pht003243.v1.p1",7,5,12,"05/16/2013","dbgap"
"1861","phs001470.v1.pht008165.v1.p1",8,1470,1478,"2018/06/21","dbgap"
"1862","phs000280.v7.pht004033.v2.p1",6120,7410,13530,"2020/06/18","dbgap"
"1863","phs001899.v2.pht009571.v2.p1",915,1025,1940,"2020/11/02","dbgap"
"1864","phs000797.v1.pht004269.v1.p1",4,1,5,"09/29/2014","dbgap"
"1865","phs000957.v1.pht004852.v1.p1",3625,5582,9207,"07/31/2015","dbgap"
"1866","phs001982.v1.pht010005.v1.p1",26,36,62,"2020/03/19","dbgap"
"1867","phs000086.v3.pht000256.v1.p1",761,680,1441,"11/04/2014","dbgap"
"1868","phs000391.v1.pht002994.v1.p1",332,334,666,"11/16/2012","dbgap"
"1869","phs000962.v1.pht006966.v1.p1",221,156,377,"2017/10/02","dbgap"
"1870","phs000358.v1.pht002242.v1.p1",763,620,1383,"05/23/2011","dbgap"
"1871","phs001522.v1.pht007732.v1.p1",654,637,1291,"2018/04/05","dbgap"
"1872","phs000448.v1.pht002508.v1.p1",2164,932,3096,"08/28/2012","dbgap"
"1873","phs000128.v3.pht000585.v2.p3",2943,3500,6443,"04/29/2016","dbgap"
"1874","phs000017.v3.pht000641.v1.p1",1505,1756,3261,"Wed Nov 26 07:50:28 2008","dbgap"
"1875","phs001039.v1.pht005846.v1.p1",15144,20214,35358,"10/19/2016","dbgap"
"1878","phs000698.v1.pht007670.v1.p1",17,32,49,"2018/03/23","dbgap"
"1879","phs001468.v3.pht009554.v1.p1",1314,1481,2795,"2021/09/23","dbgap"
"1880","phs000697.v1.pht007696.v1.p1",26,5,31,"2018/03/26","dbgap"
"1881","phs000248.v1.pht001201.v1.p1",2070,1379,3449,"02/10/2014","dbgap"
"1882","phs000398.v1.pht002465.v1.p1",234,361,595,"02/21/2012","dbgap"
"1883","phs001078.v1.pht005724.v1.p1",8199,9567,17766,"2018/09/14","dbgap"
"1884","phs000775.v1.pht003946.v1.p1",497,362,859,"07/18/2014","dbgap"
"1886","phs001229.v1.pht006550.v1.p1",25,14,39,"06/15/2017","dbgap"
"1887","phs000007.v32.pht000035.v10.p13",1602,1822,3424,"2020/12/21","dbgap"
"1888","phs000697.v1.pht007695.v1.p1",28,6,34,"2018/03/26","dbgap"
"1889","phs000980.v1.pht004961.v1.p1",16,18,34,"11/16/2015","dbgap"
"1890","phs001017.v1.pht005074.v1.p1",79,1680,1759,"2021/07/02","dbgap"
"1891","phs000188.v1.pht000980.v1.p1",1200,1828,3028,"10/05/2010","dbgap"
"1892","phs002212.v1.pht010985.v1.p1",16,2,18,"2021/02/22","dbgap"
"1893","phs001252.v1.pht006394.v1.p1",695,487,1182,"05/16/2017","dbgap"
"1894","phs000904.v1.pht004690.v1.p1",4,4,8,"2018/01/30","dbgap"
"1895","phs000280.v7.pht004042.v2.p1",1858,2523,4381,"2020/06/18","dbgap"
"1897","phs001759.v1.pht008707.v1.p1",1,6,7,"2019/03/08","dbgap"
"1900","phs000007.v32.pht000907.v7.p13",1549,1743,3292,"2020/12/21","dbgap"
"1901","phs002389.v1.pht011092.v1.p1",38,22,60,"2021/04/06","dbgap"
"1902","phs000771.v2.pht003982.v2.p1",72,29,101,"2017/10/25","dbgap"
"1903","phs001641.v1.pht010033.v1.p1",559,1277,1836,"2020/03/24","dbgap"
"1904","phs000848.v1.pht004412.v1.p1",1,2,3,"12/10/2014","dbgap"
"1905","phs002269.v1.pht010581.v1.p1",25,12,37,"2020/10/16","dbgap"
"1906","phs000358.v1.pht002240.v1.p1",763,620,1383,"05/23/2011","dbgap"
"1907","phs001943.v1.pht009714.v1.p1",14,20,34,"2019/12/17","dbgap"
"1908","phs000007.v32.pht000743.v5.p13",1158,1371,2529,"2020/12/21","dbgap"
"1909","phs000418.v2.pht002618.v1.p1",7,1,8,"04/10/2014","dbgap"
"1910","phs000924.v4.pht006321.v1.p1",178,207,385,"2019/10/07","dbgap"
"1911","phs000285.v3.pht001729.v2.p2",13,12,25,"08/20/2013","dbgap"
"1912","phs001647.v1.pht008200.v1.p1",271,112,383,"2018/08/19","dbgap"
"1913","phs000492.v3.pht006605.v2.p2",53,55,108,"2018/10/19","dbgap"
"1914","phs000128.v3.pht000490.v2.p3",2943,3500,6443,"04/29/2016","dbgap"
"1915","phs000617.v1.pht005478.v1.p1",162,128,290,"05/19/2016","dbgap"
"1916","phs001072.v1.pht005357.v1.p1",42,15,57,"03/31/2016","dbgap"
"1917","phs000209.v13.pht001121.v3.p3",646,970,1616,"11/05/2014","dbgap"
"1918","phs000007.v32.pht000306.v9.p13",1842,2123,3965,"2020/12/21","dbgap"
"1920","phs001468.v3.pht009552.v1.p1",1314,1481,2795,"2021/09/23","dbgap"
"1922","phs000577.v1.pht007290.v1.p1",174,341,515,"2017/12/20","dbgap"
"1923","phs001513.v1.pht007358.v1.p1",71,38,109,"2018/01/18","dbgap"
"1924","phs000343.v3.pht002717.v1.p1",11,7,18,"03/12/2013","dbgap"
"1925","phs000280.v7.pht004142.v2.p1",6724,8091,14815,"2020/06/18","dbgap"
"1926","phs000218.v24.pht000918.v24.p8",2729,2296,5025,"2021/10/06","dbgap"
"1927","phs001122.v1.pht008638.v1.p1",317,282,599,"2021/03/23","dbgap"
"1930","phs000219.v1.pht001084.v1.p1",127,184,311,"01/19/2010","dbgap"
"1931","phs000481.v3.pht003164.v3.p2",392,370,762,"2020/07/17","dbgap"
"1932","phs001360.v1.pht006296.v1.p1",332,1172,1504,"2020/05/05","dbgap"
"1933","phs000258.v2.pht001242.v2.p1",160,244,404,"04/14/2011","dbgap"
"1934","phs002259.v1.pht011023.v1.p1",5,20,25,"2021/05/28","dbgap"
"1936","phs000007.v32.pht007767.v1.p13",467,516,983,"2020/12/21","dbgap"
"1938","phs000286.v6.pht008792.v1.p2",1152,1951,3103,"2019/03/11","dbgap"
"1939","phs001123.v2.pht009042.v1.p1",7393,9471,16864,"2019/09/16","dbgap"
"1942","phs000733.v1.pht003820.v1.p1",4008,16,4024,"07/18/2014","dbgap"
"1945","phs002484.v1.pht011400.v1.p1",49,37,86,"2021/07/14","dbgap"
"1946","phs000734.v1.pht003771.v1.p1",409,285,694,"04/04/2014","dbgap"
"1948","phs000963.v1.pht004859.v1.p1",3771,2119,5890,"05/11/2016","dbgap"
"1949","phs000491.v1.pht002699.v1.p1",2,1,3,"04/24/2012","dbgap"
"1950","phs001435.v2.pht009873.v1.p1",79,41,120,"2021/06/23","dbgap"
"1951","phs001288.v1.pht006768.v1.p1",64,43,107,"2017/10/19","dbgap"
"1952","phs000143.v1.pht000644.v1.p1",664,1316,1980,"02/25/2011","dbgap"
"1953","phs002015.v1.pht010366.v1.p1",250,310,560,"2020/09/18","dbgap"
"1954","phs000476.v1.pht002670.v1.p1",10,10,20,"04/16/2012","dbgap"
"1955","phs000086.v3.pht000279.v1.p1",761,680,1441,"11/04/2014","dbgap"
"1956","phs002310.v1.pht011208.v1.p1",1328,559,1887,"2021/05/05","dbgap"
"1957","phs000757.v1.pht003923.v1.p1",33,21,54,"06/30/2014","dbgap"
"1959","phs000951.v5.pht005052.v5.p5",5660,4987,10647,"2021/09/27","dbgap"
"1960","phs000285.v3.pht001562.v2.p2",947,1065,2012,"08/20/2013","dbgap"
"1961","phs001981.v1.pht010701.v1.p1",32,16,48,"2020/12/16","dbgap"
"1962","phs000776.v1.pht003948.v1.p1",7,26,33,"08/04/2014","dbgap"
"1963","phs000159.v9.pht000817.v6.p5",26,20,46,"2019/12/06","dbgap"
"1964","phs001169.v2.pht006183.v2.p1",104,28,132,"2020/06/10","dbgap"
"1965","phs000618.v1.pht003302.v1.p1",2046,2304,4350,"10/24/2013","dbgap"
"1966","phs000863.v1.pht004744.v1.p1",348,282,630,"06/03/2015","dbgap"
"1968","phs001781.v1.pht008861.v1.p1",72,36,108,"2019/03/25","dbgap"
"1969","phs001712.v1.pht008681.v1.p1",61,91,152,"2019/01/31","dbgap"
"1970","phs001189.v4.pht005977.v3.p1",294,71,365,"2021/06/01","dbgap"
"1971","phs001252.v1.pht006401.v1.p1",1689,1055,2744,"05/16/2017","dbgap"
"1972","phs000656.v1.pht003482.v1.p1",15,13,28,"08/26/2013","dbgap"
"1973","phs001521.v1.pht007720.v1.p1",62,31,93,"2018/06/13","dbgap"
"1974","phs000368.v1.pht002294.v1.p1",1,4150,4151,"10/07/2011","dbgap"
"1975","phs000519.v1.pht003247.v1.p1",1937,2015,3952,"09/26/2013","dbgap"
"1976","phs000969.v1.pht004931.v1.p1",2,2,4,"10/05/2015","dbgap"
"1977","phs001541.v1.pht008308.v1.p1",387,10506,10893,"2019/11/25","dbgap"
"1978","phs000244.v1.pht001521.v1.p1",4,2,6,"07/14/2010","dbgap"
"1979","phs000302.v1.pht002178.v1.p1",200,150,350,"08/18/2011","dbgap"
"1980","phs001252.v1.pht006397.v1.p1",1408,753,2161,"05/16/2017","dbgap"
"1981","phs000285.v3.pht001626.v2.p2",909,1032,1941,"08/20/2013","dbgap"
"1982","phs001326.v1.pht007800.v1.p1",15,2,17,"2018/04/16","dbgap"
"1984","phs001065.v1.pht005408.v1.p1",296,313,609,"05/24/2016","dbgap"
"1986","phs000021.v3.pht000288.v1.p2",370,609,979,"10/25/2010","dbgap"
"1987","phs000247.v5.pht001286.v4.p3",478,499,977,"07/27/2017","dbgap"
"1988","phs001767.v1.pht008662.v1.p1",143,55,198,"2019/01/29","dbgap"
"1989","phs000801.v2.pht004612.v2.p1",5068,5423,10491,"09/20/2016","dbgap"
"1990","phs002073.v1.pht010826.v1.p1",18,22,40,"2021/01/07","dbgap"
"1991","phs000760.v1.pht004263.v1.p1",8,7,15,"02/18/2015","dbgap"
"1992","phs001618.v1.pht008227.v1.p1",25,24,49,"2018/07/18","dbgap"
"1994","phs001317.v1.pht008042.v1.p1",25,33,58,"2018/06/01","dbgap"
"1995","phs001864.v1.pht009264.v1.p1",13,9,22,"2019/07/25","dbgap"
"1996","phs001357.v1.pht006698.v1.p1",41,33,74,"07/26/2017","dbgap"
"1997","phs000286.v6.pht008720.v1.p2",938,1570,2508,"2019/03/11","dbgap"
"1998","phs000007.v32.pht007768.v1.p13",1040,1560,2600,"2020/12/21","dbgap"
"1999","phs001911.v1.pht009517.v1.p1",7,12,19,"2019/10/08","dbgap"
"2000","phs000368.v1.pht002291.v1.p1",40,4189,4229,"10/07/2011","dbgap"
"2001","phs001691.v1.pht008537.v1.p1",1,1,2,"2018/11/07","dbgap"
"2002","phs000007.v32.pht000822.v7.p13",1859,2107,3966,"2020/12/21","dbgap"
"2005","phs001586.v1.pht008149.v1.p1",98,101,199,"2018/06/18","dbgap"
"2006","phs000185.v7.pht008406.v1.p1",58,86,144,"2020/04/29","dbgap"
"2007","phs000286.v6.pht008750.v1.p2",942,1568,2510,"2019/03/11","dbgap"
"2008","phs001709.v1.pht009493.v1.p1",1,199,200,"2019/09/27","dbgap"
"2010","phs001812.v1.pht009588.v1.p1",74,59,133,"2021/02/22","dbgap"
"2011","phs001014.v1.pht005112.v1.p1",72,101,173,"02/25/2016","dbgap"
"2012","phs000576.v1.pht006148.v1.p1",116,128,244,"05/24/2017","dbgap"
"2013","phs000086.v3.pht001146.v1.p1",407,345,752,"11/04/2014","dbgap"
"2014","phs002015.v1.pht010376.v1.p1",1816,2387,4203,"2020/09/18","dbgap"
"2015","phs000287.v7.pht001495.v1.p1",2375,3156,5531,"2020/01/23","dbgap"
"2016","phs001238.v2.pht006046.v1.p1",432,1050,1482,"2018/06/14","dbgap"
"2017","phs001994.v1.pht010010.v1.p1",46,15,61,"2020/04/14","dbgap"
"2018","phs001329.v2.pht007183.v2.p1",1,4,5,"2019/05/07","dbgap"
"2019","phs000357.v2.pht002333.v1.p1",85,748,833,"2018/09/19","dbgap"
"2023","phs001435.v2.pht009875.v1.p1",79,41,120,"2021/06/23","dbgap"
"2024","phs002557.v1.pht011480.v1.p1",3,1,4,"2021/08/20","dbgap"
"2028","phs001279.v1.pht007203.v1.p1",15,23,38,"2017/12/08","dbgap"
"2029","phs000888.v1.pht005590.v1.p1",9572,13545,23117,"08/12/2016","dbgap"
"2030","phs001287.v9.pht006105.v9.p5",941,818,1759,"2021/02/17","dbgap"
"2031","phs000287.v7.pht003698.v2.p1",290,420,710,"2020/01/23","dbgap"
"2032","phs001248.v1.pht006095.v1.p1",42,52,94,"03/06/2017","dbgap"
"2033","phs000625.v1.pht003853.v1.p1",3054,2458,5512,"06/13/2014","dbgap"
"2034","phs000280.v7.pht004206.v2.p1",146,174,320,"2020/06/18","dbgap"
"2035","phs000888.v1.pht005564.v1.p1",396,404,800,"08/12/2016","dbgap"
"2036","phs000907.v1.pht004698.v1.p1",1,4,5,"11/25/2016","dbgap"
"2038","phs001419.v1.pht007084.v1.p1",67,95,162,"2017/12/04","dbgap"
"2039","phs001316.v1.pht008014.v1.p1",2,1,3,"2018/05/31","dbgap"
"2040","phs000840.v1.pht005643.v1.p1",1157,1191,2348,"07/21/2016","dbgap"
"2041","phs001227.v1.pht005835.v1.p1",70,95,165,"2020/02/18","dbgap"
"2042","phs000588.v1.pht009282.v1.p1",1,6,7,"2019/07/26","dbgap"
"2044","phs000219.v1.pht001083.v1.p1",363,502,865,"01/19/2010","dbgap"
"2045","phs001315.v1.pht006194.v1.p1",4482,4243,8725,"2018/05/18","dbgap"
"2046","phs000280.v7.pht004157.v2.p1",6097,7345,13442,"2020/06/18","dbgap"
"2047","phs001488.v1.pht007386.v1.p1",260,292,552,"2018/02/08","dbgap"
"2048","phs000362.v1.pht003229.v1.p1",10,2,12,"08/26/2013","dbgap"
"2049","phs000612.v1.pht003529.v1.p1",25,35,60,"05/23/2014","dbgap"
"2050","phs001090.v1.pht009053.v1.p1",1172,2066,3238,"2019/05/21","dbgap"
"2051","phs000237.v1.pht002159.v1.p1",1522,2047,3569,"04/18/2011","dbgap"
"2052","phs002346.v1.pht011574.v1.p1",134,26,160,"2021/09/24","dbgap"
"2053","phs001761.v1.pht009030.v1.p1",34,120,154,"2019/05/16","dbgap"
"2055","phs000538.v1.pht003039.v1.p1",2,4,6,"11/07/2012","dbgap"
"2056","phs000512.v1.pht002861.v1.p1",59,38,97,"10/15/2012","dbgap"
"2057","phs001599.v1.pht011433.v1.p1",459,484,943,"2021/07/29","dbgap"
"2058","phs000128.v3.pht000529.v2.p3",2943,3500,6443,"04/29/2016","dbgap"
"2059","phs000128.v3.pht000571.v2.p3",2943,3500,6443,"04/29/2016","dbgap"
"2060","phs002480.v1.pht011393.v1.p1",1060,822,1882,"2021/08/11","dbgap"
"2061","phs000958.v1.pht004960.v1.p1",48,52,100,"08/31/2015","dbgap"
"2062","phs001774.v1.pht008806.v1.p1",22,28,50,"2020/02/27","dbgap"
"2064","phs001218.v3.pht005959.v1.p1",736,1047,1783,"2021/06/08","dbgap"
"2065","phs000251.v2.pht001260.v2.p2",65,28,93,"11/22/2013","dbgap"
"2066","phs001856.v1.pht009596.v1.p1",4948,4976,9924,"2020/08/05","dbgap"
"2067","phs000956.v5.pht005003.v2.p1",559,552,1111,"2021/05/07","dbgap"
"2068","phs000139.v1.pht000623.v1.p1",1247,1755,3002,"Thu Nov 20 13:23:10 2008","dbgap"
"2069","phs002361.v1.pht011070.v1.p1",1,1,2,"2021/03/18","dbgap"
"2070","phs000888.v1.pht005578.v1.p1",136,124,260,"08/12/2016","dbgap"
"2071","phs000007.v32.pht000301.v9.p13",1703,1889,3592,"2020/12/21","dbgap"
"2072","phs000698.v1.pht007685.v1.p1",18,32,50,"2018/03/23","dbgap"
"2073","phs002224.v1.pht010846.v1.p1",31,85,116,"2021/05/18","dbgap"
"2074","phs000575.v2.pht005894.v2.p1",177,213,390,"2020/02/14","dbgap"
"2075","phs000167.v1.pht000716.v1.p1",700,685,1385,"04/22/2009","dbgap"
"2076","phs001256.v2.pht005994.v1.p1",50,18,68,"05/12/2017","dbgap"
"2078","phs000285.v3.pht001673.v2.p2",468,567,1035,"08/20/2013","dbgap"
"2079","phs000753.v1.pht003877.v1.p1",1302,988,2290,"06/05/2014","dbgap"
"2080","phs001358.v1.pht006333.v1.p1",1103,1238,2341,"05/02/2017","dbgap"
"2081","phs000167.v1.pht000718.v1.p1",59,43,102,"04/22/2009","dbgap"
"2082","phs001400.v1.pht006825.v1.p1",2,2,4,"2017/11/09","dbgap"
"2084","phs002228.v1.pht010858.v1.p1",38,32,70,"2021/04/23","dbgap"
"2085","phs001868.v1.pht009781.v1.p1",5418,5814,11232,"2020/04/17","dbgap"
"2086","phs001662.v2.pht010061.v1.p1",843,758,1601,"2021/08/19","dbgap"
"2087","phs001495.v2.pht007198.v2.p1",1,4,5,"2019/01/30","dbgap"
"2088","phs001163.v1.pht011097.v1.p1",177,163,340,"2021/04/06","dbgap"
"2090","phs001430.v2.pht008087.v2.p1",13,10,23,"2020/02/06","dbgap"
"2091","phs000646.v1.pht003436.v1.p1",2,1,3,"08/06/2013","dbgap"
"2092","phs001935.v1.pht009770.v1.p1",3,3,6,"2020/02/06","dbgap"
"2093","phs001046.v1.pht005297.v1.p1",287,424,711,"2018/06/01","dbgap"
"2094","phs000400.v1.pht002535.v1.p1",5,20,25,"02/21/2012","dbgap"
"2095","phs000333.v1.pht002313.v1.p1",1032,1590,2622,"10/06/2011","dbgap"
"2096","phs002244.v1.pht010552.v1.p1",23,10,33,"2020/10/02","dbgap"
"2097","phs000592.v1.pht006581.v1.p1",69,50,119,"07/12/2017","dbgap"
"2099","phs000556.v1.pht003139.v1.p1",2,4,6,"07/09/2013","dbgap"
"2100","phs001065.v1.pht005424.v1.p1",296,313,609,"05/24/2016","dbgap"
"2102","phs001551.v1.pht008346.v1.p1",49,52,101,"2018/09/07","dbgap"
"2104","phs000626.v1.pht003433.v1.p1",1,1,2,"08/21/2015","dbgap"
"2105","phs000128.v3.pht000533.v2.p3",2943,3500,6443,"04/29/2016","dbgap"
"2106","phs000222.v6.pht003452.v2.p2",413,696,1109,"2019/08/01","dbgap"
"2107","phs000914.v1.pht005251.v1.p1",1442,2059,3501,"04/20/2016","dbgap"
"2108","phs001550.v2.pht007507.v2.p1",40,35,75,"2018/10/22","dbgap"
"2109","phs000285.v3.pht001806.v2.p2",947,1065,2012,"08/20/2013","dbgap"
"2110","phs001472.v2.pht007117.v1.p1",1574,891,2465,"2021/07/07","dbgap"
"2111","phs000590.v1.pht008271.v1.p1",5,4,9,"2018/08/03","dbgap"
"2112","phs000309.v2.pht001998.v2.p2",832,953,1785,"10/19/2011","dbgap"
"2113","phs000285.v3.pht001715.v2.p2",888,981,1869,"08/20/2013","dbgap"
"2114","phs001227.v1.pht005833.v1.p1",70,95,165,"2020/02/18","dbgap"
"2115","phs000416.v2.pht002745.v2.p1",1724,1846,3570,"2018/07/06","dbgap"
"2116","phs000578.v1.pht007003.v1.p1",3,11,14,"2017/10/11","dbgap"
"2117","phs001580.v1.pht008289.v1.p1",15,26,41,"2018/08/06","dbgap"
"2118","phs000813.v1.pht004304.v1.p1",1168,1786,2954,"10/21/2015","dbgap"
"2119","phs000128.v3.pht000472.v2.p3",2943,3500,6443,"04/29/2016","dbgap"
"2120","phs000128.v3.pht000556.v2.p3",2943,3500,6443,"04/29/2016","dbgap"
"2121","phs000287.v7.pht001473.v1.p1",2375,3156,5531,"2020/01/23","dbgap"
"2122","phs000594.v1.pht006496.v1.p1",6,3,9,"06/12/2017","dbgap"
"2123","phs001612.v1.pht009497.v1.p1",811,943,1754,"2019/11/13","dbgap"
"2125","phs001526.v1.pht007613.v1.p1",7,5,12,"2018/06/26","dbgap"
"2126","phs001911.v1.pht009519.v1.p1",6,11,17,"2019/10/08","dbgap"
"2127","phs000209.v13.pht003377.v1.p3",2002,2181,4183,"11/05/2014","dbgap"
"2128","phs000456.v1.pht002645.v1.p1",79,11,90,"05/02/2012","dbgap"
"2130","phs001359.v3.pht008689.v1.p1",505,558,1063,"2021/06/10","dbgap"
"2131","phs001232.v4.pht006077.v4.p2",2014,2108,4122,"2021/08/23","dbgap"
"2132","phs001673.v1.pht008510.v1.p1",936,1160,2096,"2019/04/25","dbgap"
"2133","phs002301.v1.pht010817.v1.p1",50,30,80,"2020/12/22","dbgap"
"2134","phs000007.v32.pht003902.v5.p13",1761,2004,3765,"2020/12/21","dbgap"
"2135","phs000537.v1.pht003024.v1.p1",2,2,4,"10/24/2012","dbgap"
"2136","phs000353.v1.pht002257.v1.p1",398,445,843,"08/08/2011","dbgap"
"2137","phs000234.v2.pht001150.v2.p2",1611,2131,3742,"2018/05/29","dbgap"
"2139","phs001333.v2.pht006527.v2.p1",9,11,20,"2019/08/29","dbgap"
"2141","phs002286.v1.pht010636.v1.p1",1,5,6,"2020/11/19","dbgap"
"2142","phs002327.v1.pht010917.v1.p1",11,13,24,"2021/02/02","dbgap"
"2143","phs000007.v32.pht005169.v2.p13",959,1154,2113,"2020/12/21","dbgap"
"2144","phs001388.v2.pht006876.v1.p1",1230,2066,3296,"2021/03/05","dbgap"
"2145","phs000280.v7.pht004124.v2.p1",4845,5967,10812,"2020/06/18","dbgap"
"2146","phs000768.v2.pht004477.v2.p1",31,22,53,"12/20/2016","dbgap"
"2148","phs001995.v1.pht009993.v1.p1",298,380,678,"2020/07/17","dbgap"
"2149","phs001333.v2.pht006530.v2.p1",9,10,19,"2019/08/29","dbgap"
"2150","phs000313.v4.pht002065.v4.p2",2292,2426,4718,"2017/11/22","dbgap"
"2151","phs001080.v1.pht005371.v1.p1",62,41,103,"04/06/2016","dbgap"
"2152","phs001488.v1.pht007410.v1.p1",260,293,553,"2018/02/08","dbgap"
"2153","phs001556.v1.pht007843.v1.p1",67,33,100,"2018/04/20","dbgap"
"2154","phs000561.v1.pht003036.v1.p1",6,5,11,"11/05/2012","dbgap"
"2155","phs001595.v1.pht007994.v1.p1",2,2,4,"2018/05/22","dbgap"
"2156","phs002417.v1.pht011275.v1.p1",1578,1507,3085,"2021/06/03","dbgap"
"2157","phs001670.v1.pht008883.v1.p1",23,25,48,"2019/03/27","dbgap"
"2158","phs001134.v1.pht011228.v1.p1",105,335,440,"2021/05/17","dbgap"
"2160","phs000209.v13.pht003087.v1.p3",94,91,185,"11/05/2014","dbgap"
"2162","phs000285.v3.pht001573.v2.p2",947,1065,2012,"08/20/2013","dbgap"
"2163","phs000562.v1.pht003106.v1.p1",32,13,45,"12/26/2012","dbgap"
"2164","phs000219.v1.pht001066.v1.p1",200,311,511,"01/19/2010","dbgap"
"2165","phs000007.v32.pht004809.v1.p13",470,543,1013,"2020/12/21","dbgap"
"2166","phs001282.v2.pht006097.v2.p1",29,8,37,"2020/01/21","dbgap"
"2167","phs001095.v1.pht005621.v1.p1",421,437,858,"07/01/2016","dbgap"
"2168","phs001201.v2.pht007554.v2.p1",87,99,186,"2019/08/18","dbgap"
"2170","phs000219.v1.pht001077.v1.p1",76,134,210,"01/19/2010","dbgap"
"2171","phs002341.v1.pht011057.v1.p1",36,36,72,"2021/03/24","dbgap"
"2172","phs000280.v7.pht004067.v2.p1",5734,7246,12980,"2020/06/18","dbgap"
"2173","phs000007.v32.pht002853.v6.p13",1407,1642,3049,"2020/12/21","dbgap"
"2174","phs000428.v2.pht002614.v2.p2",6472,9148,15620,"01/27/2017","dbgap"
"2175","phs001191.v1.pht006227.v1.p1",312,588,900,"03/29/2017","dbgap"
"2176","phs001009.v1.pht005351.v1.p1",73,105,178,"03/28/2016","dbgap"
"2177","phs001026.v1.pht005120.v1.p1",68,57,125,"11/16/2015","dbgap"
"2178","phs001680.v1.pht008915.v1.p1",22,10,32,"2019/03/28","dbgap"
"2182","phs001903.v1.pht009892.v1.p1",18421,19016,37437,"2020/09/03","dbgap"
"2183","phs000298.v4.pht002281.v3.p3",7742,4936,12678,"2018/06/22","dbgap"
"2184","phs000589.v1.pht009174.v1.p1",2,12,14,"2019/06/14","dbgap"
"2187","phs000007.v32.pht004367.v1.p13",422,580,1002,"2020/12/21","dbgap"
"2188","phs000007.v32.pht010725.v1.p13",2041,2354,4395,"2020/12/21","dbgap"
"2189","phs000128.v3.pht000482.v2.p3",2943,3500,6443,"04/29/2016","dbgap"
"2191","phs002335.v1.pht010943.v1.p1",6,6,12,"2021/02/08","dbgap"
"2194","phs000730.v1.pht005061.v1.p1",31,55,86,"11/13/2015","dbgap"
"2195","phs000007.v32.pht000085.v8.p13",1580,1775,3355,"2020/12/21","dbgap"
"2196","phs001686.v1.pht008563.v1.p1",3,3,6,"2018/11/26","dbgap"
"2197","phs001576.v2.pht008216.v2.p2",28,11,39,"2019/09/27","dbgap"
"2199","phs000350.v1.pht002199.v1.p1",190,90,280,"03/28/2014","dbgap"
"2200","phs000486.v1.pht002805.v1.p1",1857,3481,5338,"12/17/2014","dbgap"
"2201","phs001278.v1.pht006281.v1.p1",4,7,11,"06/16/2017","dbgap"
"2202","phs001488.v1.pht007405.v1.p1",260,293,553,"2018/02/08","dbgap"
"2203","phs001788.v1.pht008817.v1.p1",3903,858,4761,"2019/03/05","dbgap"
"2204","phs000588.v1.pht009284.v1.p1",1,3,4,"2019/07/26","dbgap"
"2207","phs001471.v1.pht009807.v1.p1",141,369,510,"2020/01/10","dbgap"
"2208","phs001238.v2.pht006663.v1.p1",535,704,1239,"2018/06/14","dbgap"
"2209","phs000287.v7.pht001478.v1.p1",2375,3156,5531,"2020/01/23","dbgap"
"2210","phs001232.v4.pht006079.v4.p2",2070,2169,4239,"2021/08/23","dbgap"
"2214","phs000280.v7.pht004058.v5.p1",6105,6967,13072,"2020/06/18","dbgap"
"2215","phs000727.v1.pht003862.v1.p1",116,95,211,"10/27/2014","dbgap"
"2216","phs000987.v1.pht004968.v1.p1",101,83,184,"04/05/2017","dbgap"
"2217","phs000128.v3.pht000568.v2.p3",2943,3500,6443,"04/29/2016","dbgap"
"2219","phs001345.v3.pht008602.v1.p1",573,1279,1852,"2021/06/09","dbgap"
"2220","phs000280.v7.pht004239.v2.p1",5438,6644,12082,"2020/06/18","dbgap"
"2221","phs000209.v13.pht003604.v2.p3",2082,2300,4382,"11/05/2014","dbgap"
"2222","phs001972.v1.pht009843.v1.p1",1313,1480,2793,"2020/06/30","dbgap"
"2223","phs001360.v1.pht006293.v1.p1",332,1172,1504,"2020/05/05","dbgap"
"2224","phs000454.v1.pht003327.v1.p1",2420,806,3226,"06/17/2013","dbgap"
"2225","phs000280.v7.pht006469.v1.p1",1002,1296,2298,"2020/06/18","dbgap"
"2226","phs000007.v32.pht000207.v7.p13",1356,1678,3034,"2020/12/21","dbgap"
"2227","phs000639.v1.pht004782.v1.p1",465,302,767,"11/02/2015","dbgap"
"2228","phs001164.v1.pht008870.v1.p1",22,19,41,"2019/03/25","dbgap"
"2229","phs000760.v1.pht004264.v1.p1",8,7,15,"02/18/2015","dbgap"
"2230","phs000491.v1.pht002700.v1.p1",2,1,3,"04/24/2012","dbgap"
"2231","phs000007.v32.pht000742.v7.p13",1322,1573,2895,"2020/12/21","dbgap"
"2232","phs000638.v1.pht003569.v1.p1",1341,1146,2487,"11/20/2013","dbgap"
"2234","phs000481.v3.pht002660.v3.p2",392,370,762,"2020/07/17","dbgap"
"2235","phs000280.v7.pht004108.v2.p1",6101,7381,13482,"2020/06/18","dbgap"
"2237","phs001972.v1.pht009842.v1.p1",1273,1411,2684,"2020/06/30","dbgap"
"2238","phs000715.v1.pht003746.v1.p1",15,17,32,"03/13/2014","dbgap"
"2239","phs000007.v32.pht005175.v1.p13",884,1365,2249,"2020/12/21","dbgap"
"2240","phs000339.v2.pht002138.v2.p1",46,88,134,"02/05/2013","dbgap"
"2241","phs000574.v1.pht005854.v1.p1",41,972,1013,"05/24/2017","dbgap"
"2242","phs000458.v1.pht003593.v1.p1",59,63,122,"11/26/2013","dbgap"
"2243","phs000128.v3.pht000433.v2.p3",2943,3500,6443,"04/29/2016","dbgap"
"2244","phs000007.v32.pht004805.v3.p13",1150,1401,2551,"2020/12/21","dbgap"
"2245","phs001575.v2.pht008206.v1.p1",16,26,42,"2019/11/12","dbgap"
"2246","phs002446.v1.pht011404.v1.p1",3,9,12,"2021/07/21","dbgap"
"2247","phs000086.v3.pht000222.v1.p1",761,680,1441,"11/04/2014","dbgap"
"2248","phs000007.v32.pht002348.v2.p13",341,345,686,"2020/12/21","dbgap"
"2250","phs000126.v2.pht005716.v1.p1",1005,985,1990,"08/29/2016","dbgap"
"2251","phs000343.v3.pht002211.v1.p1",1390,798,2188,"03/12/2013","dbgap"
"2252","phs002506.v1.pht011538.v1.p1",4037,3056,7093,"2021/09/29","dbgap"
"2253","phs000287.v7.pht001451.v1.p1",2140,2763,4903,"2020/01/23","dbgap"
"2254","phs000571.v3.pht003189.v3.p2",14,14,28,"12/01/2015","dbgap"
"2255","phs000280.v7.pht004136.v2.p1",4883,6019,10902,"2020/06/18","dbgap"
"2256","phs000562.v1.pht003107.v1.p1",32,12,44,"12/26/2012","dbgap"
"2258","phs001166.v1.pht005632.v1.p1",690,1336,2026,"07/08/2016","dbgap"
"2259","phs001709.v1.pht009492.v1.p1",1,199,200,"2019/09/27","dbgap"
"2260","phs000007.v32.pht005151.v1.p13",29,34,63,"2020/12/21","dbgap"
"2261","phs000280.v7.pht004068.v2.p1",6769,8146,14915,"2020/06/18","dbgap"
"2263","phs000508.v2.pht002809.v1.p1",19,16,35,"04/15/2014","dbgap"
"2264","phs000086.v3.pht000334.v1.p1",729,666,1395,"11/04/2014","dbgap"
"2265","phs001419.v1.pht007094.v1.p1",37,45,82,"2017/12/04","dbgap"
"2266","phs000662.v1.pht003560.v1.p1",299,342,641,"12/17/2013","dbgap"
"2268","phs000988.v5.pht005249.v5.p1",2041,1915,3956,"2021/09/28","dbgap"
"2269","phs000209.v13.pht003375.v1.p3",2112,2293,4405,"11/05/2014","dbgap"
"2270","phs001182.v2.pht005723.v2.p1",8,13,21,"2020/09/18","dbgap"
"2271","phs001527.v1.pht007518.v1.p1",213,6,219,"2018/04/04","dbgap"
"2273","phs000297.v1.pht002394.v1.p1",1732,2541,4273,"07/27/2012","dbgap"
"2274","phs000280.v7.pht006472.v1.p1",1049,1265,2314,"2020/06/18","dbgap"
"2275","phs000490.v1.pht002965.v1.p1",469,531,1000,"2018/05/07","dbgap"
"2276","phs001289.v1.pht007789.v1.p1",16,13,29,"2018/04/16","dbgap"
"2277","phs000543.v1.pht002937.v1.p1",7,8,15,"10/31/2014","dbgap"
"2278","phs000007.v32.pht000744.v5.p13",288,367,655,"2020/12/21","dbgap"
"2279","phs001288.v1.pht006772.v1.p1",62,40,102,"2017/10/19","dbgap"
"2280","phs000903.v1.pht004871.v1.p1",1149,1464,2613,"10/14/2015","dbgap"
"2281","phs000287.v7.pht001464.v1.p1",2375,3156,5531,"2020/01/23","dbgap"
"2282","phs000521.v2.pht007045.v1.p1",70,57,127,"2020/03/13","dbgap"
"2283","phs001281.v2.pht006127.v2.p1",4,7,11,"2019/02/21","dbgap"
"2284","phs000830.v1.pht004922.v1.p1",11,2,13,"08/21/2015","dbgap"
"2286","phs001325.v3.pht006350.v1.p1",178,207,385,"2019/11/22","dbgap"
"2287","phs000990.v1.pht004996.v1.p1",1078,616,1694,"02/29/2016","dbgap"
"2288","phs000910.v1.pht004725.v1.p1",4063,3942,8005,"08/20/2015","dbgap"
"2289","phs000219.v1.pht001059.v1.p1",124,179,303,"01/19/2010","dbgap"
"2290","phs000589.v1.pht009196.v1.p1",1,5,6,"2019/06/14","dbgap"
"2291","phs000285.v3.pht001713.v2.p2",873,956,1829,"08/20/2013","dbgap"
"2292","phs001194.v3.pht005818.v2.p2",289,250,539,"2020/07/24","dbgap"
"2293","phs000086.v3.pht000238.v1.p1",743,671,1414,"11/04/2014","dbgap"
"2294","phs001591.v1.pht009691.v1.p1",3437,3585,7022,"2021/08/03","dbgap"
"2295","phs000128.v3.pht000428.v2.p3",2943,3500,6443,"04/29/2016","dbgap"
"2296","phs000007.v32.pht000832.v7.p13",1154,1403,2557,"2020/12/21","dbgap"
"2297","phs000007.v32.pht003904.v5.p13",2223,2208,4431,"2020/12/21","dbgap"
"2298","phs000888.v1.pht005569.v1.p1",210,170,380,"08/12/2016","dbgap"
"2299","phs001488.v1.pht007400.v1.p1",238,266,504,"2018/02/08","dbgap"
"2301","phs000286.v6.pht001945.v2.p2",1287,2142,3429,"2019/03/11","dbgap"
"2302","phs000007.v32.pht010739.v1.p13",89,75,164,"2020/12/21","dbgap"
"2303","phs000285.v3.pht001770.v2.p2",18,23,41,"08/20/2013","dbgap"
"2304","phs001488.v1.pht007401.v1.p1",22,27,49,"2018/02/08","dbgap"
"2305","phs000007.v32.pht006012.v4.p13",2112,2408,4520,"2020/12/21","dbgap"
"2306","phs000804.v1.pht005377.v1.p1",53,49,102,"09/06/2016","dbgap"
"2307","phs000285.v3.pht001853.v2.p2",874,983,1857,"08/20/2013","dbgap"
"2308","phs001310.v1.pht006873.v1.p1",28,25,53,"2017/09/18","dbgap"
"2309","phs001814.v1.pht009006.v1.p1",149,130,279,"2019/06/03","dbgap"
"2311","phs000831.v1.pht004907.v1.p1",84,73,157,"08/13/2015","dbgap"
"2312","phs000626.v1.pht003432.v1.p1",1,1,2,"08/21/2015","dbgap"
"2313","phs001655.v1.pht008259.v1.p1",35,47,82,"2018/08/06","dbgap"
"2314","phs000128.v3.pht000415.v2.p3",2943,3500,6443,"04/29/2016","dbgap"
"2315","phs000304.v3.pht001907.v2.p1",439,740,1179,"2018/05/03","dbgap"
"2316","phs001005.v2.pht005041.v2.p1",3,1,4,"2019/11/01","dbgap"
"2319","phs001022.v1.pht005441.v1.p1",96,24,120,"2017/08/17","dbgap"
"2320","phs000343.v3.pht002217.v1.p1",1379,785,2164,"03/12/2013","dbgap"
"2322","phs000588.v1.pht009307.v1.p1",42,151,193,"2019/07/26","dbgap"
"2323","phs001310.v1.pht006866.v1.p1",3,1,4,"2017/09/18","dbgap"
"2324","phs001597.v1.pht008126.v1.p1",38,24,62,"2019/03/22","dbgap"
"2326","phs001193.v1.pht005973.v1.p1",901,696,1597,"12/06/2016","dbgap"
"2327","phs000280.v7.pht004218.v2.p1",3278,4316,7594,"2020/06/18","dbgap"
"2328","phs001404.v1.pht010788.v1.p1",33,125,158,"2020/12/15","dbgap"
"2329","phs000128.v3.pht000410.v2.p3",2943,3500,6443,"04/29/2016","dbgap"
"2330","phs001494.v1.pht007190.v1.p1",776,446,1222,"2018/03/08","dbgap"
"2331","phs001641.v1.pht010030.v1.p1",449,1069,1518,"2020/03/24","dbgap"
"2332","phs001380.v1.pht009231.v1.p1",1540,566,2106,"2019/10/11","dbgap"
"2333","phs000170.v2.pht000739.v2.p1",1648,2336,3984,"02/27/2015","dbgap"
"2334","phs001488.v1.pht007399.v1.p1",1,7,8,"2018/02/08","dbgap"
"2336","phs000698.v1.pht007682.v1.p1",18,32,50,"2018/03/23","dbgap"
"2337","phs000594.v1.pht006509.v1.p1",6,3,9,"06/12/2017","dbgap"
"2338","phs001758.v1.pht008608.v1.p1",2,8,10,"2018/12/31","dbgap"
"2339","phs000436.v1.pht002833.v1.p1",737,449,1186,"11/19/2013","dbgap"
"2341","phs000007.v32.pht001183.v3.p13",101,389,490,"2020/12/21","dbgap"
"2342","phs001082.v1.pht005381.v1.p1",5,4,9,"02/09/2017","dbgap"
"2344","phs000287.v7.pht001452.v1.p1",2375,3156,5531,"2020/01/23","dbgap"
"2345","phs000888.v1.pht005561.v1.p1",4512,4757,9269,"08/12/2016","dbgap"
"2346","phs000638.v1.pht003570.v1.p1",1341,1146,2487,"11/20/2013","dbgap"
"2347","phs000007.v32.pht003910.v6.p13",3271,4114,7385,"2020/12/21","dbgap"
"2348","phs000128.v3.pht000477.v2.p3",2943,3500,6443,"04/29/2016","dbgap"
"2349","phs001297.v1.pht006202.v1.p1",47,50,97,"06/14/2017","dbgap"
"2350","phs000430.v1.pht003054.v1.p1",696,270,966,"06/20/2013","dbgap"
"2351","phs000130.v1.pht000398.v1.p1",973,990,1963,"Mon Oct 27 17:24:36 2008","dbgap"
"2353","phs001591.v1.pht009693.v1.p1",1784,3322,5106,"2021/08/03","dbgap"
"2354","phs000962.v1.pht006968.v1.p1",221,156,377,"2017/10/02","dbgap"
"2355","phs001423.v3.pht006985.v3.p2",912,619,1531,"2021/05/13","dbgap"
"2356","phs001279.v1.pht007206.v1.p1",15,23,38,"2017/12/08","dbgap"
"2357","phs000171.v1.pht000753.v1.p1",164,316,480,"12/11/2009","dbgap"
"2358","phs002046.v1.pht010622.v1.p1",1401,4157,5558,"2020/11/02","dbgap"
"2359","phs001488.v1.pht007412.v1.p1",45,49,94,"2018/02/08","dbgap"
"2360","phs000128.v3.pht000451.v2.p3",2943,3500,6443,"04/29/2016","dbgap"
"2361","phs000572.v8.pht003394.v5.p4",4800,6682,11482,"2019/11/19","dbgap"
"2362","phs001332.v2.pht007448.v2.p1",158,188,346,"2019/11/08","dbgap"
"2363","phs000007.v32.pht000182.v15.p13",8964,9291,18255,"2020/12/21","dbgap"
"2364","phs001651.v1.pht008236.v1.p1",36,15,51,"2018/07/18","dbgap"
"2365","phs001281.v2.pht006130.v2.p1",3,7,10,"2019/02/21","dbgap"
"2366","phs000415.v1.pht002411.v1.p1",137,120,257,"08/13/2015","dbgap"
"2367","phs001829.v1.pht010168.v1.p1",10,7,17,"2020/04/24","dbgap"
"2369","phs000007.v32.pht005144.v4.p13",465,523,988,"2020/12/21","dbgap"
"2370","phs000631.v1.pht003599.v1.p1",1746,1286,3032,"12/03/2013","dbgap"
"2371","phs000285.v3.pht001578.v2.p2",947,1065,2012,"08/20/2013","dbgap"
"2372","phs001745.v1.pht008598.v1.p1",597,506,1103,"2019/02/06","dbgap"
"2373","phs001389.v1.pht006601.v1.p1",6,7,13,"06/27/2017","dbgap"
"2374","phs001419.v1.pht007083.v1.p1",5,6,11,"2017/12/04","dbgap"
"2375","phs000576.v1.pht006158.v1.p1",116,128,244,"05/24/2017","dbgap"
"2376","phs000911.v1.pht004976.v1.p1",9507,9339,18846,"05/06/2016","dbgap"
"2377","phs001331.v2.pht006926.v2.p1",518,341,859,"2019/08/30","dbgap"
"2378","phs000715.v1.pht003743.v1.p1",15,17,32,"03/13/2014","dbgap"
"2379","phs000855.v1.pht004552.v1.p1",8,7,15,"03/10/2015","dbgap"
"2380","phs002286.v1.pht010635.v1.p1",1,5,6,"2020/11/19","dbgap"
"2382","phs001197.v1.pht007561.v1.p1",111,84,195,"2018/04/27","dbgap"
"2383","phs000899.v1.pht008941.v1.p1",200,197,397,"2019/04/25","dbgap"
"2384","phs000285.v3.pht001581.v2.p2",947,1065,2012,"08/20/2013","dbgap"
"2385","phs000222.v6.pht001154.v4.p2",535,950,1485,"2019/08/01","dbgap"
"2386","phs000007.v32.pht002151.v1.p13",346,553,899,"2020/12/21","dbgap"
"2387","phs002008.v1.pht010201.v1.p1",14,4,18,"2020/06/15","dbgap"
"2388","phs000299.v2.pht001882.v2.p1",15,6,21,"02/27/2014","dbgap"
"2390","phs000280.v7.pht004062.v2.p1",6120,7410,13530,"2020/06/18","dbgap"
"2391","phs000553.v1.pht003135.v1.p1",1,4,5,"06/26/2013","dbgap"
"2392","phs001199.v1.pht005706.v1.p1",138,59,197,"08/29/2016","dbgap"
"2393","phs000421.v1.pht003234.v1.p1",1713,2909,4622,"05/21/2013","dbgap"
"2394","phs000400.v1.pht002534.v1.p1",5,20,25,"02/21/2012","dbgap"
"2395","phs002269.v1.pht010582.v1.p1",25,12,37,"2020/10/16","dbgap"
"2396","phs001609.v1.pht008139.v1.p1",89,875,964,"2019/01/10","dbgap"
"2397","phs000413.v2.pht002732.v2.p1",7,8,15,"11/16/2012","dbgap"
"2399","phs000608.v1.pht003344.v1.p1",792,667,1459,"07/15/2013","dbgap"
"2400","phs001488.v1.pht007382.v1.p1",260,293,553,"2018/02/08","dbgap"
"2401","phs000285.v3.pht001621.v2.p2",584,615,1199,"08/20/2013","dbgap"
"2402","phs001538.v1.pht008099.v1.p1",215,297,512,"2018/06/01","dbgap"
"2403","phs001311.v1.pht007919.v1.p1",33,26,59,"2018/05/15","dbgap"
"2404","phs000641.v1.pht003474.v1.p1",10,5,15,"08/21/2013","dbgap"
"2405","phs000255.v1.pht001254.v1.p1",56,60,116,"06/09/2010","dbgap"
"2406","phs000287.v7.pht001454.v1.p1",225,318,543,"2020/01/23","dbgap"
"2407","phs000086.v3.pht000627.v1.p1",47,33,80,"11/04/2014","dbgap"
"2408","phs002015.v1.pht010394.v1.p1",919,1068,1987,"2020/09/18","dbgap"
"2411","phs000701.v1.pht005518.v1.p1",39,35,74,"06/01/2017","dbgap"
"2412","phs000280.v7.pht004199.v2.p1",5436,6656,12092,"2020/06/18","dbgap"
"2414","phs000128.v3.pht000884.v2.p3",3222,3874,7096,"04/29/2016","dbgap"
"2415","phs000219.v1.pht001101.v1.p1",120,189,309,"01/19/2010","dbgap"
"2416","phs001252.v1.pht006383.v1.p1",1686,1054,2740,"05/16/2017","dbgap"
"2417","phs000280.v7.pht006464.v1.p1",2341,3130,5471,"2020/06/18","dbgap"
"2418","phs001746.v1.pht008569.v1.p1",5,5,10,"2018/11/21","dbgap"
"2419","phs001570.v2.pht007868.v1.p1",2,275,277,"2020/04/14","dbgap"
"2421","phs000285.v3.pht001557.v2.p2",942,1063,2005,"08/20/2013","dbgap"
"2422","phs001704.v1.pht008462.v1.p1",16,7,23,"2018/10/16","dbgap"
"2423","phs002328.v1.pht010855.v1.p1",178,90,268,"2021/03/05","dbgap"
"2424","phs001501.v1.pht007225.v1.p1",726,391,1117,"2020/08/24","dbgap"
"2425","phs000671.v1.pht003549.v1.p1",9,1,10,"10/25/2013","dbgap"
"2428","phs000956.v5.pht005000.v1.p1",1104,1088,2192,"2021/05/07","dbgap"
"2429","phs001516.v1.pht007491.v1.p1",9564,12137,21701,"2018/03/15","dbgap"
"2430","phs001807.v1.pht008976.v1.p1",54,33,87,"2019/06/11","dbgap"
"2431","phs001394.v1.pht006947.v1.p1",607,563,1170,"2017/09/22","dbgap"
"2432","phs001348.v2.pht006234.v2.p1",24,21,45,"2017/09/25","dbgap"
"2433","phs000583.v1.pht003293.v1.p1",860,756,1616,"03/21/2014","dbgap"
"2434","phs000899.v1.pht008943.v1.p1",85,81,166,"2019/04/25","dbgap"
"2436","phs000007.v32.pht003628.v5.p13",2036,2329,4365,"2020/12/21","dbgap"
"2437","phs001662.v2.pht010058.v1.p1",843,758,1601,"2021/08/19","dbgap"
"2438","phs001215.v4.pht008632.v2.p2",1064,1480,2544,"2021/06/08","dbgap"
"2441","phs001442.v3.pht010301.v1.p2",120,107,227,"2021/08/13","dbgap"
"2442","phs000286.v6.pht002139.v4.p2",1682,1982,3664,"2019/03/11","dbgap"
"2443","phs000637.v1.pht003535.v1.p1",650,617,1267,"10/21/2013","dbgap"
"2444","phs001008.v1.pht005111.v1.p1",419,605,1024,"11/13/2015","dbgap"
"2446","phs001279.v1.pht007219.v1.p1",15,23,38,"2017/12/08","dbgap"
"2447","phs000007.v32.pht005156.v2.p13",659,739,1398,"2020/12/21","dbgap"
"2448","phs001547.v2.pht009990.v1.p1",75,15,90,"2021/07/15","dbgap"
"2449","phs000280.v7.pht004123.v2.p1",5431,6623,12054,"2020/06/18","dbgap"
"2450","phs001188.v2.pht006300.v2.p1",57,49,106,"2020/01/06","dbgap"
"2452","phs001289.v1.pht007786.v1.p1",16,13,29,"2018/04/16","dbgap"
"2453","phs000496.v1.pht003169.v1.p1",1048,2091,3139,"03/28/2014","dbgap"
"2454","phs000577.v1.pht007284.v1.p1",17,29,46,"2017/12/20","dbgap"
"2455","phs000219.v1.pht001046.v1.p1",664,1054,1718,"01/19/2010","dbgap"
"2456","phs000886.v1.pht004650.v1.p1",30,44,74,"05/26/2016","dbgap"
"2458","phs000128.v3.pht000455.v2.p3",2943,3500,6443,"04/29/2016","dbgap"
"2459","phs000759.v1.pht003911.v1.p1",8,10,18,"06/20/2014","dbgap"
"2461","phs001705.v1.pht009271.v1.p1",314,251,565,"2019/07/26","dbgap"
"2462","phs001333.v2.pht006528.v2.p1",9,11,20,"2019/08/29","dbgap"
"2464","phs000926.v1.pht004864.v1.p1",3,1,4,"08/04/2015","dbgap"
"2466","phs000007.v32.pht000686.v7.p13",948,1008,1956,"2020/12/21","dbgap"
"2470","phs000086.v3.pht000227.v1.p1",761,680,1441,"11/04/2014","dbgap"
"2471","phs000285.v3.pht001574.v2.p2",947,1065,2012,"08/20/2013","dbgap"
"2472","phs000341.v2.pht002672.v2.p1",152,89,241,"11/21/2016","dbgap"
"2473","phs000007.v32.pht004812.v3.p13",836,996,1832,"2020/12/21","dbgap"
"2474","phs002048.v2.pht010315.v2.p1",4,54,58,"2021/03/17","dbgap"
"2475","phs001231.v2.pht006180.v2.p1",12,8,20,"2018/04/20","dbgap"
"2476","phs001599.v1.pht011434.v1.p1",459,484,943,"2021/07/29","dbgap"
"2477","phs000128.v3.pht000601.v3.p3",7980,7897,15877,"04/29/2016","dbgap"
"2478","phs000620.v1.pht003893.v1.p1",2824,3273,6097,"03/03/2015","dbgap"
"2479","phs001198.v1.pht007863.v1.p1",59,50,109,"2018/05/21","dbgap"
"2480","phs002436.v1.pht011378.v1.p1",7,6,13,"2021/07/07","dbgap"
"2481","phs001310.v1.pht006874.v1.p1",26,24,50,"2017/09/18","dbgap"
"2482","phs001305.v1.pht007108.v1.p1",5,7,12,"2017/11/01","dbgap"
"2483","phs000539.v1.pht003019.v1.p1",3,5,8,"11/29/2012","dbgap"
"2484","phs001213.v2.pht005837.v1.p1",1160,611,1771,"2020/02/27","dbgap"
"2485","phs000171.v1.pht000750.v1.p1",636,1284,1920,"12/11/2009","dbgap"
"2486","phs000830.v1.pht004923.v1.p1",11,2,13,"08/21/2015","dbgap"
"2487","phs001012.v1.pht005548.v1.p1",1033,1097,2130,"06/22/2016","dbgap"
"2488","phs002000.v1.pht010118.v1.p1",38,37,75,"2020/06/11","dbgap"
"2489","phs000588.v1.pht009303.v1.p1",42,151,193,"2019/07/26","dbgap"
"2491","phs000879.v1.pht005035.v1.p1",15,15,30,"10/14/2015","dbgap"
"2492","phs002252.v1.pht010671.v1.p1",9,4,13,"2021/01/06","dbgap"
"2493","phs000128.v3.pht000549.v2.p3",2943,3500,6443,"04/29/2016","dbgap"
"2494","phs001802.v1.pht008961.v1.p1",3,2,5,"2019/04/09","dbgap"
"2495","phs002022.v1.pht010183.v1.p1",8,15,23,"2020/07/10","dbgap"
"2496","phs000265.v3.pht001273.v3.p1",37,32,69,"10/17/2011","dbgap"
"2497","phs000285.v3.pht001710.v2.p2",873,956,1829,"08/20/2013","dbgap"
"2498","phs000086.v3.pht000343.v1.p1",2,3,5,"11/04/2014","dbgap"
"2499","phs000788.v2.pht004627.v2.p3",31982,46441,78423,"2018/02/01","dbgap"
"2503","phs000007.v32.pht004368.v5.p13",1529,1882,3411,"2020/12/21","dbgap"
"2505","phs001908.v2.pht009531.v2.p1",5,7,12,"2021/04/27","dbgap"
"2507","phs001815.v1.pht009009.v1.p1",573,1064,1637,"2020/08/05","dbgap"
"2508","phs000632.v1.pht003579.v1.p1",6,4,10,"02/07/2014","dbgap"
"2509","phs001607.v3.pht010151.v3.p2",2535,1114,3649,"2021/07/29","dbgap"
"2510","phs001421.v1.pht007027.v1.p1",20,17,37,"2018/01/11","dbgap"
"2511","phs000285.v3.pht001728.v1.p2",2,7,9,"08/20/2013","dbgap"
"2512","phs000901.v1.pht004674.v1.p1",44,13,57,"06/01/2015","dbgap"
"2514","phs001743.v1.pht008923.v1.p1",23,3,26,"2019/03/28","dbgap"
"2515","phs000737.v1.pht004445.v1.p1",565,750,1315,"01/29/2015","dbgap"
"2516","phs001251.v1.pht005951.v1.p1",2,2,4,"11/21/2016","dbgap"
"2517","phs001570.v2.pht007867.v1.p1",2,275,277,"2020/04/14","dbgap"
"2518","phs000660.v1.pht003512.v1.p1",5,7,12,"06/04/2014","dbgap"
"2519","phs002188.v1.pht011032.v1.p1",5,5,10,"2021/03/22","dbgap"
"2520","phs001552.v1.pht008396.v1.p1",1329,497,1826,"2018/09/21","dbgap"
"2521","phs000007.v32.pht005168.v1.p13",677,800,1477,"2020/12/21","dbgap"
"2522","phs001199.v1.pht005707.v1.p1",138,59,197,"08/29/2016","dbgap"
"2523","phs001057.v1.pht005303.v1.p1",894,99,993,"02/18/2016","dbgap"
"2525","phs001084.v1.pht005329.v1.p1",8,10,18,"03/07/2016","dbgap"
"2526","phs002105.v1.pht010705.v1.p1",69,150,219,"2020/12/01","dbgap"
"2527","phs000086.v3.pht000337.v1.p1",731,666,1397,"11/04/2014","dbgap"
"2528","phs000128.v3.pht000528.v2.p3",2943,3500,6443,"04/29/2016","dbgap"
"2529","phs001215.v4.pht008631.v2.p2",1067,1483,2550,"2021/06/08","dbgap"
"2530","phs000437.v1.pht003688.v1.p1",4,8,12,"04/09/2014","dbgap"
"2531","phs001197.v1.pht007563.v1.p1",106,82,188,"2018/04/27","dbgap"
"2532","phs001778.v1.pht009831.v1.p1",5,6,11,"2020/07/16","dbgap"
"2534","phs000888.v1.pht005559.v1.p1",2247,2179,4426,"08/12/2016","dbgap"
"2535","phs000303.v1.pht001896.v1.p1",1004,1022,2026,"10/25/2011","dbgap"
"2536","phs000796.v1.pht005383.v1.p1",1111,2024,3135,"05/17/2016","dbgap"
"2537","phs001881.v1.pht010565.v1.p1",2839,1545,4384,"2020/10/01","dbgap"
"2538","phs000553.v1.pht003132.v1.p1",1,4,5,"06/26/2013","dbgap"
"2542","phs002025.v1.pht010235.v1.p1",2281,1718,3999,"2020/07/20","dbgap"
"2543","phs002008.v1.pht010203.v1.p1",14,4,18,"2020/06/15","dbgap"
"2544","phs000983.v1.pht005004.v1.p1",93,419,512,"10/05/2015","dbgap"
"2545","phs001311.v1.pht007918.v1.p1",35,25,60,"2018/05/15","dbgap"
"2546","phs000636.v1.pht003429.v1.p1",15,30,45,"08/09/2013","dbgap"
"2547","phs001404.v1.pht010786.v1.p1",33,125,158,"2020/12/15","dbgap"
"2549","phs000550.v1.pht003128.v1.p1",2,1,3,"01/18/2013","dbgap"
"2553","phs002408.v1.pht011159.v1.p1",4,3,7,"2021/04/28","dbgap"
"2554","phs000001.v3.pht002479.v1.p1",2011,2580,4591,"02/24/2012","dbgap"
"2556","phs000209.v13.pht002140.v2.p3",2722,2864,5586,"11/05/2014","dbgap"
"2557","phs000653.v3.pht003478.v3.p1",538,476,1014,"2018/09/11","dbgap"
"2558","phs000007.v32.pht000036.v10.p13",1604,1885,3489,"2020/12/21","dbgap"
"2559","phs001840.v1.pht009147.v1.p1",4,2,6,"2019/06/13","dbgap"
"2560","phs001787.v1.pht009045.v1.p1",23,28,51,"2020/06/18","dbgap"
"2561","phs001048.v2.pht008898.v1.p1",171,136,307,"2019/04/10","dbgap"
"2562","phs001241.v1.pht005924.v1.p1",7,8,15,"2017/11/14","dbgap"
"2563","phs000823.v1.pht005048.v1.p1",178,209,387,"05/11/2016","dbgap"
"2564","phs000280.v7.pht004233.v2.p1",5306,6409,11715,"2020/06/18","dbgap"
"2565","phs001229.v1.pht006547.v1.p1",25,14,39,"06/15/2017","dbgap"
"2566","phs001065.v1.pht005425.v1.p1",296,313,609,"05/24/2016","dbgap"
"2567","phs001811.v1.pht009060.v1.p1",33,69,102,"2019/05/13","dbgap"
"2569","phs001200.v1.pht005928.v1.p1",4,3,7,"11/16/2016","dbgap"
"2570","phs000571.v3.pht003184.v3.p2",20,16,36,"12/01/2015","dbgap"
"2571","phs000128.v3.pht000501.v2.p3",2943,3500,6443,"04/29/2016","dbgap"
"2573","phs001488.v1.pht007408.v1.p1",260,293,553,"2018/02/08","dbgap"
"2574","phs001430.v2.pht008063.v2.p1",13,12,25,"2020/02/06","dbgap"
"2575","phs000286.v6.pht008728.v1.p2",75,111,186,"2019/03/11","dbgap"
"2576","phs000579.v1.pht003277.v1.p1",26,25,51,"11/04/2013","dbgap"
"2577","phs000715.v1.pht003745.v1.p1",15,17,32,"03/13/2014","dbgap"
"2578","phs000007.v32.pht003631.v5.p13",1494,1690,3184,"2020/12/21","dbgap"
"2579","phs001995.v1.pht009991.v1.p1",298,380,678,"2020/07/17","dbgap"
"2580","phs001168.v2.pht007579.v2.p2",720,591,1311,"2019/03/19","dbgap"
"2581","phs001875.v1.pht009651.v1.p1",3,3,6,"2019/12/06","dbgap"
"2582","phs000128.v3.pht000539.v2.p3",2943,3500,6443,"04/29/2016","dbgap"
"2583","phs000595.v1.pht006640.v1.p1",286,329,615,"07/05/2017","dbgap"
"2585","phs000933.v2.pht004775.v2.p1",169,121,290,"2018/03/09","dbgap"
"2586","phs001026.v1.pht005122.v1.p1",68,57,125,"11/16/2015","dbgap"
"2587","phs000409.v1.pht002738.v1.p1",63,27,90,"05/23/2012","dbgap"
"2588","phs001278.v1.pht006275.v1.p1",10,47,57,"06/16/2017","dbgap"
"2591","phs000439.v1.pht002931.v1.p1",1262,626,1888,"06/20/2014","dbgap"
"2592","phs001279.v1.pht007215.v1.p1",15,22,37,"2017/12/08","dbgap"
"2593","phs000007.v32.pht000039.v13.p13",2228,2438,4666,"2020/12/21","dbgap"
"2596","phs001609.v1.pht008142.v1.p1",89,875,964,"2019/01/10","dbgap"
"2597","phs000086.v3.pht000277.v1.p1",761,680,1441,"11/04/2014","dbgap"
"2598","phs001122.v1.pht008637.v1.p1",317,282,599,"2021/03/23","dbgap"
"2599","phs000128.v3.pht000467.v2.p3",2943,3500,6443,"04/29/2016","dbgap"
"2600","phs000280.v7.pht006479.v1.p1",2253,2952,5205,"2020/06/18","dbgap"
"2601","phs000577.v1.pht007275.v1.p1",47,47,94,"2017/12/20","dbgap"
"2603","phs000797.v1.pht004266.v1.p1",4,1,5,"09/29/2014","dbgap"
"2604","phs000819.v1.pht004381.v1.p1",6,14,20,"2018/01/18","dbgap"
"2605","phs000578.v1.pht007023.v1.p1",15,10,25,"2017/10/11","dbgap"
"2606","phs001251.v1.pht005949.v1.p1",2,2,4,"11/21/2016","dbgap"
"2607","phs000126.v2.pht000321.v2.p1",616,432,1048,"08/29/2016","dbgap"
"2608","phs000701.v1.pht005507.v1.p1",13,7,20,"06/01/2017","dbgap"
"2609","phs001488.v1.pht007388.v1.p1",254,289,543,"2018/02/08","dbgap"
"2612","phs000285.v3.pht001847.v2.p2",769,832,1601,"08/20/2013","dbgap"
"2613","phs000128.v3.pht000519.v2.p3",2943,3500,6443,"04/29/2016","dbgap"
"2614","phs001110.v3.pht006514.v2.p1",306,288,594,"2020/09/08","dbgap"
"2616","phs001406.v1.pht007746.v1.p1",415,517,932,"2019/10/11","dbgap"
"2618","phs001641.v1.pht010025.v1.p1",559,1278,1837,"2020/03/24","dbgap"
"2619","phs001322.v2.pht006329.v2.p1",8,4,12,"2018/04/30","dbgap"
"2620","phs002208.v1.pht010499.v1.p1",104,77,181,"2021/06/11","dbgap"
"2621","phs001882.v1.pht010491.v1.p1",68,49999,50067,"2021/07/20","dbgap"
"2622","phs001864.v1.pht009266.v1.p1",13,9,22,"2019/07/25","dbgap"
"2623","phs002394.v1.pht011133.v1.p1",24,29,53,"2021/04/19","dbgap"
"2624","phs000249.v2.pht001876.v2.p1",254,128,382,"04/16/2014","dbgap"
"2625","phs002234.v1.pht010517.v1.p1",3,1,4,"2020/09/15","dbgap"
"2626","phs001867.v1.pht009354.v1.p1",6,7,13,"2019/08/05","dbgap"
"2627","phs000574.v1.pht005859.v1.p1",41,972,1013,"03/06/2017","dbgap"
"2628","phs001488.v1.pht007416.v1.p1",23,124,147,"2018/02/08","dbgap"
"2630","phs001089.v4.pht005484.v4.p1",729,674,1403,"2021/09/23","dbgap"
"2631","phs000285.v3.pht001653.v2.p2",908,1016,1924,"08/20/2013","dbgap"
"2632","phs000353.v1.pht002253.v1.p1",40,33,73,"08/08/2011","dbgap"
"2633","phs001995.v1.pht009994.v1.p1",298,380,678,"2020/07/17","dbgap"
"2634","phs000007.v32.pht000076.v8.p13",1501,1722,3223,"2020/12/21","dbgap"
"2635","phs000653.v3.pht008354.v1.p1",1041,1145,2186,"2018/09/11","dbgap"
"2636","phs000573.v1.pht003217.v1.p1",49,34,83,"03/20/2013","dbgap"
"2637","phs001289.v1.pht007793.v1.p1",16,13,29,"2018/04/16","dbgap"
"2638","phs000276.v2.pht003627.v1.p1",2592,2810,5402,"01/22/2014","dbgap"
"2639","phs001428.v1.pht008385.v1.p1",16,1831,1847,"2018/09/20","dbgap"
"2640","phs000629.v1.pht003385.v1.p1",595,976,1571,"04/24/2015","dbgap"
"2641","phs000398.v1.pht002467.v1.p1",234,361,595,"02/21/2012","dbgap"
"2642","phs002245.v1.pht010531.v1.p1",338,246,584,"2020/10/16","dbgap"
"2643","phs000405.v1.pht002608.v1.p1",6,7,13,"11/15/2012","dbgap"
"2644","phs000608.v1.pht003345.v1.p1",792,667,1459,"07/15/2013","dbgap"
"2646","phs000171.v1.pht000768.v1.p1",635,1281,1916,"12/11/2009","dbgap"
"2647","phs000007.v32.pht003903.v4.p13",1207,1305,2512,"2020/12/21","dbgap"
"2649","phs001488.v1.pht007384.v1.p1",24,15,39,"2018/02/08","dbgap"
"2650","phs000436.v1.pht002832.v1.p1",746,459,1205,"11/19/2013","dbgap"
"2651","phs001487.v1.pht007139.v1.p1",518,249,767,"2018/08/02","dbgap"
"2652","phs000286.v6.pht008753.v1.p2",1009,1780,2789,"2019/03/11","dbgap"
"2653","phs000918.v1.pht004749.v1.p1",6842,4560,11402,"06/10/2015","dbgap"
"2654","phs001740.v1.pht008622.v1.p1",353,226,579,"2019/08/01","dbgap"
"2655","phs001765.v1.pht008664.v1.p1",26,13,39,"2019/01/29","dbgap"
"2656","phs001945.v1.pht010486.v1.p1",46,11243,11289,"2021/05/25","dbgap"
"2657","phs002006.v2.pht010164.v2.p1",13,13,26,"2020/09/02","dbgap"
"2659","phs001244.v1.pht006056.v1.p1",73,30,103,"01/09/2017","dbgap"
"2660","phs000563.v1.pht003083.v1.p1",1,3,4,"10/24/2013","dbgap"
"2661","phs000285.v3.pht001714.v2.p2",884,977,1861,"08/20/2013","dbgap"
"2662","phs000571.v3.pht003186.v3.p2",1653,1220,2873,"12/01/2015","dbgap"
"2663","phs001206.v1.pht007344.v1.p1",6,6,12,"2018/02/27","dbgap"
"2664","phs000664.v1.pht003544.v1.p1",17,17,34,"10/22/2013","dbgap"
"2665","phs001082.v1.pht005378.v1.p1",8,7,15,"02/09/2017","dbgap"
"2666","phs002020.v1.pht010228.v1.p1",438,352,790,"2020/05/26","dbgap"
"2667","phs000732.v1.pht003799.v1.p1",12,8,20,"04/14/2014","dbgap"
"2668","phs001076.v1.pht005364.v1.p1",2378,2102,4480,"04/24/2017","dbgap"
"2669","phs000621.v1.pht003330.v1.p1",149,66,215,"07/09/2013","dbgap"
"2670","phs001943.v1.pht009713.v1.p1",14,20,34,"2019/12/17","dbgap"
"2671","phs000280.v7.pht006456.v1.p1",1124,1407,2531,"2020/06/18","dbgap"
"2672","phs001017.v1.pht005077.v1.p1",79,1680,1759,"2021/07/02","dbgap"
"2673","phs002052.v1.pht010318.v1.p1",20,20,40,"2020/08/05","dbgap"
"2676","phs000280.v7.pht004158.v2.p1",5349,6499,11848,"2020/06/18","dbgap"
"2677","phs000899.v1.pht008944.v1.p1",85,81,166,"2019/04/25","dbgap"
"2678","phs001282.v2.pht006098.v2.p1",29,8,37,"2020/01/21","dbgap"
"2679","phs000007.v32.pht007775.v3.p13",2119,2450,4569,"2020/12/21","dbgap"
"2680","phs000421.v1.pht003236.v1.p1",1697,2895,4592,"05/21/2013","dbgap"
"2681","phs000007.v32.pht000211.v5.p13",110,193,303,"2020/12/21","dbgap"
"2682","phs000255.v1.pht001252.v1.p1",56,60,116,"06/09/2010","dbgap"
"2683","phs001189.v4.pht005979.v2.p1",293,70,363,"2021/06/01","dbgap"
"2684","phs001033.v1.pht005201.v1.p1",85,74,159,"09/02/2016","dbgap"
"2685","phs001298.v1.pht008649.v1.p1",2298,2504,4802,"2019/01/29","dbgap"
"2686","phs000285.v3.pht001672.v2.p2",908,1016,1924,"08/20/2013","dbgap"
"2687","phs001087.v3.pht005758.v3.p1",74,30,104,"2020/09/18","dbgap"
"2688","phs001811.v1.pht009063.v1.p1",33,69,102,"2019/05/13","dbgap"
"2689","phs000883.v1.pht004598.v1.p1",1331,723,2054,"01/15/2016","dbgap"
"2690","phs000280.v7.pht004087.v2.p1",1691,1584,3275,"2020/06/18","dbgap"
"2691","phs001270.v1.pht006252.v1.p1",3,7,10,"2017/10/04","dbgap"
"2692","phs001750.v1.pht008587.v1.p1",21,18,39,"2018/12/11","dbgap"
"2693","phs001488.v1.pht007411.v1.p1",69,82,151,"2018/02/08","dbgap"
"2694","phs001217.v3.pht007761.v1.p1",1745,1607,3352,"2021/06/08","dbgap"
"2695","phs000007.v32.pht000162.v8.p13",1275,1527,2802,"2020/12/21","dbgap"
"2696","phs001954.v1.pht009797.v1.p1",36,53,89,"2020/01/10","dbgap"
"2698","phs001947.v1.pht010135.v1.p1",15,8,23,"2020/04/14","dbgap"
"2699","phs000007.v32.pht002854.v4.p13",1760,1623,3383,"2020/12/21","dbgap"
"2700","phs000286.v6.pht001957.v2.p2",1293,2157,3450,"2019/03/11","dbgap"
"2701","phs001596.v1.pht007967.v1.p1",15,22,37,"2018/05/17","dbgap"
"2702","phs000697.v1.pht007700.v1.p1",17,2,19,"2018/03/26","dbgap"
"2703","phs001782.v2.pht008797.v2.p1",330,472,802,"2021/07/02","dbgap"
"2705","phs000490.v1.pht002964.v1.p1",574,426,1000,"2018/05/07","dbgap"
"2708","phs000595.v1.pht006632.v1.p1",287,330,617,"07/05/2017","dbgap"
"2709","phs000297.v1.pht002391.v1.p1",2289,2992,5281,"07/27/2012","dbgap"
"2710","phs000376.v1.pht002307.v1.p1",40,37,77,"10/16/2014","dbgap"
"2711","phs000638.v1.pht003571.v1.p1",1341,1146,2487,"11/20/2013","dbgap"
"2712","phs002049.v1.pht010296.v1.p1",64,53,117,"2020/06/30","dbgap"
"2713","phs000624.v1.pht009130.v1.p1",345,277,622,"2019/06/03","dbgap"
"2714","phs000588.v1.pht009298.v1.p1",35,134,169,"2019/07/26","dbgap"
"2716","phs000007.v32.pht001226.v4.p13",591,685,1276,"2020/12/21","dbgap"
"2717","phs000285.v3.pht001582.v2.p2",947,1065,2012,"08/20/2013","dbgap"
"2718","phs000895.v1.pht005072.v1.p1",88,72,160,"04/01/2016","dbgap"
"2721","phs000280.v7.pht006459.v1.p1",2368,3176,5544,"2020/06/18","dbgap"
"2722","phs001421.v1.pht007028.v1.p1",20,17,37,"2018/01/11","dbgap"
"2723","phs001729.v2.pht010126.v1.p1",11,8,19,"2021/08/26","dbgap"
"2724","phs001664.v1.pht008439.v1.p1",827,392,1219,"2018/10/02","dbgap"
"2725","phs001911.v1.pht009518.v1.p1",6,11,17,"2019/10/08","dbgap"
"2727","phs001459.v1.pht007311.v1.p1",7,29,36,"2020/09/28","dbgap"
"2729","phs001647.v1.pht008201.v1.p1",271,112,383,"2018/08/19","dbgap"
"2730","phs000285.v3.pht001707.v2.p2",888,982,1870,"08/20/2013","dbgap"
"2731","phs001662.v2.pht010063.v1.p1",843,758,1601,"2021/08/19","dbgap"
"2732","phs001721.v1.pht009719.v1.p1",2234,2574,4808,"2020/02/04","dbgap"
"2733","phs000352.v1.pht002287.v1.p1",21,25,46,"10/28/2011","dbgap"
"2734","phs000776.v1.pht003947.v1.p1",7,26,33,"08/04/2014","dbgap"
"2735","phs001197.v1.pht007565.v1.p1",106,82,188,"2018/04/27","dbgap"
"2736","phs001194.v3.pht005822.v2.p2",7253,6459,13712,"2020/07/24","dbgap"
"2738","phs002039.v1.pht010270.v1.p1",5,13,18,"2020/06/10","dbgap"
"2739","phs000701.v1.pht005511.v1.p1",48,43,91,"06/01/2017","dbgap"
"2741","phs001134.v1.pht011227.v1.p1",105,335,440,"2021/05/17","dbgap"
"2742","phs000280.v7.pht004196.v2.p1",4883,6019,10902,"2020/06/18","dbgap"
"2743","phs000982.v1.pht004981.v1.p1",1358,1489,2847,"09/14/2015","dbgap"
"2744","phs000620.v1.pht003891.v1.p1",3546,3831,7377,"03/03/2015","dbgap"
"2745","phs000327.v1.pht003011.v1.p1",58,36,94,"03/22/2013","dbgap"
"2746","phs001392.v1.pht006895.v1.p1",5,3,8,"2017/09/22","dbgap"
"2747","phs000428.v2.pht005037.v1.p2",6472,9148,15620,"01/27/2017","dbgap"
"2748","phs000999.v3.pht005180.v3.p1",130,112,242,"2019/11/22","dbgap"
"2749","phs002204.v1.pht010909.v1.p1",2,2,4,"2021/02/02","dbgap"
"2750","phs000285.v3.pht001684.v2.p2",50,50,100,"08/20/2013","dbgap"
"2751","phs000847.v2.pht005718.v1.p1",676,718,1394,"12/02/2016","dbgap"
"2754","phs000888.v1.pht005575.v1.p1",2756,4050,6806,"08/12/2016","dbgap"
"2755","phs001451.v3.pht007131.v2.p1",6,6,12,"2021/01/26","dbgap"
"2756","phs001196.v1.pht005698.v1.p1",2788,2408,5196,"2018/04/05","dbgap"
"2757","phs000682.v1.pht003598.v1.p1",103,59,162,"11/25/2013","dbgap"
"2758","phs001373.v2.pht006702.v2.p2",18,15,33,"2019/10/16","dbgap"
"2762","phs000481.v3.pht002659.v3.p2",392,370,762,"2020/07/17","dbgap"
"2763","phs000280.v7.pht006412.v1.p1",417,372,789,"2020/06/18","dbgap"
"2764","phs001517.v2.pht007480.v2.p2",514,480,994,"2020/04/30","dbgap"
"2765","phs000285.v3.pht001804.v2.p2",947,1065,2012,"08/20/2013","dbgap"
"2766","phs000007.v32.pht002143.v7.p13",2111,2427,4538,"2020/12/21","dbgap"
"2767","phs000439.v1.pht002930.v1.p1",1262,626,1888,"06/20/2014","dbgap"
"2768","phs000285.v3.pht001868.v2.p2",947,1065,2012,"08/20/2013","dbgap"
"2769","phs000481.v3.pht002661.v3.p2",392,370,762,"2020/07/17","dbgap"
"2770","phs001293.v3.pht008893.v1.p1",16451,16124,32575,"2021/06/09","dbgap"
"2772","phs000007.v32.pht009751.v2.p13",1311,1558,2869,"2020/12/21","dbgap"
"2773","phs001318.v1.pht008029.v1.p1",24,13,37,"2018/05/31","dbgap"
"2774","phs001793.v1.pht008899.v1.p1",21,12,33,"2020/08/04","dbgap"
"2775","phs001660.v1.pht008412.v1.p1",59,44,103,"2018/10/05","dbgap"
"2777","phs001744.v1.pht008572.v1.p1",2299,926,3225,"2020/08/24","dbgap"
"2778","phs000646.v1.pht003437.v1.p1",2,1,3,"08/06/2013","dbgap"
"2780","phs000726.v1.pht003777.v1.p1",546,426,972,"10/27/2014","dbgap"
"2781","phs001538.v1.pht008088.v1.p1",222,317,539,"2018/06/01","dbgap"
"2782","phs001227.v1.pht005832.v1.p1",70,95,165,"2020/02/18","dbgap"
"2783","phs001683.v2.pht008866.v2.p1",201,225,426,"2020/07/15","dbgap"
"2784","phs001730.v2.pht010132.v1.p1",24,17,41,"2021/08/26","dbgap"
"2785","phs000720.v4.pht003880.v2.p1",509,294,803,"2021/03/24","dbgap"
"2786","phs000280.v7.pht004104.v2.p1",5434,6649,12083,"2020/06/18","dbgap"
"2787","phs001943.v1.pht009716.v1.p1",14,20,34,"2019/12/17","dbgap"
"2788","phs001284.v1.pht009034.v1.p1",125,92,217,"2019/05/09","dbgap"
"2789","phs001290.v1.pht010332.v1.p1",3202,2867,6069,"2020/07/29","dbgap"
"2790","phs000209.v13.pht004320.v1.p3",3057,3363,6420,"11/05/2014","dbgap"
"2791","phs001194.v3.pht005815.v2.p2",50,51,101,"2020/07/24","dbgap"
"2795","phs002437.v1.pht011430.v1.p1",8,9,17,"2021/07/29","dbgap"
"2797","phs001244.v1.pht006057.v1.p1",73,30,103,"01/09/2017","dbgap"
"2798","phs000872.v1.pht004572.v1.p1",18,6,24,"03/24/2015","dbgap"
"2800","phs000280.v7.pht004146.v2.p1",4883,6019,10902,"2020/06/18","dbgap"
"2801","phs000280.v7.pht004078.v2.p1",6743,8110,14853,"2020/06/18","dbgap"
"2802","phs001252.v1.pht006393.v1.p1",1691,1055,2746,"05/16/2017","dbgap"
"2803","phs001545.v2.pht009966.v1.p1",316,152,468,"2021/07/13","dbgap"
"2804","phs000842.v2.pht004402.v2.p1",1142,686,1828,"2019/03/22","dbgap"
"2805","phs000682.v1.pht003595.v1.p1",457,402,859,"11/25/2013","dbgap"
"2806","phs002334.v1.pht010958.v1.p1",11,18,29,"2021/02/12","dbgap"
"2807","phs000575.v2.pht005893.v2.p1",177,212,389,"2020/02/14","dbgap"
"2808","phs001316.v1.pht008015.v1.p1",2,1,3,"2018/05/31","dbgap"
"2809","phs000671.v1.pht003546.v1.p1",9,1,10,"10/25/2013","dbgap"
"2810","phs001565.v1.pht007895.v1.p1",39,32,71,"2018/05/10","dbgap"
"2811","phs000935.v1.pht004818.v1.p1",93,66,159,"11/16/2016","dbgap"
"2813","phs000007.v32.pht002564.v6.p13",1575,1772,3347,"2020/12/21","dbgap"
"2814","phs001446.v2.pht009628.v1.p1",725,1155,1880,"2021/06/24","dbgap"
"2817","phs000128.v3.pht000545.v2.p3",2943,3500,6443,"04/29/2016","dbgap"
"2818","phs001486.v3.pht008701.v3.p3",545,531,1076,"2021/10/06","dbgap"
"2819","phs001684.v1.pht008392.v1.p1",16,18,34,"2018/09/19","dbgap"
"2821","phs000516.v2.pht002828.v2.p1",34,25,59,"03/10/2015","dbgap"
"2823","phs000339.v2.pht002486.v1.p1",46,88,134,"02/22/2013","dbgap"
"2824","phs000609.v1.pht003284.v1.p1",18,9,27,"05/14/2013","dbgap"
"2825","phs001065.v1.pht005404.v1.p1",28,16,44,"05/24/2016","dbgap"
"2826","phs001296.v2.pht006355.v2.p1",9,30,39,"2019/05/31","dbgap"
"2829","phs000924.v4.pht006324.v4.p1",98,126,224,"2019/10/07","dbgap"
"2830","phs000086.v3.pht004261.v1.p1",740,661,1401,"11/04/2014","dbgap"
"2831","phs000784.v3.pht004283.v1.p1",917,859,1776,"2019/11/15","dbgap"
"2832","phs001065.v1.pht005398.v1.p1",2,1,3,"05/24/2016","dbgap"
"2833","phs001616.v2.pht010143.v1.p2",11472,13446,24918,"2020/10/27","dbgap"
"2835","phs001488.v1.pht007409.v1.p1",260,293,553,"2018/02/08","dbgap"
"2838","phs001080.v1.pht005372.v1.p1",62,41,103,"04/06/2016","dbgap"
"2839","phs001491.v2.pht007255.v2.p1",134,171,305,"2020/03/09","dbgap"
"2840","phs000578.v1.pht007014.v1.p1",49,44,93,"2017/10/11","dbgap"
"2841","phs001003.v2.pht010322.v2.p1",56,89,145,"2021/03/01","dbgap"
"2842","phs001403.v1.pht006843.v1.p1",7,14,21,"2017/09/12","dbgap"
"2843","phs000625.v1.pht003852.v1.p1",3361,2762,6123,"06/13/2014","dbgap"
"2844","phs000549.v1.pht002992.v1.p1",1,5,6,"09/28/2012","dbgap"
"2846","phs001963.v1.pht009829.v1.p1",3885,2953,6838,"2020/11/24","dbgap"
"2847","phs000592.v1.pht006596.v1.p1",178,144,322,"07/12/2017","dbgap"
"2848","phs000287.v7.pht005388.v1.p1",512,689,1201,"2020/01/23","dbgap"
"2849","phs001817.v1.pht009134.v1.p1",85,177,262,"2019/06/04","dbgap"
"2850","phs001189.v4.pht005980.v2.p1",293,70,363,"2021/06/01","dbgap"
"2851","phs000362.v1.pht003230.v1.p1",10,2,12,"08/26/2013","dbgap"
"2852","phs000944.v1.pht005288.v1.p1",1,3,4,"02/05/2016","dbgap"
"2854","phs000128.v3.pht000468.v2.p3",2943,3500,6443,"04/29/2016","dbgap"
"2855","phs002015.v1.pht010389.v1.p1",233,338,571,"2020/09/18","dbgap"
"2856","phs001323.v2.pht010115.v2.p1",377,284,661,"2020/04/30","dbgap"
"2857","phs000280.v7.pht004232.v2.p1",6013,7179,13192,"2020/06/18","dbgap"
"2858","phs002015.v1.pht010372.v1.p1",1351,1909,3260,"2020/09/18","dbgap"
"2859","phs000574.v1.pht005872.v1.p1",41,939,980,"03/06/2017","dbgap"
"2861","phs001317.v1.pht008041.v1.p1",25,34,59,"2018/06/01","dbgap"
"2862","phs000577.v1.pht007282.v1.p1",142,295,437,"2017/12/20","dbgap"
"2863","phs001426.v1.pht006914.v1.p1",125,121,246,"2017/09/19","dbgap"
"2865","phs000007.v32.pht004804.v3.p13",175,227,402,"2020/12/21","dbgap"
"2866","phs000742.v1.pht008116.v1.p1",791,1047,1838,"2018/07/23","dbgap"
"2867","phs000285.v3.pht001873.v1.p2",1,6,7,"08/20/2013","dbgap"
"2868","phs001460.v1.pht006910.v1.p1",12,4,16,"2017/09/22","dbgap"
"2869","phs000946.v5.pht004973.v3.p1",21,53,74,"2021/05/07","dbgap"
"2870","phs000720.v4.pht003881.v2.p1",509,294,803,"2021/03/24","dbgap"
"2871","phs001289.v1.pht007787.v1.p1",16,13,29,"2018/04/16","dbgap"
"2872","phs000086.v3.pht000335.v1.p1",705,640,1345,"11/04/2014","dbgap"
"2873","phs002310.v1.pht011207.v1.p1",1328,559,1887,"2021/05/05","dbgap"
"2875","phs000885.v1.pht004606.v1.p1",42,8,50,"03/19/2015","dbgap"
"2876","phs000442.v1.pht002488.v1.p1",53,38,91,"04/12/2012","dbgap"
"2877","phs000235.v17.pht001132.v16.p4",113,144,257,"2021/08/30","dbgap"
"2878","phs002234.v1.pht010514.v1.p1",3,1,4,"2020/09/15","dbgap"
"2879","phs000979.v3.pht005194.v3.p2",607,363,970,"2019/09/16","dbgap"
"2880","phs000280.v7.pht004131.v2.p1",5446,6661,12107,"2020/06/18","dbgap"
"2881","phs000313.v4.pht002066.v4.p2",845,1232,2077,"2017/11/22","dbgap"
"2885","phs000360.v3.pht003256.v2.p1",8474,10189,18663,"08/05/2016","dbgap"
"2886","phs000007.v32.pht000023.v4.p13",430,780,1210,"2020/12/21","dbgap"
"2887","phs000007.v32.pht000687.v7.p13",1519,1750,3269,"2020/12/21","dbgap"
"2889","phs001585.v1.pht008829.v1.p1",255,179,434,"2019/03/18","dbgap"
"2890","phs001591.v1.pht009695.v1.p1",1784,3322,5106,"2021/08/03","dbgap"
"2891","phs000287.v7.pht001449.v1.p1",2375,3156,5531,"2020/01/23","dbgap"
"2892","phs000697.v1.pht007693.v1.p1",28,6,34,"2018/03/26","dbgap"
"2893","phs000888.v1.pht005567.v1.p1",2355,3174,5529,"08/12/2016","dbgap"
"2895","phs001278.v1.pht006268.v1.p1",25,24,49,"06/16/2017","dbgap"
"2896","phs000007.v32.pht003905.v6.p13",2552,3010,5562,"2020/12/21","dbgap"
"2897","phs000128.v3.pht000459.v2.p3",2943,3500,6443,"04/29/2016","dbgap"
"2898","phs000748.v7.pht003889.v7.p4",606,400,1006,"2019/02/05","dbgap"
"2899","phs000128.v3.pht000557.v2.p3",2943,3500,6443,"04/29/2016","dbgap"
"2901","phs000888.v1.pht004677.v1.p1",25246,29783,55029,"08/12/2016","dbgap"
"2902","phs000993.v5.pht005013.v2.p2",464,245,709,"2021/05/20","dbgap"
"2903","phs000280.v7.pht004238.v2.p1",5438,6644,12082,"2020/06/18","dbgap"
"2904","phs001575.v2.pht009605.v1.p1",12,25,37,"2019/11/12","dbgap"
"2905","phs000911.v1.pht004977.v1.p1",8608,8852,17460,"05/06/2016","dbgap"
"2906","phs002052.v1.pht010319.v1.p1",20,20,40,"2020/08/05","dbgap"
"2907","phs001464.v1.pht006969.v1.p1",9,5,14,"2017/10/03","dbgap"
"2909","phs000571.v3.pht003183.v3.p2",447,337,784,"12/01/2015","dbgap"
"2911","phs001550.v2.pht007505.v2.p1",40,35,75,"2018/10/22","dbgap"
"2913","phs000260.v4.pht001258.v4.p2",92,18,110,"11/30/2015","dbgap"
"2914","phs000888.v1.pht005556.v1.p1",1318,1738,3056,"08/12/2016","dbgap"
"2915","phs001055.v1.pht005912.v1.p1",1200,1197,2397,"2017/08/16","dbgap"
"2916","phs001894.v1.pht009524.v1.p1",419,305,724,"2020/04/15","dbgap"
"2917","phs000750.v1.pht003935.v1.p1",112,138,250,"09/03/2014","dbgap"
"2918","phs000410.v1.pht002451.v1.p1",30,135,165,"03/11/2014","dbgap"
"2919","phs000949.v1.pht005223.v1.p1",14,14,28,"02/08/2016","dbgap"
"2921","phs001559.v1.pht007664.v1.p1",155,28,183,"2018/03/20","dbgap"
"2922","phs002015.v1.pht010387.v1.p1",161,127,288,"2020/09/18","dbgap"
"2923","phs000280.v7.pht006453.v1.p1",2376,3194,5570,"2020/06/18","dbgap"
"2924","phs000753.v1.pht003874.v1.p1",1302,988,2290,"06/05/2014","dbgap"
"2925","phs001712.v1.pht008671.v1.p1",61,91,152,"2019/01/31","dbgap"
"2926","phs000782.v1.pht003993.v1.p1",15,1,16,"2017/10/04","dbgap"
"2929","phs000007.v32.pht000606.v5.p13",894,1020,1914,"2020/12/21","dbgap"
"2930","phs000094.v1.pht001137.v1.p1",3988,3491,7479,"04/12/2010","dbgap"
"2931","phs000787.v1.pht004259.v1.p1",6,3,9,"09/23/2014","dbgap"
"2932","phs000007.v32.pht000099.v8.p13",1555,1761,3316,"2020/12/21","dbgap"
"2933","phs001925.v1.pht010571.v1.p1",2,4,6,"2020/10/27","dbgap"
"2934","phs000128.v3.pht000442.v2.p3",2943,3500,6443,"04/29/2016","dbgap"
"2935","phs001815.v1.pht009010.v1.p1",573,1064,1637,"2020/08/05","dbgap"
"2936","phs000280.v7.pht006457.v1.p1",1125,1408,2533,"2020/06/18","dbgap"
"2937","phs001235.v1.pht008446.v1.p1",2,3,5,"2019/03/21","dbgap"
"2938","phs001488.v1.pht007393.v1.p1",260,293,553,"2018/02/08","dbgap"
"2939","phs000479.v1.pht002663.v1.p1",2,1,3,"08/15/2012","dbgap"
"2941","phs001850.v1.pht009238.v1.p1",32,267,299,"2019/07/03","dbgap"
"2943","phs001736.v1.pht009328.v1.p1",1504,881,2385,"2019/07/29","dbgap"
"2944","phs001218.v3.pht005958.v1.p1",1581,1628,3209,"2021/06/08","dbgap"
"2945","phs002364.v1.pht011041.v1.p1",2,1,3,"2021/03/17","dbgap"
"2946","phs000590.v1.pht008283.v1.p1",33,36,69,"2018/08/03","dbgap"
"2947","phs002436.v1.pht011375.v1.p1",7,6,13,"2021/07/07","dbgap"
"2949","phs001228.v1.pht008134.v1.p1",571,541,1112,"2018/06/07","dbgap"
"2950","phs002059.v1.pht010427.v1.p1",925,887,1812,"2020/12/18","dbgap"
"2954","phs000494.v1.pht002799.v1.p1",2543,2019,4562,"07/19/2012","dbgap"
"2955","phs000404.v1.pht002367.v1.p1",1442,2010,3452,"12/13/2011","dbgap"
"2957","phs001096.v1.pht005606.v1.p1",519,568,1087,"06/30/2016","dbgap"
"2958","phs001288.v1.pht006762.v1.p1",64,43,107,"2017/10/19","dbgap"
"2959","phs000181.v1.pht000794.v1.p1",5275,5386,10661,"12/11/2009","dbgap"
"2961","phs000286.v6.pht008749.v1.p2",1290,2155,3445,"2019/03/11","dbgap"
"2962","phs001198.v1.pht007862.v1.p1",59,50,109,"2018/05/21","dbgap"
"2963","phs000514.v1.pht002839.v1.p1",15,4,19,"08/15/2012","dbgap"
"2964","phs001572.v1.pht007839.v1.p1",195,117,312,"2018/04/20","dbgap"
"2965","phs001279.v1.pht007213.v1.p1",15,23,38,"2017/12/08","dbgap"
"2967","phs000285.v3.pht001828.v2.p2",876,990,1866,"08/20/2013","dbgap"
"2968","phs001194.v3.pht005825.v2.p2",110,107,217,"2020/07/24","dbgap"
"2970","phs001168.v2.pht007581.v2.p2",720,591,1311,"2019/03/19","dbgap"
"2971","phs001418.v1.pht007238.v1.p1",13,20,33,"2018/11/15","dbgap"
"2972","phs000509.v1.pht004314.v1.p1",60,28,88,"02/18/2015","dbgap"
"2974","phs001032.v6.pht005098.v2.p2",826,308,1134,"2021/05/20","dbgap"
"2975","phs001330.v2.pht007533.v2.p1",25,15,40,"2019/11/08","dbgap"
"2976","phs000641.v1.pht003475.v1.p1",10,5,15,"08/21/2013","dbgap"
"2977","phs001544.v2.pht009898.v1.p1",114,7,121,"2021/07/09","dbgap"
"2978","phs000286.v6.pht008746.v1.p2",1291,2159,3450,"2019/03/11","dbgap"
"2979","phs001836.v1.pht009219.v1.p1",1,3,4,"2019/06/24","dbgap"
"2980","phs000664.v1.pht003542.v1.p1",17,17,34,"10/22/2013","dbgap"
"2981","phs000389.v1.pht002379.v1.p1",910,891,1801,"09/19/2011","dbgap"
"2982","phs000285.v3.pht001708.v2.p2",885,974,1859,"08/20/2013","dbgap"
"2984","phs000370.v2.pht002381.v1.p1",69,23,92,"04/14/2014","dbgap"
"2985","phs000928.v1.pht004938.v1.p1",3,8,11,"01/13/2016","dbgap"
"2987","phs000086.v3.pht000213.v1.p1",748,668,1416,"11/04/2014","dbgap"
"2988","phs000406.v1.pht002403.v1.p1",31,26,57,"10/25/2011","dbgap"
"2991","phs000774.v2.pht004701.v1.p1",5609,6221,11830,"2017/12/29","dbgap"
"2992","phs000285.v3.pht001595.v2.p2",61,132,193,"08/20/2013","dbgap"
"2993","phs000280.v7.pht004143.v2.p1",6782,8155,14937,"2020/06/18","dbgap"
"2995","phs001215.v4.pht008628.v2.p2",2536,2442,4978,"2021/06/08","dbgap"
"2996","phs002055.v1.pht010343.v1.p1",177,99,276,"2020/07/10","dbgap"
"2997","phs000285.v3.pht001855.v2.p2",880,993,1873,"08/20/2013","dbgap"
"2998","phs001573.v1.pht010176.v1.p1",29,10,39,"2020/04/29","dbgap"
"2999","phs001919.v1.pht009592.v1.p1",28,11,39,"2020/03/11","dbgap"
"3001","phs000767.v1.pht003932.v1.p1",37,12,49,"07/03/2014","dbgap"
"3002","phs002244.v1.pht010551.v1.p1",23,10,33,"2020/10/02","dbgap"
"3004","phs000285.v3.pht001593.v2.p2",947,1065,2012,"08/20/2013","dbgap"
"3005","phs000277.v2.pht002797.v2.p1",3616,2870,6486,"2020/04/02","dbgap"
"3006","phs001200.v1.pht005926.v1.p1",4,3,7,"11/16/2016","dbgap"
"3007","phs002428.v1.pht011269.v1.p1",72,137,209,"2021/06/02","dbgap"
"3008","phs000219.v1.pht001061.v1.p1",358,494,852,"01/19/2010","dbgap"
"3009","phs000218.v24.pht000917.v23.p8",3107,2530,5637,"2021/10/06","dbgap"
"3010","phs000019.v1.pht000063.v1.p1",672,723,1395,"Thu Jan 17 21:45:34 2008","dbgap"
"3012","phs000335.v3.pht002114.v1.p2",18,15,33,"07/25/2014","dbgap"
"3013","phs001481.v1.pht008131.v1.p1",238,218,456,"2018/06/07","dbgap"
"3014","phs000592.v1.pht006597.v1.p1",178,144,322,"07/12/2017","dbgap"
"3016","phs002002.v1.pht010192.v1.p1",6,2,8,"2020/04/27","dbgap"
"3017","phs000007.v32.pht000198.v8.p13",1639,1845,3484,"2020/12/21","dbgap"
"3018","phs002059.v1.pht010425.v1.p1",925,887,1812,"2020/12/18","dbgap"
"3019","phs001630.v1.pht008173.v1.p1",1956,720,2676,"2020/06/26","dbgap"
"3020","phs000354.v1.pht003350.v1.p1",1,11,12,"06/25/2013","dbgap"
"3021","phs000921.v4.pht004883.v3.p1",981,1123,2104,"2019/11/20","dbgap"
"3022","phs000288.v2.pht002517.v2.p2",423,364,787,"2017/11/06","dbgap"
"3023","phs000139.v1.pht000643.v1.p1",1247,1755,3002,"Thu Nov 20 13:23:14 2008","dbgap"
"3024","phs002088.v2.pht010649.v1.p1",22,18,40,"2021/06/16","dbgap"
"3025","phs002238.v1.pht011522.v1.p1",121,81,202,"2021/10/04","dbgap"
"3026","phs000274.v1.pht001277.v1.p1",737,1536,2273,"11/28/2011","dbgap"
"3027","phs000094.v1.pht001138.v1.p1",3743,3418,7161,"04/12/2010","dbgap"
"3029","phs000682.v1.pht003594.v1.p1",457,402,859,"11/25/2013","dbgap"
"3030","phs000594.v1.pht006495.v1.p1",5,3,8,"06/12/2017","dbgap"
"3031","phs000966.v2.pht005304.v2.p2",766,884,1650,"2021/08/27","dbgap"
"3032","phs001367.v1.pht008247.v1.p1",4737,5237,9974,"2018/07/25","dbgap"
"3033","phs000750.v1.pht003934.v1.p1",127,144,271,"09/03/2014","dbgap"
"3035","phs000128.v3.pht000470.v2.p3",2943,3500,6443,"04/29/2016","dbgap"
"3036","phs001618.v1.pht008226.v1.p1",25,24,49,"2018/07/18","dbgap"
"3037","phs000219.v1.pht001086.v1.p1",127,184,311,"01/19/2010","dbgap"
"3038","phs000815.v2.pht006790.v2.p1",130,174,304,"2020/02/03","dbgap"
"3039","phs000007.v32.pht000309.v15.p13",4113,4211,8324,"2020/12/21","dbgap"
"3041","phs001135.v2.pht005983.v1.p1",690,296,986,"2020/03/09","dbgap"
"3043","phs000787.v1.pht004258.v1.p1",6,3,9,"09/23/2014","dbgap"
"3044","phs000459.v1.pht002545.v1.p1",65,52,117,"01/07/2016","dbgap"
"3045","phs001260.v1.pht006052.v1.p1",24,19,43,"01/05/2017","dbgap"
"3047","phs000285.v3.pht001865.v2.p2",880,993,1873,"08/20/2013","dbgap"
"3049","phs001769.v1.pht008625.v1.p1",4,2,6,"2019/01/17","dbgap"
"3050","phs001818.v3.pht009022.v3.p1",8,8,16,"2021/03/11","dbgap"
"3051","phs001828.v1.pht009369.v1.p1",799,593,1392,"2019/08/01","dbgap"
"3052","phs001538.v1.pht008096.v1.p1",7,10,17,"2018/06/01","dbgap"
"3053","phs000477.v1.pht002688.v1.p1",12,9,21,"04/16/2012","dbgap"
"3054","phs000007.v32.pht002894.v1.p13",171,217,388,"2020/12/21","dbgap"
"3056","phs000430.v1.pht003052.v1.p1",696,270,966,"06/20/2013","dbgap"
"3057","phs001544.v2.pht009897.v1.p1",114,7,121,"2021/07/09","dbgap"
"3058","phs001484.v1.pht007737.v1.p1",234,87,321,"2018/05/15","dbgap"
"3059","phs000287.v7.pht001466.v2.p1",2375,3156,5531,"2020/01/23","dbgap"
"3060","phs000349.v1.pht002190.v1.p1",848,220,1068,"05/02/2011","dbgap"
"3061","phs000337.v1.pht005335.v1.p1",56,38,94,"03/15/2016","dbgap"
"3063","phs001782.v2.pht008800.v2.p1",50,62,112,"2021/07/02","dbgap"
"3065","phs000007.v32.pht005163.v3.p13",1417,1543,2960,"2020/12/21","dbgap"
"3066","phs001328.v1.pht006303.v1.p1",54,37,91,"05/17/2017","dbgap"
"3068","phs001012.v1.pht005549.v1.p1",549,628,1177,"06/22/2016","dbgap"
"3070","phs001138.v4.pht007937.v3.p2",1242,1104,2346,"2021/10/21","dbgap"
"3071","phs001292.v2.pht007856.v2.p1",234,538,772,"2019/06/03","dbgap"
"3073","phs000251.v2.pht001263.v2.p2",65,28,93,"11/22/2013","dbgap"
"3075","phs000280.v7.pht004151.v2.p1",22,8151,8173,"2020/06/18","dbgap"
"3078","phs001871.v1.pht009361.v1.p1",137,211,348,"2019/08/01","dbgap"
"3079","phs000287.v7.pht001480.v1.p1",2375,3156,5531,"2020/01/23","dbgap"
"3080","phs000774.v2.pht004699.v1.p1",7850,7332,15182,"2017/12/29","dbgap"
"3081","phs000007.v32.pht005170.v3.p13",203,248,451,"2020/12/21","dbgap"
"3082","phs000298.v4.pht002282.v3.p3",7742,4936,12678,"2018/06/22","dbgap"
"3083","phs000228.v4.pht002156.v1.p1",147,151,298,"03/21/2017","dbgap"
"3085","phs000203.v1.pht000881.v1.p1",2072,1265,3337,"10/12/2010","dbgap"
"3086","phs000455.v1.pht002574.v1.p1",7,3,10,"06/20/2012","dbgap"
"3087","phs001494.v1.pht007191.v1.p1",730,410,1140,"2018/03/08","dbgap"
"3088","phs000479.v1.pht002664.v1.p1",2,1,3,"08/15/2012","dbgap"
"3089","phs001202.v1.pht005776.v1.p1",7431,2665,10096,"07/10/2017","dbgap"
"3090","phs000347.v1.pht003124.v1.p1",19,10,29,"07/09/2013","dbgap"
"3091","phs000219.v1.pht001079.v1.p1",569,913,1482,"01/19/2010","dbgap"
"3092","phs000796.v1.pht005386.v1.p1",1092,2012,3104,"05/17/2016","dbgap"
"3093","phs000285.v3.pht001709.v2.p2",885,977,1862,"08/20/2013","dbgap"
"3095","phs000904.v1.pht004689.v1.p1",4,4,8,"2018/01/30","dbgap"
"3096","phs000559.v1.pht003617.v1.p1",7858,6558,14416,"12/16/2013","dbgap"
"3097","phs000007.v32.pht003906.v7.p13",2462,2893,5355,"2020/12/21","dbgap"
"3098","phs002480.v1.pht011394.v1.p1",1059,821,1880,"2021/08/11","dbgap"
"3099","phs000574.v1.pht005871.v1.p1",28,822,850,"03/06/2017","dbgap"
"3100","phs001852.v1.pht009279.v1.p1",212,187,399,"2019/07/26","dbgap"
"3101","phs000219.v1.pht001073.v1.p1",664,1054,1718,"01/19/2010","dbgap"
"3102","phs000007.v32.pht000685.v2.p13",212,183,395,"2020/12/21","dbgap"
"3103","phs000924.v4.pht006323.v2.p1",121,152,273,"2019/10/07","dbgap"
"3104","phs001925.v1.pht010568.v1.p1",2,4,6,"2020/10/27","dbgap"
"3107","phs001877.v1.pht009481.v1.p1",24,7,31,"2019/09/19","dbgap"
"3108","phs001138.v4.pht007939.v3.p2",1242,1104,2346,"2021/10/21","dbgap"
"3109","phs000577.v1.pht007272.v1.p1",173,341,514,"2017/12/20","dbgap"
"3110","phs000725.v2.pht003882.v2.p1",60,34,94,"01/30/2017","dbgap"
"3111","phs000007.v32.pht000825.v7.p13",1845,2090,3935,"2020/12/21","dbgap"
"3112","phs001745.v1.pht008599.v1.p1",597,506,1103,"2019/02/06","dbgap"
"3113","phs000444.v1.pht002703.v1.p1",484,829,1313,"04/19/2012","dbgap"
"3114","phs000224.v3.pht002181.v3.p2",998,1919,2917,"2019/10/08","dbgap"
"3115","phs001632.v1.pht008534.v1.p1",648,760,1408,"2018/11/05","dbgap"
"3117","phs001058.v1.pht005237.v1.p1",306,197,503,"01/25/2016","dbgap"
"3118","phs000170.v2.pht000737.v1.p1",1634,2330,3964,"02/27/2015","dbgap"
"3119","phs001325.v3.pht006353.v2.p1",121,152,273,"2019/11/22","dbgap"
"3121","phs000788.v2.pht004626.v2.p3",33200,47634,80834,"2018/02/01","dbgap"
"3122","phs000362.v1.pht003227.v1.p1",13,2,15,"08/26/2013","dbgap"
"3123","phs000763.v1.pht004256.v1.p1",987,1071,2058,"01/16/2015","dbgap"
"3124","phs000285.v3.pht001819.v2.p2",878,990,1868,"08/20/2013","dbgap"
"3127","phs001437.v1.pht006807.v1.p1",157,83,240,"2019/09/11","dbgap"
"3128","phs001231.v2.pht006182.v2.p1",12,8,20,"2018/04/20","dbgap"
"3129","phs001511.v1.pht007294.v1.p1",212,338,550,"2019/10/17","dbgap"
"3130","phs001241.v1.pht005922.v1.p1",7,8,15,"2017/11/14","dbgap"
"3131","phs001281.v2.pht006135.v2.p1",15,25,40,"2019/02/21","dbgap"
"3133","phs000007.v32.pht000821.v7.p13",2024,2319,4343,"2020/12/21","dbgap"
"3134","phs001770.v1.pht008684.v1.p1",35,44,79,"2019/02/01","dbgap"
"3135","phs000888.v1.pht004678.v1.p1",25246,29783,55029,"08/12/2016","dbgap"
"3136","phs000288.v2.pht002520.v2.p2",1381,1188,2569,"2017/11/06","dbgap"
"3137","phs001855.v1.pht009247.v1.p1",382,501,883,"2019/07/29","dbgap"
"3138","phs000251.v2.pht001261.v2.p2",65,28,93,"11/22/2013","dbgap"
"3139","phs001284.v1.pht009031.v1.p1",125,92,217,"2019/05/09","dbgap"
"3140","phs001064.v1.pht006833.v1.p1",3,3,6,"2018/02/27","dbgap"
"3142","phs000286.v6.pht008754.v1.p2",1295,2163,3458,"2019/03/11","dbgap"
"3143","phs000280.v7.pht009475.v1.p1",2391,3565,5956,"2020/06/18","dbgap"
"3144","phs000171.v1.pht000769.v1.p1",636,1276,1912,"12/11/2009","dbgap"
"3145","phs002389.v1.pht011091.v1.p1",39,23,62,"2021/04/06","dbgap"
"3147","phs001297.v1.pht006200.v1.p1",47,50,97,"06/14/2017","dbgap"
"3148","phs001326.v1.pht007824.v1.p1",21,3,24,"2018/04/16","dbgap"
"3150","phs000280.v7.pht006451.v1.p1",718,1006,1724,"2020/06/18","dbgap"
"3152","phs001224.v1.pht005939.v1.p1",9,8,17,"11/18/2016","dbgap"
"3153","phs001940.v2.pht009696.v1.p1",19,17,36,"2020/01/31","dbgap"
"3154","phs002030.v1.pht010263.v1.p1",407,231,638,"2020/06/02","dbgap"
"3155","phs000280.v7.pht004063.v2.p1",6784,8156,14940,"2020/06/18","dbgap"
"3156","phs000988.v5.pht005246.v4.p1",2293,2076,4369,"2021/09/28","dbgap"
"3157","phs002310.v1.pht011206.v1.p1",1328,559,1887,"2021/05/05","dbgap"
"3158","phs001820.v1.pht010241.v1.p1",74,44,118,"2020/05/26","dbgap"
"3159","phs000280.v7.pht006415.v1.p1",2140,2772,4912,"2020/06/18","dbgap"
"3160","phs000777.v1.pht003975.v1.p1",4,6,10,"08/20/2014","dbgap"
"3161","phs000007.v32.pht002428.v1.p13",786,979,1765,"2020/12/21","dbgap"
"3162","phs000280.v7.pht004140.v2.p1",198,205,403,"2020/06/18","dbgap"
"3163","phs000285.v3.pht001722.v2.p2",886,978,1864,"08/20/2013","dbgap"
"3164","phs002204.v1.pht010910.v1.p1",2,2,4,"2021/02/02","dbgap"
"3165","phs000824.v1.pht005139.v1.p1",37,63,100,"11/24/2015","dbgap"
"3166","phs000018.v2.pht004355.v1.p1",1435,1611,3046,"12/16/2014","dbgap"
"3167","phs000385.v1.pht002342.v1.p1",53,47,100,"11/28/2011","dbgap"
"3168","phs000983.v1.pht005005.v1.p1",93,419,512,"10/05/2015","dbgap"
"3169","phs000285.v3.pht001662.v2.p2",104,227,331,"08/20/2013","dbgap"
"3170","phs000486.v1.pht002802.v1.p1",3314,4943,8257,"12/17/2014","dbgap"
"3171","phs001195.v1.pht006861.v1.p1",10,3,13,"2018/03/27","dbgap"
"3172","phs000697.v1.pht007692.v1.p1",12,3,15,"2018/03/26","dbgap"
"3173","phs001252.v1.pht006390.v1.p1",470,287,757,"05/16/2017","dbgap"
"3174","phs000086.v3.pht000234.v1.p1",761,680,1441,"11/04/2014","dbgap"
"3175","phs000512.v1.pht002863.v1.p1",59,38,97,"10/15/2012","dbgap"
"3177","phs000809.v1.pht004346.v1.p1",6,2,8,"11/07/2014","dbgap"
"3178","phs000727.v1.pht003863.v1.p1",116,95,211,"10/27/2014","dbgap"
"3179","phs001605.v2.pht010081.v1.p1",109,183,292,"2021/07/22","dbgap"
"3180","phs000128.v3.pht000580.v2.p3",2943,3500,6443,"04/29/2016","dbgap"
"3181","phs001776.v1.pht009211.v1.p1",51,40,91,"2019/06/19","dbgap"
"3182","phs001931.v1.pht009676.v1.p1",10,26,36,"2020/02/03","dbgap"
"3184","phs001167.v1.pht005636.v1.p1",839,1206,2045,"07/08/2016","dbgap"
"3185","phs000007.v32.pht000015.v3.p13",1274,1737,3011,"2020/12/21","dbgap"
"3187","phs001644.v2.pht009946.v2.p2",5031,7019,12050,"2021/08/08","dbgap"
"3188","phs000285.v3.pht001604.v2.p2",3,16,19,"08/20/2013","dbgap"
"3189","phs000007.v32.pht000094.v3.p13",1443,1315,2758,"2020/12/21","dbgap"
"3190","phs001052.v2.pht005468.v2.p1",57,26,83,"2020/11/24","dbgap"
"3193","phs001224.v1.pht005942.v1.p1",9,8,17,"11/18/2016","dbgap"
"3194","phs002048.v2.pht010317.v2.p1",4,54,58,"2021/03/17","dbgap"
"3196","phs000869.v1.pht004607.v1.p1",5551,1380,6931,"03/19/2015","dbgap"
"3198","phs000726.v1.pht003778.v1.p1",546,426,972,"10/27/2014","dbgap"
"3199","phs000737.v1.pht004443.v1.p1",989,1100,2089,"01/29/2015","dbgap"
"3200","phs001364.v1.pht007464.v1.p1",1001,1078,2079,"2018/02/27","dbgap"
"3201","phs001522.v1.pht007731.v1.p1",1261,1261,2522,"2018/04/05","dbgap"
"3202","phs000285.v3.pht001630.v2.p2",909,1032,1941,"08/20/2013","dbgap"
"3203","phs000855.v1.pht004553.v1.p1",8,7,15,"03/10/2015","dbgap"
"3204","phs002185.v1.pht010966.v1.p1",3715,2201,5916,"2021/08/24","dbgap"
"3205","phs000869.v1.pht004608.v1.p1",6,4,10,"03/19/2015","dbgap"
"3206","phs000794.v1.pht004309.v1.p1",7,5,12,"12/18/2014","dbgap"
"3207","phs001330.v2.pht007535.v2.p1",25,15,40,"2019/11/08","dbgap"
"3208","phs002393.v1.pht011136.v1.p1",68,70,138,"2021/04/28","dbgap"
"3209","phs001457.v1.pht007054.v1.p1",14,38,52,"2018/04/12","dbgap"
"3210","phs000552.v2.pht003027.v1.p1",12,53,65,"04/08/2014","dbgap"
"3211","phs001311.v1.pht007922.v1.p1",35,26,61,"2018/05/15","dbgap"
"3212","phs000486.v1.pht002803.v1.p1",3314,4943,8257,"12/17/2014","dbgap"
"3213","phs000460.v1.pht002549.v1.p1",553,1129,1682,"11/22/2013","dbgap"
"3214","phs000280.v7.pht009473.v1.p1",2771,4089,6860,"2020/06/18","dbgap"
"3216","phs001697.v1.pht010578.v1.p1",57,175,232,"2021/01/12","dbgap"
"3217","phs000007.v32.pht009752.v1.p13",223,277,500,"2020/12/21","dbgap"
"3218","phs000007.v32.pht000161.v8.p13",1518,1746,3264,"2020/12/21","dbgap"
"3219","phs002323.v1.pht010883.v1.p1",37,34,71,"2021/05/24","dbgap"
"3220","phs000140.v1.pht000655.v1.p1",840,1208,2048,"11/24/2010","dbgap"
"3221","phs002317.v1.pht011163.v1.p1",232,183,415,"2021/05/04","dbgap"
"3222","phs002328.v1.pht010856.v1.p1",178,90,268,"2021/03/05","dbgap"
"3223","phs000572.v8.pht003391.v5.p4",2311,2424,4735,"2019/11/19","dbgap"
"3224","phs000007.v32.pht000610.v3.p13",285,513,798,"2020/12/21","dbgap"
"3225","phs002327.v1.pht010918.v1.p1",11,13,24,"2021/02/02","dbgap"
"3226","phs000007.v32.pht000905.v4.p13",647,722,1369,"2020/12/21","dbgap"
"3227","phs001860.v1.pht009450.v1.p1",86,120,206,"2020/05/15","dbgap"
"3228","phs001001.v1.pht007525.v1.p1",4,4,8,"2018/02/28","dbgap"
"3229","phs000711.v7.pht003721.v7.p2",1828,1747,3575,"2021/03/24","dbgap"
"3230","phs000280.v7.pht004204.v2.p1",4883,6019,10902,"2020/06/18","dbgap"
"3231","phs000171.v1.pht000778.v1.p1",330,670,1000,"12/11/2009","dbgap"
"3232","phs000280.v7.pht006428.v1.p1",2370,3157,5527,"2020/06/18","dbgap"
"3233","phs001407.v1.pht006831.v1.p1",1,10,11,"2017/08/25","dbgap"
"3234","phs001578.v1.pht007877.v1.p1",40,42,82,"2018/11/30","dbgap"
"3235","phs000707.v2.pht003715.v2.p1",10,8,18,"03/29/2017","dbgap"
"3236","phs000957.v1.pht004855.v1.p1",3625,5582,9207,"07/31/2015","dbgap"
"3237","phs000701.v1.pht005512.v1.p1",48,43,91,"06/01/2017","dbgap"
"3239","phs001330.v2.pht007532.v2.p1",25,15,40,"2019/11/08","dbgap"
"3240","phs002230.v1.pht010961.v1.p1",515,814,1329,"2021/02/23","dbgap"
"3241","phs001675.v1.pht010218.v1.p1",190,195,385,"2021/02/10","dbgap"
"3242","phs001273.v3.pht006173.v2.p2",23125,13760,36885,"2019/10/10","dbgap"
"3243","phs000370.v2.pht002384.v1.p1",69,23,92,"04/14/2014","dbgap"
"3244","phs001000.v1.pht005028.v1.p1",1973,349,2322,"03/16/2016","dbgap"
"3245","phs001691.v1.pht008538.v1.p1",1,1,2,"2018/11/07","dbgap"
"3246","phs000262.v3.pht006262.v1.p2",31,11,42,"2017/09/05","dbgap"
"3247","phs000007.v32.pht003097.v6.p13",3700,4435,8135,"2020/12/21","dbgap"
"3248","phs001017.v1.pht005076.v1.p1",79,1680,1759,"2021/07/02","dbgap"
"3249","phs000018.v2.pht000062.v1.p1",841,984,1825,"12/16/2014","dbgap"
"3250","phs001580.v1.pht008290.v1.p1",15,26,41,"2018/08/06","dbgap"
"3251","phs001345.v3.pht008603.v1.p1",382,882,1264,"2021/06/09","dbgap"
"3252","phs000280.v7.pht004057.v2.p1",4883,6019,10902,"2020/06/18","dbgap"
"3254","phs001289.v1.pht007791.v1.p1",16,13,29,"2018/04/16","dbgap"
"3255","phs001502.v1.pht007258.v1.p1",674,698,1372,"2018/09/07","dbgap"
"3256","phs001538.v1.pht008091.v1.p1",178,229,407,"2018/06/01","dbgap"
"3257","phs001289.v1.pht007794.v1.p1",16,13,29,"2018/04/16","dbgap"
"3258","phs000285.v3.pht001788.v2.p2",863,965,1828,"08/20/2013","dbgap"
"3259","phs002298.v1.pht010759.v1.p1",359,36,395,"2020/12/09","dbgap"
"3260","phs001157.v1.pht005806.v1.p1",4331,4696,9027,"04/17/2017","dbgap"
"3262","phs000128.v3.pht000460.v2.p3",2943,3500,6443,"04/29/2016","dbgap"
"3263","phs000564.v2.pht003057.v2.p1",139,137,276,"07/09/2015","dbgap"
"3264","phs000280.v7.pht004096.v2.p1",475,608,1083,"2020/06/18","dbgap"
"3265","phs001238.v2.pht006029.v2.p1",2731,3446,6177,"2018/06/14","dbgap"
"3266","phs000007.v32.pht000203.v8.p13",1585,1780,3365,"2020/12/21","dbgap"
"3267","phs000631.v1.pht003601.v1.p1",1746,1286,3032,"12/03/2013","dbgap"
"3268","phs000128.v3.pht000589.v2.p3",2943,3500,6443,"04/29/2016","dbgap"
"3269","phs001556.v1.pht007844.v1.p1",67,33,100,"2018/04/20","dbgap"
"3270","phs000017.v3.pht000368.v1.p1",131,284,415,"Wed Nov 26 07:49:48 2008","dbgap"
"3271","phs001585.v1.pht008827.v1.p1",257,181,438,"2019/03/18","dbgap"
"3273","phs000821.v1.pht004339.v1.p1",641,725,1366,"11/07/2014","dbgap"
"3274","phs001313.v1.pht007972.v1.p1",1,4,5,"2018/05/17","dbgap"
"3276","phs001765.v1.pht008663.v1.p1",26,13,39,"2019/01/29","dbgap"
"3277","phs000553.v1.pht003134.v1.p1",1,4,5,"06/26/2013","dbgap"
"3278","phs001770.v1.pht008686.v1.p1",196,160,356,"2019/02/01","dbgap"
"3279","phs001224.v1.pht005938.v1.p1",9,8,17,"11/18/2016","dbgap"
"3280","phs000374.v1.pht002358.v1.p1",4,3,7,"08/31/2011","dbgap"
"3281","phs000867.v1.pht004482.v1.p1",1016,834,1850,"02/13/2015","dbgap"
"3282","phs000491.v1.pht002698.v1.p1",2,1,3,"04/24/2012","dbgap"
"3283","phs001246.v1.pht006085.v1.p1",12,14,26,"01/23/2017","dbgap"
"3284","phs001488.v1.pht007404.v1.p1",258,291,549,"2018/02/08","dbgap"
"3285","phs001089.v4.pht005487.v4.p1",726,670,1396,"2021/09/23","dbgap"
"3286","phs002614.v1.pht011590.v1.p1",5,7,12,"2021/09/30","dbgap"
"3287","phs001385.v1.pht007163.v1.p1",24,165,189,"2017/12/04","dbgap"
"3288","phs000280.v7.pht004229.v2.p1",4157,5062,9219,"2020/06/18","dbgap"
"3289","phs001521.v1.pht007723.v1.p1",16,11,27,"2018/06/13","dbgap"
"3290","phs000007.v32.pht000299.v12.p13",5147,6051,11198,"2020/12/21","dbgap"
"3292","phs001740.v1.pht008623.v1.p1",353,226,579,"2019/08/01","dbgap"
"3294","phs000586.v1.pht004832.v1.p1",285,768,1053,"08/18/2015","dbgap"
"3295","phs001209.v1.pht006805.v1.p1",4,9,13,"2017/08/22","dbgap"
"3296","phs001331.v2.pht006928.v2.p1",442,288,730,"2019/08/30","dbgap"
"3297","phs001380.v1.pht009232.v1.p1",1540,566,2106,"2019/10/11","dbgap"
"3298","phs002088.v2.pht010650.v1.p1",22,18,40,"2021/06/16","dbgap"
"3299","phs000590.v1.pht008276.v1.p1",26,28,54,"2018/08/03","dbgap"
"3300","phs001020.v2.pht005783.v2.p1",784,467,1251,"2019/10/18","dbgap"
"3301","phs001641.v1.pht010028.v1.p1",741,1643,2384,"2020/03/24","dbgap"
"3302","phs000815.v2.pht006792.v1.p1",130,174,304,"2020/02/03","dbgap"
"3303","phs001662.v2.pht010066.v1.p1",843,758,1601,"2021/08/19","dbgap"
"3304","phs001157.v1.pht005804.v1.p1",4380,4738,9118,"04/17/2017","dbgap"
"3305","phs000698.v1.pht007672.v1.p1",17,32,49,"2018/03/23","dbgap"
"3306","phs000209.v13.pht001203.v2.p3",3060,3369,6429,"11/05/2014","dbgap"
"3307","phs001289.v1.pht007784.v1.p1",1,1,2,"2018/04/16","dbgap"
"3308","phs000128.v3.pht000483.v2.p3",2943,3500,6443,"04/29/2016","dbgap"
"3310","phs000209.v13.pht003379.v1.p3",1005,1141,2146,"11/05/2014","dbgap"
"3311","phs001511.v1.pht007292.v1.p1",212,338,550,"2019/10/17","dbgap"
"3312","phs000128.v3.pht000592.v2.p3",2943,3500,6443,"04/29/2016","dbgap"
"3313","phs002015.v1.pht010361.v1.p1",1816,2387,4203,"2020/09/18","dbgap"
"3314","phs001513.v1.pht007359.v1.p1",71,38,109,"2018/01/18","dbgap"
"3315","phs000093.v2.pht000698.v2.p2",77,54,131,"10/09/2009","dbgap"
"3316","phs000128.v3.pht000575.v2.p3",2943,3500,6443,"04/29/2016","dbgap"
"3317","phs001694.v1.pht008493.v1.p1",6,2,8,"2018/10/24","dbgap"
"3318","phs000285.v3.pht001643.v2.p2",118,121,239,"08/20/2013","dbgap"
"3319","phs002508.v1.pht011502.v1.p1",1,5,6,"2021/08/20","dbgap"
"3320","phs000588.v1.pht009302.v1.p1",42,151,193,"2019/07/26","dbgap"
"3321","phs002238.v1.pht011520.v1.p1",121,81,202,"2021/10/04","dbgap"
"3322","phs001358.v1.pht006335.v1.p1",1092,1230,2322,"05/02/2017","dbgap"
"3324","phs000808.v1.pht004467.v1.p1",111,123,234,"02/05/2015","dbgap"
"3325","phs000007.v32.pht006015.v4.p13",3490,4123,7613,"2020/12/21","dbgap"
"3326","phs001489.v2.pht008584.v2.p2",6057,6807,12864,"2021/03/18","dbgap"
"3327","phs001021.v1.pht005264.v1.p1",136,274,410,"02/01/2016","dbgap"
"3328","phs000438.v1.pht003320.v1.p1",341,380,721,"04/18/2014","dbgap"
"3329","phs001109.v3.pht005447.v2.p2",1121,674,1795,"2020/02/28","dbgap"
"3332","phs001247.v1.pht008300.v1.p1",451,448,899,"2018/08/13","dbgap"
"3333","phs000159.v9.pht000819.v9.p5",49,48,97,"2019/12/06","dbgap"
"3334","phs000579.v1.pht003280.v1.p1",25,25,50,"11/04/2013","dbgap"
"3335","phs002039.v1.pht010271.v1.p1",5,13,18,"2020/06/10","dbgap"
"3336","phs001446.v2.pht009626.v1.p1",725,1155,1880,"2021/06/24","dbgap"
"3338","phs000209.v13.pht001119.v8.p3",3060,3369,6429,"11/05/2014","dbgap"
"3339","phs001466.v2.pht009580.v1.p1",425,409,834,"2021/06/25","dbgap"
"3340","phs000128.v3.pht000362.v1.p3",115,258,373,"04/29/2016","dbgap"
"3342","phs000286.v6.pht001924.v2.p2",256,532,788,"2019/03/11","dbgap"
"3343","phs000558.v1.pht006230.v1.p1",91,84,175,"03/31/2017","dbgap"
"3344","phs001238.v2.pht006042.v1.p1",573,1281,1854,"2018/06/14","dbgap"
"3345","phs001332.v2.pht007453.v2.p1",156,187,343,"2019/11/08","dbgap"
"3346","phs000417.v2.pht002397.v2.p1",177,93,270,"02/02/2012","dbgap"
"3348","phs001065.v1.pht005428.v1.p1",296,313,609,"05/24/2016","dbgap"
"3349","phs000810.v1.pht004715.v1.p1",5161,7359,12520,"12/02/2015","dbgap"
"3351","phs000331.v1.pht002093.v1.p1",424,405,829,"03/27/2012","dbgap"
"3352","phs000128.v3.pht000541.v2.p3",2943,3500,6443,"04/29/2016","dbgap"
"3353","phs000883.v1.pht004597.v1.p1",1331,723,2054,"01/15/2016","dbgap"
"3354","phs002056.v1.pht010451.v1.p1",6353,40,6393,"2021/08/11","dbgap"
"3355","phs001073.v2.pht005954.v2.p1",18,47,65,"2020/12/18","dbgap"
"3356","phs001065.v1.pht005433.v1.p1",296,313,609,"05/24/2016","dbgap"
"3358","phs000280.v7.pht009476.v1.p1",2205,3287,5492,"2020/06/18","dbgap"
"3359","phs000280.v7.pht004149.v2.p1",5435,6635,12070,"2020/06/18","dbgap"
"3360","phs001057.v1.pht005301.v1.p1",894,99,993,"02/18/2016","dbgap"
"3361","phs001488.v1.pht007387.v1.p1",260,292,552,"2018/02/08","dbgap"
"3362","phs002228.v1.pht010857.v1.p1",38,32,70,"2021/04/23","dbgap"
"3363","phs000660.v1.pht003510.v1.p1",5,7,12,"06/04/2014","dbgap"
"3364","phs001728.v2.pht010122.v1.p1",34,16,50,"2021/08/25","dbgap"
"3365","phs001918.v2.pht010049.v1.p1",5164,3924,9088,"2021/10/07","dbgap"
"3366","phs001875.v1.pht009650.v1.p1",3,3,6,"2019/12/06","dbgap"
"3367","phs000592.v1.pht006582.v1.p1",89,72,161,"07/12/2017","dbgap"
"3368","phs001097.v1.pht005616.v1.p1",1072,1154,2226,"08/09/2016","dbgap"
"3369","phs000574.v1.pht005873.v1.p1",41,972,1013,"03/06/2017","dbgap"
"3371","phs001252.v1.pht006379.v1.p1",1691,1055,2746,"05/16/2017","dbgap"
"3372","phs001065.v1.pht005427.v1.p1",296,313,609,"05/24/2016","dbgap"
"3373","phs001808.v1.pht008974.v1.p1",4,10,14,"2019/04/19","dbgap"
"3374","phs002037.v1.pht010266.v1.p1",126,112,238,"2020/06/10","dbgap"
"3375","phs001433.v1.pht006810.v1.p1",12,9,21,"2017/08/24","dbgap"
"3376","phs000128.v3.pht000401.v2.p3",2943,3500,6443,"04/29/2016","dbgap"
"3378","phs000757.v1.pht003920.v1.p1",69,58,127,"06/30/2014","dbgap"
"3379","phs000280.v7.pht006467.v1.p1",94,100,194,"2020/06/18","dbgap"
"3380","phs001295.v2.pht006237.v2.p1",100,182,282,"2019/04/19","dbgap"
"3381","phs000285.v3.pht001636.v2.p2",909,1029,1938,"08/20/2013","dbgap"
"3382","phs000285.v3.pht001579.v2.p2",947,1065,2012,"08/20/2013","dbgap"
"3383","phs000476.v1.pht002669.v1.p1",10,10,20,"04/16/2012","dbgap"
"3384","phs001942.v1.pht010588.v1.p1",13,3,16,"2020/10/21","dbgap"
"3385","phs002040.v1.pht010258.v1.p1",2,1,3,"2020/06/02","dbgap"
"3386","phs000952.v1.pht005319.v1.p1",1540,1332,2872,"03/10/2016","dbgap"
"3387","phs001783.v2.pht008822.v2.p1",372,465,837,"2021/08/06","dbgap"
"3388","phs000304.v3.pht001904.v1.p1",945,1245,2190,"2018/05/03","dbgap"
"3389","phs000397.v3.pht002408.v3.p3",5293,5416,10709,"2020/08/17","dbgap"
"3391","phs001091.v1.pht006065.v1.p1",3,2,5,"05/12/2017","dbgap"
"3392","phs000906.v1.pht007146.v1.p1",3901,3842,7743,"2017/12/04","dbgap"
"3393","phs001603.v2.pht009968.v1.p1",55,105,160,"2021/07/16","dbgap"
"3394","phs000086.v3.pht000348.v1.p1",11,28,39,"11/04/2014","dbgap"
"3395","phs001296.v2.pht006354.v2.p1",11,30,41,"2019/05/31","dbgap"
"3398","phs001484.v1.pht007738.v1.p1",234,87,321,"2018/05/15","dbgap"
"3400","phs000837.v1.pht004440.v1.p1",3,3,6,"01/26/2015","dbgap"
"3402","phs002040.v1.pht010259.v1.p1",2,1,3,"2020/06/02","dbgap"
"3403","phs001349.v2.pht010328.v1.p1",10093,515,10608,"2021/04/07","dbgap"
"3404","phs001087.v3.pht005759.v3.p1",74,30,104,"2020/09/18","dbgap"
"3405","phs001617.v1.pht010617.v1.p1",105,89,194,"2021/01/12","dbgap"
"3406","phs001703.v3.pht008453.v2.p1",54,37,91,"2019/11/27","dbgap"
"3407","phs001726.v2.pht011573.v1.p1",1401,1241,2642,"2021/09/24","dbgap"
"3408","phs002304.v1.pht010849.v1.p1",377,244,621,"2021/04/07","dbgap"
"3409","phs002557.v1.pht011479.v1.p1",3,1,4,"2021/08/20","dbgap"
"3410","phs000280.v7.pht006471.v1.p1",1040,1250,2290,"2020/06/18","dbgap"
"3411","phs000656.v1.pht003481.v1.p1",15,13,28,"08/26/2013","dbgap"
"3412","phs000188.v1.pht000979.v1.p1",717,1197,1914,"10/05/2010","dbgap"
"3413","phs001619.v3.pht008175.v3.p1",282,268,550,"2021/03/10","dbgap"
"3414","phs000280.v7.pht004060.v5.p1",1017,1051,2068,"2020/06/18","dbgap"
"3415","phs000577.v1.pht007287.v1.p1",173,340,513,"2017/12/20","dbgap"
"3416","phs000280.v7.pht004036.v2.p1",6623,7972,14595,"2020/06/18","dbgap"
"3417","phs000007.v32.pht000083.v8.p13",1549,1743,3292,"2020/12/21","dbgap"
"3418","phs001912.v1.pht009625.v1.p1",72,8,80,"2020/10/14","dbgap"
"3419","phs001090.v1.pht009052.v1.p1",2307,2517,4824,"2019/05/21","dbgap"
"3420","phs000285.v3.pht001718.v2.p2",885,980,1865,"08/20/2013","dbgap"
"3421","phs000577.v1.pht007286.v1.p1",29,50,79,"2017/12/20","dbgap"
"3423","phs001342.v1.pht008048.v1.p1",30,16,46,"2018/06/01","dbgap"
"3424","phs001897.v1.pht009540.v1.p1",20,18,38,"2019/12/03","dbgap"
"3425","phs001781.v1.pht008862.v1.p1",72,36,108,"2019/03/25","dbgap"
"3426","phs000224.v3.pht002182.v3.p2",967,1890,2857,"2019/10/08","dbgap"
"3427","phs001754.v4.pht009108.v2.p2",3664,6253,9917,"2021/02/26","dbgap"
"3428","phs001732.v2.pht010142.v1.p1",43,46,89,"2021/08/26","dbgap"
"3429","phs000086.v3.pht000625.v1.p1",712,653,1365,"11/04/2014","dbgap"
"3430","phs000086.v3.pht000339.v1.p1",719,657,1376,"11/04/2014","dbgap"
"3431","phs000128.v3.pht000486.v2.p3",2943,3500,6443,"04/29/2016","dbgap"
"3432","phs001972.v1.pht009841.v1.p1",1313,1480,2793,"2020/06/30","dbgap"
"3433","phs001485.v2.pht007185.v1.p1",11,13,24,"2021/03/10","dbgap"
"3434","phs000671.v1.pht003548.v1.p1",9,1,10,"10/25/2013","dbgap"
"3435","phs000128.v3.pht000599.v2.p3",2943,3500,6443,"04/29/2016","dbgap"
"3436","phs001606.v2.pht010088.v1.p1",134,190,324,"2021/07/19","dbgap"
"3437","phs001867.v1.pht009352.v1.p1",6,7,13,"2019/08/05","dbgap"
"3438","phs001592.v1.pht007979.v1.p1",51,7,58,"2018/05/16","dbgap"
"3440","phs000428.v2.pht002612.v2.p2",6516,9185,15701,"01/27/2017","dbgap"
"3441","phs000722.v2.pht003897.v2.p2",266,410,676,"05/01/2017","dbgap"
"3442","phs000376.v1.pht002310.v1.p1",23,21,44,"10/16/2014","dbgap"
"3443","phs002255.v1.pht010674.v1.p1",209,180,389,"2020/11/20","dbgap"
"3444","phs001370.v1.pht006645.v1.p1",28,21,49,"07/06/2017","dbgap"
"3445","phs000007.v32.pht010755.v1.p13",1606,1882,3488,"2020/12/21","dbgap"
"3446","phs001427.v2.pht007484.v1.p1",13,4,17,"2021/01/26","dbgap"
"3447","phs000607.v3.pht003442.v2.p2",4836,5159,9995,"2018/05/01","dbgap"
"3448","phs000287.v7.pht001459.v1.p1",2375,3156,5531,"2020/01/23","dbgap"
"3449","phs001559.v1.pht007663.v1.p1",161,29,190,"2018/03/20","dbgap"
"3450","phs000376.v1.pht002306.v1.p1",40,37,77,"10/16/2014","dbgap"
"3451","phs000578.v1.pht007024.v1.p1",49,44,93,"2017/10/11","dbgap"
"3452","phs001494.v1.pht007189.v1.p1",776,446,1222,"2018/03/08","dbgap"
"3453","phs000827.v3.pht004471.v3.p1",241,351,592,"11/14/2016","dbgap"
"3454","phs000007.v32.pht000170.v8.p13",1890,2132,4022,"2020/12/21","dbgap"
"3455","phs001317.v1.pht008044.v1.p1",23,31,54,"2018/06/01","dbgap"
"3456","phs000258.v2.pht001241.v2.p1",160,244,404,"04/14/2011","dbgap"
"3459","phs000508.v2.pht002812.v1.p1",19,16,35,"04/15/2014","dbgap"
"3460","phs000254.v2.pht003002.v1.p1",217,214,431,"10/11/2012","dbgap"
"3461","phs001212.v1.pht006564.v1.p1",26,27,53,"2017/10/13","dbgap"
"3462","phs000562.v1.pht003104.v1.p1",32,13,45,"12/26/2012","dbgap"
"3463","phs001781.v1.pht008860.v1.p1",72,36,108,"2019/03/25","dbgap"
"3464","phs000020.v2.pht000070.v1.p1",1291,2449,3740,"Mon Oct 27 16:30:03 2008","dbgap"
"3465","phs000384.v1.pht002462.v1.p1",2,2,4,"06/01/2012","dbgap"
"3466","phs000219.v1.pht001068.v1.p1",664,1054,1718,"01/19/2010","dbgap"
"3467","phs001073.v2.pht005955.v2.p1",18,47,65,"2020/12/18","dbgap"
"3468","phs001594.v1.pht008147.v1.p1",15,23,38,"2018/06/18","dbgap"
"3470","phs000128.v3.pht000464.v2.p3",2943,3500,6443,"04/29/2016","dbgap"
"3471","phs000086.v3.pht000360.v1.p1",17,18,35,"11/04/2014","dbgap"
"3472","phs001415.v1.pht006686.v1.p1",15049,14491,29540,"2019/03/25","dbgap"
"3475","phs001373.v2.pht006703.v2.p2",18,15,33,"2019/10/16","dbgap"
"3476","phs000341.v2.pht002675.v2.p1",150,88,238,"11/21/2016","dbgap"
"3478","phs001130.v1.pht008416.v1.p1",290,305,595,"2018/09/26","dbgap"
"3479","phs001014.v1.pht005113.v1.p1",72,101,173,"02/25/2016","dbgap"
"3480","phs002063.v1.pht010406.v1.p1",21,13,34,"2020/07/24","dbgap"
"3481","phs000590.v1.pht008285.v1.p1",30,36,66,"2018/08/03","dbgap"
"3483","phs000286.v6.pht008756.v1.p2",1295,2163,3458,"2019/03/11","dbgap"
"3484","phs000433.v1.pht002435.v1.p1",1327,2872,4199,"04/04/2012","dbgap"
"3485","phs001260.v1.pht006051.v1.p1",24,19,43,"01/05/2017","dbgap"
"3486","phs002055.v1.pht010344.v1.p1",177,99,276,"2020/07/10","dbgap"
"3487","phs001377.v1.pht006941.v1.p1",330,50,380,"2017/09/22","dbgap"
"3488","phs001311.v1.pht007917.v1.p1",35,26,61,"2018/05/15","dbgap"
"3490","phs002368.v1.pht011045.v1.p1",1,1,2,"2021/03/11","dbgap"
"3491","phs002224.v1.pht010847.v1.p1",31,85,116,"2021/05/18","dbgap"
"3492","phs001584.v2.pht009070.v2.p2",47973,56726,104699,"2020/11/13","dbgap"
"3494","phs001990.v1.pht010018.v1.p1",87,192,279,"2020/03/19","dbgap"
"3495","phs000607.v3.pht003443.v2.p2",4477,4790,9267,"2018/05/01","dbgap"
"3496","phs001710.v1.pht011290.v1.p1",235,181,416,"2021/06/07","dbgap"
"3497","phs001025.v1.pht005086.v1.p1",292,1987,2279,"11/06/2015","dbgap"
"3498","phs000007.v32.pht005149.v4.p13",1374,1556,2930,"2020/12/21","dbgap"
"3499","phs000589.v1.pht009198.v1.p1",9,127,136,"2019/06/14","dbgap"
"3500","phs001327.v2.pht011184.v1.p1",13721,11937,25658,"2021/05/07","dbgap"
"3501","phs000333.v1.pht002315.v1.p1",1032,1590,2622,"10/06/2011","dbgap"
"3502","phs001538.v1.pht008093.v1.p1",215,300,515,"2018/06/01","dbgap"
"3503","phs002088.v2.pht010715.v1.p1",22,18,40,"2021/06/16","dbgap"
"3504","phs001312.v1.pht007201.v1.p1",2045,3143,5188,"2017/12/07","dbgap"
"3505","phs000280.v7.pht009480.v2.p1",1586,2382,3968,"2020/06/18","dbgap"
"3506","phs001309.v1.pht007914.v1.p1",51,54,105,"2018/05/15","dbgap"
"3507","phs001626.v1.pht008475.v1.p1",68,64,132,"2018/10/29","dbgap"
"3508","phs000016.v2.pht000051.v2.p2",784,121,905,"11/27/2009","dbgap"
"3509","phs001252.v1.pht006396.v1.p1",1670,1043,2713,"05/16/2017","dbgap"
"3510","phs000086.v3.pht000245.v1.p1",761,680,1441,"11/04/2014","dbgap"
"3511","phs000980.v1.pht005053.v1.p1",16,18,34,"11/16/2015","dbgap"
"3512","phs001341.v1.pht006245.v1.p1",36,54,90,"2017/11/30","dbgap"
"3513","phs000254.v2.pht002225.v2.p1",217,214,431,"10/11/2012","dbgap"
"3514","phs000128.v3.pht000508.v2.p3",2943,3500,6443,"04/29/2016","dbgap"
"3515","phs001053.v1.pht007232.v1.p1",143,213,356,"2017/12/13","dbgap"
"3516","phs000623.v1.pht003339.v1.p1",47,59,106,"08/16/2013","dbgap"
"3517","phs000209.v13.pht002298.v1.p3",1918,2101,4019,"11/05/2014","dbgap"
"3518","phs000552.v2.pht003029.v1.p1",12,53,65,"04/08/2014","dbgap"
"3519","phs001303.v1.pht006611.v1.p1",1437,72,1509,"06/28/2017","dbgap"
"3520","phs000742.v1.pht008108.v1.p1",2559,2979,5538,"2018/07/23","dbgap"
"3522","phs000474.v3.pht002694.v3.p2",285,261,546,"04/25/2016","dbgap"
"3523","phs001135.v2.pht005984.v2.p1",685,293,978,"2020/03/09","dbgap"
"3524","phs001290.v1.pht010333.v1.p1",3202,2867,6069,"2020/07/29","dbgap"
"3525","phs001497.v2.pht007242.v2.p1",1819,1354,3173,"2021/09/08","dbgap"
"3526","phs000287.v7.pht001447.v4.p1",2400,3204,5604,"2020/01/23","dbgap"
"3527","phs000452.v3.pht002590.v3.p1",144,86,230,"2020/02/27","dbgap"
"3528","phs001869.v1.pht009397.v1.p1",526,475,1001,"2019/08/18","dbgap"
"3530","phs001576.v2.pht008217.v2.p2",35,17,52,"2019/09/27","dbgap"
"3533","phs001305.v1.pht007109.v1.p1",5,7,12,"2017/11/01","dbgap"
"3534","phs001488.v1.pht007421.v1.p1",3,3,6,"2018/02/08","dbgap"
"3535","phs000521.v2.pht007037.v2.p1",19,23,42,"2020/03/13","dbgap"
"3536","phs002499.v1.pht011448.v1.p1",6,3,9,"2021/08/05","dbgap"
"3537","phs000171.v1.pht000771.v1.p1",636,1282,1918,"12/11/2009","dbgap"
"3538","phs001172.v1.pht005841.v1.p2",1126,990,2116,"12/21/2016","dbgap"
"3539","phs000621.v1.pht003328.v1.p1",149,66,215,"07/09/2013","dbgap"
"3540","phs000128.v3.pht000521.v2.p3",2943,3500,6443,"04/29/2016","dbgap"
"3541","phs001397.v1.pht006954.v1.p1",316,404,720,"2017/10/05","dbgap"
"3542","phs001504.v2.pht007908.v1.p1",489,487,976,"2021/03/05","dbgap"
"3543","phs001573.v1.pht010179.v1.p1",29,10,39,"2020/04/29","dbgap"
"3544","phs000991.v1.pht005256.v1.p1",320,235,555,"01/21/2016","dbgap"
"3545","phs000285.v3.pht001644.v2.p2",905,1008,1913,"08/20/2013","dbgap"
"3546","phs001800.v2.pht008926.v2.p1",13,2,15,"2020/12/16","dbgap"
"3547","phs000744.v4.pht003976.v4.p2",1127,941,2068,"08/01/2016","dbgap"
"3548","phs002310.v1.pht011209.v1.p1",1328,559,1887,"2021/05/05","dbgap"
"3549","phs001757.v1.pht008667.v1.p1",148,184,332,"2019/03/11","dbgap"
"3550","phs001238.v2.pht006652.v1.p1",262,363,625,"2018/06/14","dbgap"
"3551","phs000578.v1.pht007004.v1.p1",1,3,4,"2017/10/11","dbgap"
"3552","phs000514.v1.pht002840.v1.p1",15,4,19,"08/15/2012","dbgap"
"3553","phs000331.v1.pht002094.v1.p1",424,405,829,"03/27/2012","dbgap"
"3554","phs000219.v1.pht001056.v1.p1",144,233,377,"01/19/2010","dbgap"
"3555","phs000888.v1.pht005580.v1.p1",519,167,686,"08/12/2016","dbgap"
"3556","phs000086.v3.pht000240.v1.p1",761,680,1441,"11/04/2014","dbgap"
"3557","phs000285.v3.pht001592.v2.p2",947,1064,2011,"08/20/2013","dbgap"
"3559","phs000778.v1.pht003968.v1.p1",1,4,5,"07/28/2014","dbgap"
"3560","phs001425.v1.pht006756.v1.p1",22,12,34,"2017/08/09","dbgap"
"3561","phs001305.v1.pht007100.v1.p1",5,7,12,"2017/11/01","dbgap"
"3562","phs000280.v7.pht004197.v2.p1",6608,7982,14590,"2020/06/18","dbgap"
"3563","phs000450.v4.pht002527.v3.p1",171,153,324,"2020/10/29","dbgap"
"3564","phs002290.v1.pht010823.v1.p1",82,36,118,"2020/12/30","dbgap"
"3565","phs001611.v1.pht009159.v1.p1",40,29,69,"2019/06/13","dbgap"
"3566","phs000127.v2.pht000650.v1.p1",231,201,432,"09/03/2010","dbgap"
"3568","phs000848.v1.pht004411.v1.p1",1,2,3,"12/10/2014","dbgap"
"3570","phs000521.v2.pht007034.v2.p1",2,2,4,"2020/03/13","dbgap"
"3571","phs001691.v1.pht008535.v1.p1",1,1,2,"2018/11/07","dbgap"
"3572","phs001419.v1.pht007092.v1.p1",17,11,28,"2017/12/04","dbgap"
"3573","phs000286.v6.pht001955.v2.p2",1248,2079,3327,"2019/03/11","dbgap"
"3574","phs000698.v1.pht007676.v1.p1",17,29,46,"2018/03/23","dbgap"
"3575","phs002389.v1.pht011093.v1.p1",39,23,62,"2021/04/06","dbgap"
"3576","phs001349.v2.pht010327.v1.p1",10093,515,10608,"2021/04/07","dbgap"
"3577","phs001444.v2.pht006960.v1.p1",190,138,328,"2019/11/04","dbgap"
"3578","phs000708.v1.pht003726.v1.p1",90,109,199,"07/14/2014","dbgap"
"3579","phs000382.v3.pht002324.v3.p1",51,55,106,"2018/01/18","dbgap"
"3580","phs000626.v1.pht003430.v1.p1",1,1,2,"08/21/2015","dbgap"
"3582","phs001124.v1.pht009257.v1.p1",47,228,275,"2019/07/22","dbgap"
"3583","phs001067.v1.pht005286.v1.p1",2,1,3,"02/02/2016","dbgap"
"3584","phs000294.v1.pht001534.v1.p1",4620,1422,6042,"08/17/2010","dbgap"
"3585","phs001597.v1.pht008127.v1.p1",38,24,62,"2019/03/22","dbgap"
"3586","phs000378.v1.pht002317.v1.p1",440,815,1255,"04/23/2014","dbgap"
"3587","phs000167.v1.pht000714.v1.p1",1086,490,1576,"04/22/2009","dbgap"
"3588","phs000007.v32.pht000688.v8.p13",1895,2163,4058,"2020/12/21","dbgap"
"3590","phs001475.v1.pht007582.v1.p1",575,512,1087,"2018/08/18","dbgap"
"3592","phs001871.v1.pht009360.v1.p1",137,211,348,"2019/08/01","dbgap"
"3593","phs001599.v1.pht011435.v1.p1",459,484,943,"2021/07/29","dbgap"
"3594","phs000902.v1.pht004669.v1.p1",607,177,784,"01/20/2016","dbgap"
"3595","phs001392.v1.pht006892.v1.p1",11,8,19,"2017/09/22","dbgap"
"3596","phs002003.v1.pht010109.v1.p1",19,19,38,"2020/04/06","dbgap"
"3597","phs001819.v2.pht009447.v1.p1",6,8,14,"2020/12/18","dbgap"
"3598","phs000603.v1.pht007550.v1.p1",3,8,11,"2018/03/06","dbgap"
"3600","phs001895.v2.pht009444.v2.p1",184,102,286,"2020/01/02","dbgap"
"3604","phs000280.v7.pht009459.v2.p1",341,466,807,"2020/06/18","dbgap"
"3606","phs000285.v3.pht001816.v2.p2",22,32,54,"08/20/2013","dbgap"
"3607","phs001252.v1.pht006392.v1.p1",383,250,633,"05/16/2017","dbgap"
"3608","phs000808.v1.pht004465.v1.p1",111,123,234,"02/05/2015","dbgap"
"3609","phs001039.v1.pht005849.v1.p1",15144,20214,35358,"10/19/2016","dbgap"
"3610","phs000007.v32.pht001039.v5.p13",540,591,1131,"2020/12/21","dbgap"
"3611","phs000378.v1.pht002316.v1.p1",440,815,1255,"04/23/2014","dbgap"
"3612","phs001598.v2.pht009996.v1.p1",222,68,290,"2021/06/28","dbgap"
"3613","phs001208.v2.pht008654.v1.p1",4344,4158,8502,"2019/08/10","dbgap"
"3614","phs001963.v1.pht009827.v1.p1",3885,2953,6838,"2020/11/24","dbgap"
"3615","phs000145.v4.pht000662.v3.p2",3078,2838,5916,"04/16/2013","dbgap"
"3617","phs000007.v32.pht000194.v8.p13",1890,2165,4055,"2020/12/21","dbgap"
"3618","phs002440.v1.pht011285.v1.p1",1,1,2,"2021/06/07","dbgap"
"3619","phs000285.v3.pht001587.v2.p2",938,1059,1997,"08/20/2013","dbgap"
"3620","phs002254.v1.pht010541.v1.p1",70,64,134,"2020/09/28","dbgap"
"3621","phs000541.v1.pht003050.v1.p1",2,5,7,"11/29/2012","dbgap"
"3622","phs001208.v2.pht008655.v1.p1",4344,4158,8502,"2019/08/10","dbgap"
"3623","phs001331.v2.pht006919.v2.p1",543,362,905,"2019/08/30","dbgap"
"3624","phs000285.v3.pht001841.v2.p2",876,990,1866,"08/20/2013","dbgap"
"3625","phs000650.v1.pht003484.v1.p1",364,222,586,"08/27/2013","dbgap"
"3627","phs001273.v3.pht006174.v2.p2",23125,13760,36885,"2019/10/10","dbgap"
"3628","phs001466.v2.pht009578.v1.p1",425,409,834,"2021/06/25","dbgap"
"3629","phs000966.v2.pht011076.v1.p2",91,108,199,"2021/08/27","dbgap"
"3630","phs000578.v1.pht007010.v1.p1",49,43,92,"2017/10/11","dbgap"
"3631","phs001517.v2.pht007482.v2.p2",514,480,994,"2020/04/30","dbgap"
"3632","phs000285.v3.pht001832.v2.p2",876,990,1866,"08/20/2013","dbgap"
"3633","phs000007.v32.pht002898.v5.p13",2071,2391,4462,"2020/12/21","dbgap"
"3634","phs001253.v1.pht006163.v1.p1",486,77,563,"02/23/2017","dbgap"
"3636","phs000086.v3.pht000280.v1.p1",761,680,1441,"11/04/2014","dbgap"
"3637","phs000408.v1.pht002439.v1.p1",174,788,962,"11/15/2011","dbgap"
"3638","phs000086.v3.pht000666.v1.p1",789,708,1497,"11/04/2014","dbgap"
"3639","phs000632.v1.pht003576.v1.p1",13,10,23,"02/07/2014","dbgap"
"3641","phs000124.v2.pht002173.v1.p1",867,766,1633,"03/08/2011","dbgap"
"3642","phs000332.v3.pht002337.v3.p2",12,1790,1802,"02/01/2016","dbgap"
"3643","phs001853.v1.pht009810.v1.p1",11,4,15,"2020/02/19","dbgap"
"3644","phs001298.v1.pht008647.v1.p1",2298,2504,4802,"2019/01/29","dbgap"
"3645","phs001259.v1.pht006088.v1.p1",726,1423,2149,"2019/04/23","dbgap"
"3647","phs000286.v6.pht008729.v1.p2",1295,2163,3458,"2019/03/11","dbgap"
"3649","phs000280.v7.pht006484.v1.p1",577,1063,1640,"2020/06/18","dbgap"
"3650","phs000209.v13.pht004322.v1.p3",2771,2985,5756,"11/05/2014","dbgap"
"3651","phs001303.v1.pht006613.v1.p1",1437,72,1509,"06/28/2017","dbgap"
"3653","phs001630.v1.pht010193.v1.p1",2021,784,2805,"2020/06/26","dbgap"
"3654","phs000763.v1.pht004254.v1.p1",987,1071,2058,"01/16/2015","dbgap"
"3655","phs001032.v6.pht005099.v3.p2",826,308,1134,"2021/05/20","dbgap"
"3656","phs000223.v1.pht002620.v1.p1",1298,2127,3425,"03/14/2012","dbgap"
"3657","phs001046.v1.pht005298.v1.p1",348,548,896,"2018/06/01","dbgap"
"3659","phs001442.v3.pht008328.v3.p2",6522,7316,13838,"2021/08/13","dbgap"
"3660","phs001164.v1.pht008869.v1.p1",22,19,41,"2019/03/25","dbgap"
"3661","phs001993.v1.pht010084.v1.p1",30,39,69,"2020/09/04","dbgap"
"3663","phs001608.v2.pht011585.v1.p1",290,352,642,"2021/09/29","dbgap"
"3664","phs000380.v1.pht002456.v1.p1",199,783,982,"01/13/2012","dbgap"
"3665","phs002289.v1.pht010891.v1.p1",9,4,13,"2021/01/28","dbgap"
"3666","phs000285.v3.pht001861.v2.p2",172,194,366,"08/20/2013","dbgap"
"3667","phs000364.v2.pht002263.v2.p1",26,16,42,"09/24/2013","dbgap"
"3668","phs000007.v32.pht010726.v1.p13",1589,1862,3451,"2020/12/21","dbgap"
"3669","phs001395.v2.pht006626.v1.p1",3380,4713,8093,"2021/06/09","dbgap"
"3670","phs000226.v2.pht002290.v1.p1",1567,2428,3995,"07/18/2011","dbgap"
"3673","phs001451.v3.pht007134.v3.p1",6,6,12,"2021/01/26","dbgap"
"3674","phs000398.v1.pht002466.v1.p1",234,361,595,"02/21/2012","dbgap"
"3675","phs001212.v1.pht006563.v1.p1",26,27,53,"2017/10/13","dbgap"
"3677","phs000086.v3.pht000340.v1.p1",139,110,249,"11/04/2014","dbgap"
"3678","phs000550.v1.pht003129.v1.p1",2,1,3,"01/18/2013","dbgap"
"3679","phs000556.v1.pht003140.v1.p1",2,4,6,"07/09/2013","dbgap"
"3680","phs000353.v1.pht002255.v1.p1",254,273,527,"08/08/2011","dbgap"
"3682","phs000589.v1.pht009197.v1.p1",9,127,136,"2019/06/14","dbgap"
"3683","phs000007.v32.pht000183.v13.p13",7982,7900,15882,"2020/12/21","dbgap"
"3684","phs001651.v1.pht008234.v1.p1",36,15,51,"2018/07/18","dbgap"
"3685","phs001906.v1.pht009662.v1.p1",7,9,16,"2019/12/11","dbgap"
"3687","phs000740.v1.pht003818.v1.p1",24,6,30,"04/22/2014","dbgap"
"3689","phs001421.v1.pht007025.v1.p1",20,17,37,"2018/01/11","dbgap"
"3690","phs002006.v2.pht010162.v2.p1",13,13,26,"2020/09/02","dbgap"
"3691","phs001616.v2.pht008544.v2.p2",11471,13443,24914,"2020/10/27","dbgap"
"3692","phs001176.v3.pht005797.v2.p1",17,12,29,"2019/10/23","dbgap"
"3695","phs000571.v3.pht003177.v3.p2",456,325,781,"12/01/2015","dbgap"
"3696","phs000546.v1.pht003141.v1.p1",40,35,75,"07/09/2013","dbgap"
"3697","phs001784.v1.pht009000.v1.p1",30,11,41,"2019/06/24","dbgap"
"3699","phs000007.v32.pht010753.v1.p13",89,149,238,"2020/12/21","dbgap"
"3700","phs001064.v1.pht006834.v1.p1",3,3,6,"2018/02/27","dbgap"
"3701","phs000007.v32.pht004815.v1.p13",110,178,288,"2020/12/21","dbgap"
"3702","phs000007.v32.pht000151.v8.p13",1767,1833,3600,"2020/12/21","dbgap"
"3704","phs001641.v1.pht010024.v1.p1",741,1643,2384,"2020/03/24","dbgap"
"3706","phs000486.v1.pht002804.v1.p1",1857,3481,5338,"12/17/2014","dbgap"
"3709","phs001547.v2.pht009989.v1.p1",75,15,90,"2021/07/15","dbgap"
"3710","phs001611.v1.pht009158.v1.p1",40,30,70,"2019/06/13","dbgap"
"3711","phs000128.v3.pht000424.v2.p3",2943,3500,6443,"04/29/2016","dbgap"
"3712","phs000285.v3.pht001773.v2.p2",130,251,381,"08/20/2013","dbgap"
"3713","phs001318.v1.pht008023.v1.p1",27,13,40,"2018/05/31","dbgap"
"3714","phs000607.v3.pht003445.v3.p2",4586,4909,9495,"2018/05/01","dbgap"
"3715","phs001406.v1.pht007747.v1.p1",151,230,381,"2019/10/11","dbgap"
"3717","phs000001.v3.pht000374.v2.p1",2090,2644,4734,"02/24/2012","dbgap"
"3719","phs000128.v3.pht000444.v2.p3",2943,3500,6443,"04/29/2016","dbgap"
"3721","phs000406.v1.pht002405.v1.p1",31,26,57,"10/25/2011","dbgap"
"3722","phs001385.v1.pht007164.v1.p1",24,165,189,"2017/12/04","dbgap"
"3723","phs001000.v1.pht005029.v1.p1",1973,349,2322,"03/16/2016","dbgap"
"3724","phs000287.v7.pht001476.v1.p1",2375,3156,5531,"2020/01/23","dbgap"
"3725","phs001515.v2.pht009567.v2.p2",6398,2702,9100,"2021/09/09","dbgap"
"3726","phs002015.v1.pht010369.v1.p1",1539,2128,3667,"2020/09/18","dbgap"
"3727","phs001322.v2.pht006332.v2.p1",8,4,12,"2018/04/30","dbgap"
"3728","phs000925.v1.pht005176.v1.p1",4949,7955,12904,"03/22/2017","dbgap"
"3729","phs001419.v1.pht007095.v1.p1",13,8,21,"2017/12/04","dbgap"
"3731","phs000814.v1.pht004582.v1.p1",3187,405,3592,"01/07/2016","dbgap"
"3732","phs000648.v1.pht004577.v1.p1",4561,3507,8068,"06/23/2015","dbgap"
"3734","phs001238.v2.pht006653.v1.p1",701,879,1580,"2018/06/14","dbgap"
"3735","phs000592.v1.pht006586.v1.p1",32,12,44,"07/12/2017","dbgap"
"3736","phs001327.v2.pht011186.v1.p1",13724,11941,25665,"2021/05/07","dbgap"
"3737","phs000478.v1.pht002658.v1.p1",7,6,13,"05/02/2012","dbgap"
"3738","phs000171.v1.pht000756.v1.p1",166,317,483,"12/11/2009","dbgap"
"3739","phs000606.v1.pht007575.v1.p1",742,274,1016,"2018/03/09","dbgap"
"3740","phs000128.v3.pht000584.v2.p3",2943,3500,6443,"04/29/2016","dbgap"
"3743","phs000280.v7.pht004230.v2.p1",6063,7326,13389,"2020/06/18","dbgap"
"3745","phs000571.v3.pht003175.v3.p2",3344,2916,6260,"12/01/2015","dbgap"
"3746","phs001740.v1.pht008624.v1.p1",353,226,579,"2019/08/01","dbgap"
"3747","phs000280.v7.pht006423.v1.p1",1071,1306,2377,"2020/06/18","dbgap"
"3748","phs001201.v2.pht007560.v2.p1",87,99,186,"2019/08/18","dbgap"
"3749","phs001310.v1.pht006864.v1.p1",31,25,56,"2017/09/18","dbgap"
"3750","phs000308.v1.pht002083.v1.p1",911,1381,2292,"12/16/2010","dbgap"
"3751","phs000678.v1.pht003564.v1.p1",589,2787,3376,"05/13/2014","dbgap"
"3752","phs001662.v2.pht010064.v1.p1",843,758,1601,"2021/08/19","dbgap"
"3753","phs001196.v1.pht005701.v1.p1",2788,2408,5196,"2018/04/05","dbgap"
"3754","phs001252.v1.pht006404.v1.p1",1568,1028,2596,"05/16/2017","dbgap"
"3755","phs000910.v1.pht004729.v1.p1",4063,3942,8005,"08/20/2015","dbgap"
"3756","phs000556.v1.pht003137.v1.p1",6,8,14,"07/09/2013","dbgap"
"3757","phs000996.v2.pht005751.v2.p1",698,687,1385,"2019/10/11","dbgap"
"3758","phs000280.v7.pht004145.v2.p1",5430,6643,12073,"2020/06/18","dbgap"
"3759","phs000209.v13.pht003089.v1.p3",3060,3369,6429,"11/05/2014","dbgap"
"3760","phs000573.v1.pht003216.v1.p1",49,34,83,"03/20/2013","dbgap"
"3761","phs001602.v2.pht009977.v1.p1",5,2,7,"2021/07/16","dbgap"
"3762","phs000381.v1.pht002423.v1.p1",743,488,1231,"12/19/2011","dbgap"
"3763","phs000007.v32.pht002232.v7.p13",1837,1662,3499,"2020/12/21","dbgap"
"3764","phs001434.v2.pht009857.v1.p1",47,18,65,"2021/06/23","dbgap"
"3765","phs002050.v1.pht010359.v1.p1",1113,1415,2528,"2020/11/19","dbgap"
"3766","phs000636.v1.pht003428.v1.p1",15,30,45,"08/09/2013","dbgap"
"3767","phs002444.v1.pht011383.v1.p1",392,323,715,"2021/07/30","dbgap"
"3768","phs001416.v2.pht009015.v1.p1",2532,2823,5355,"2019/10/01","dbgap"
"3770","phs000128.v3.pht000475.v2.p3",2943,3500,6443,"04/29/2016","dbgap"
"3772","phs001045.v1.pht009262.v1.p1",169,154,323,"2019/07/25","dbgap"
"3773","phs000289.v2.pht001886.v2.p1",1275,1322,2597,"05/26/2011","dbgap"
"3774","phs000007.v32.pht005146.v4.p13",1728,1965,3693,"2020/12/21","dbgap"
"3775","phs001913.v1.pht009513.v1.p1",79,198,277,"2019/12/10","dbgap"
"3776","phs000285.v3.pht001821.v2.p2",879,990,1869,"08/20/2013","dbgap"
"3778","phs001076.v1.pht005362.v1.p1",2379,2104,4483,"04/24/2017","dbgap"
"3779","phs000907.v1.pht004696.v1.p1",1,4,5,"11/25/2016","dbgap"
"3780","phs000007.v32.pht004814.v1.p13",161,231,392,"2020/12/21","dbgap"
"3781","phs001616.v2.pht008541.v2.p2",11469,13441,24910,"2020/10/27","dbgap"
"3782","phs000280.v7.pht004128.v2.p1",1154,1570,2724,"2020/06/18","dbgap"
"3785","phs000852.v1.pht006694.v1.p1",419,365,784,"07/26/2017","dbgap"
"3786","phs001196.v1.pht007727.v1.p1",2788,2408,5196,"2018/04/05","dbgap"
"3787","phs002317.v1.pht011165.v1.p1",232,183,415,"2021/05/04","dbgap"
"3788","phs000167.v1.pht000717.v1.p1",1820,1209,3029,"04/22/2009","dbgap"
"3789","phs001484.v1.pht007740.v1.p1",234,87,321,"2018/05/15","dbgap"
"3790","phs001368.v3.pht007959.v3.p2",2068,2809,4877,"2021/08/24","dbgap"
"3791","phs000153.v9.pht000835.v8.p8",7980,7899,15879,"07/16/2015","dbgap"
"3792","phs000007.v32.pht003311.v2.p13",467,516,983,"2020/12/21","dbgap"
"3793","phs001165.v1.pht007988.v1.p1",452,440,892,"2018/05/22","dbgap"
"3795","phs000007.v32.pht010745.v1.p13",1425,1733,3158,"2020/12/21","dbgap"
"3796","phs000592.v1.pht006584.v1.p1",7,5,12,"07/12/2017","dbgap"
"3797","phs001882.v1.pht010493.v1.p1",68,49999,50067,"2021/07/20","dbgap"
"3798","phs000209.v13.pht004324.v1.p3",2576,2817,5393,"11/05/2014","dbgap"
"3799","phs000837.v1.pht004442.v1.p1",3,3,6,"01/26/2015","dbgap"
"3800","phs000286.v6.pht008771.v1.p2",1295,2163,3458,"2019/03/11","dbgap"
"3801","phs000007.v32.pht000827.v2.p13",94,204,298,"2020/12/21","dbgap"
"3802","phs000308.v1.pht002086.v1.p1",910,1379,2289,"03/25/2011","dbgap"
"3803","phs000209.v13.pht001528.v1.p3",115,136,251,"11/05/2014","dbgap"
"3805","phs000285.v3.pht001862.v2.p2",172,194,366,"08/20/2013","dbgap"
"3806","phs000588.v1.pht009291.v1.p1",42,151,193,"2019/07/26","dbgap"
"3807","phs000171.v1.pht000785.v1.p1",329,669,998,"12/11/2009","dbgap"
"3808","phs000948.v1.pht004850.v1.p1",684,1284,1968,"08/26/2015","dbgap"
"3809","phs000203.v1.pht000883.v1.p1",2073,1267,3340,"10/12/2010","dbgap"
"3810","phs001238.v2.pht006049.v1.p1",432,1050,1482,"2018/06/14","dbgap"
"3811","phs001106.v1.pht007336.v1.p1",29,30,59,"2018/10/15","dbgap"
"3812","phs000280.v7.pht006483.v1.p1",2369,3153,5522,"2020/06/18","dbgap"
"3813","phs001419.v1.pht007086.v1.p1",181,173,354,"2017/12/04","dbgap"
"3814","phs000783.v2.pht004280.v2.p1",264,195,459,"2018/03/09","dbgap"
"3815","phs000128.v3.pht000404.v2.p3",2943,3500,6443,"04/29/2016","dbgap"
"3817","phs000872.v1.pht004573.v1.p1",18,6,24,"03/24/2015","dbgap"
"3818","phs000966.v2.pht005308.v2.p2",199,269,468,"2021/08/27","dbgap"
"3819","phs001458.v1.pht007782.v1.p1",721,1165,1886,"2018/04/12","dbgap"
"3820","phs001208.v2.pht008657.v1.p1",3272,3764,7036,"2019/08/10","dbgap"
"3821","phs001488.v1.pht007390.v1.p1",33,42,75,"2018/02/08","dbgap"
"3823","phs000840.v1.pht005641.v1.p1",1157,1191,2348,"07/21/2016","dbgap"
"3824","phs000280.v7.pht004064.v2.p1",5446,6662,12108,"2020/06/18","dbgap"
"3825","phs000285.v3.pht001660.v2.p2",11,8,19,"08/20/2013","dbgap"
"3826","phs001908.v2.pht009533.v2.p1",5,7,12,"2021/04/27","dbgap"
"3828","phs000280.v7.pht004122.v2.p1",6100,7352,13452,"2020/06/18","dbgap"
"3829","phs000089.v3.pht000177.v3.p2",336,466,802,"04/01/2010","dbgap"
"3831","phs001792.v1.pht008929.v1.p1",92,372,464,"2019/04/15","dbgap"
"3832","phs000128.v3.pht000512.v2.p3",2943,3500,6443,"04/29/2016","dbgap"
"3833","phs000560.v1.pht003066.v1.p1",333,510,843,"07/25/2014","dbgap"
"3834","phs001323.v2.pht010114.v2.p1",377,284,661,"2020/04/30","dbgap"
"3835","phs000549.v1.pht002990.v1.p1",1,5,6,"09/28/2012","dbgap"
"3837","phs001581.v1.pht008383.v1.p1",17,5,22,"2018/09/19","dbgap"
"3838","phs000007.v32.pht010757.v1.p13",2488,3040,5528,"2020/12/21","dbgap"
"3841","phs000280.v7.pht006416.v4.p1",6614,7790,14404,"2020/06/18","dbgap"
"3843","phs001318.v1.pht008026.v1.p1",28,13,41,"2018/05/31","dbgap"
"3844","phs001013.v3.pht005309.v3.p2",709,495,1204,"2017/11/13","dbgap"
"3845","phs000354.v1.pht003346.v1.p1",18,28,46,"06/25/2013","dbgap"
"3846","phs000286.v6.pht001950.v2.p2",1279,2127,3406,"2019/03/11","dbgap"
"3847","phs000219.v1.pht001100.v1.p1",664,1054,1718,"01/19/2010","dbgap"
"3848","phs000648.v1.pht004578.v1.p1",4561,3507,8068,"06/23/2015","dbgap"
"3849","phs000145.v4.pht002998.v2.p2",677,609,1286,"04/16/2013","dbgap"
"3850","phs001049.v1.pht005229.v1.p1",17,13,30,"2018/08/18","dbgap"
"3851","phs000209.v13.pht002197.v1.p3",605,886,1491,"11/05/2014","dbgap"
"3852","phs001616.v2.pht008539.v2.p2",11480,13455,24935,"2020/10/27","dbgap"
"3853","phs002055.v1.pht010346.v1.p1",177,99,276,"2020/07/10","dbgap"
"3855","phs000571.v3.pht003185.v3.p2",257,203,460,"12/01/2015","dbgap"
"3856","phs000262.v3.pht001280.v3.p2",31,11,42,"2017/09/05","dbgap"
"3857","phs001303.v1.pht006612.v1.p1",1437,72,1509,"06/28/2017","dbgap"
"3858","phs001246.v1.pht006082.v1.p1",16,17,33,"01/23/2017","dbgap"
"3859","phs000209.v13.pht001122.v2.p3",57,104,161,"11/05/2014","dbgap"
"3860","phs001328.v1.pht006318.v1.p1",52,34,86,"05/17/2017","dbgap"
"3861","phs001173.v1.pht005669.v1.p1",2521,812,3333,"2017/09/15","dbgap"
"3862","phs002015.v1.pht010365.v1.p1",4,4,8,"2020/09/18","dbgap"
"3863","phs001198.v1.pht007865.v1.p1",58,49,107,"2018/05/21","dbgap"
"3864","phs000280.v7.pht006445.v1.p1",2371,3180,5551,"2020/06/18","dbgap"
"3865","phs001660.v1.pht008411.v1.p1",59,44,103,"2018/10/05","dbgap"
"3866","phs000433.v1.pht002436.v1.p1",1325,2872,4197,"04/04/2012","dbgap"
"3867","phs002484.v1.pht011398.v1.p1",49,37,86,"2021/07/14","dbgap"
"3868","phs001292.v2.pht007849.v2.p1",164,400,564,"2019/06/03","dbgap"
"3870","phs001619.v3.pht008177.v3.p1",210,215,425,"2021/03/10","dbgap"
"3871","phs001759.v1.pht008709.v1.p1",1,6,7,"2019/03/08","dbgap"
"3872","phs002208.v1.pht010501.v1.p1",104,77,181,"2021/06/11","dbgap"
"3873","phs000791.v2.pht004592.v2.p1",21,23,44,"2020/01/10","dbgap"
"3874","phs000086.v3.pht000247.v1.p1",676,622,1298,"11/04/2014","dbgap"
"3875","phs000899.v1.pht008942.v1.p1",200,197,397,"2019/04/25","dbgap"
"3876","phs001065.v1.pht005421.v1.p1",296,313,609,"05/24/2016","dbgap"
"3877","phs000497.v3.pht002712.v3.p2",252,164,416,"10/07/2016","dbgap"
"3878","phs000128.v3.pht000438.v2.p3",2943,3500,6443,"04/29/2016","dbgap"
"3879","phs001065.v1.pht005403.v1.p1",296,313,609,"05/24/2016","dbgap"
"3880","phs000914.v1.pht005254.v1.p1",1283,1904,3187,"04/20/2016","dbgap"
"3881","phs000733.v1.pht003819.v1.p1",4008,16,4024,"07/18/2014","dbgap"
"3882","phs000397.v3.pht002410.v3.p3",2238,2748,4986,"2020/08/17","dbgap"
"3883","phs001741.v1.pht009165.v1.p1",573,332,905,"2020/01/07","dbgap"
"3885","phs000280.v7.pht004126.v2.p1",6782,8153,14935,"2020/06/18","dbgap"
"3886","phs000936.v1.pht004889.v1.p1",3623,2240,5863,"11/10/2015","dbgap"
"3887","phs000222.v6.pht002874.v3.p2",535,950,1485,"2019/08/01","dbgap"
"3888","phs000188.v1.pht001895.v1.p1",1200,1828,3028,"10/05/2010","dbgap"
"3890","phs000608.v1.pht003343.v1.p1",792,667,1459,"07/15/2013","dbgap"
"3891","phs000285.v3.pht001740.v2.p2",845,930,1775,"08/20/2013","dbgap"
"3892","phs000892.v2.pht004628.v2.p2",5,41,46,"09/29/2015","dbgap"
"3893","phs000239.v2.pht001223.v2.p1",2,4,6,"07/21/2010","dbgap"
"3894","phs001231.v2.pht006181.v2.p1",12,8,20,"2018/04/20","dbgap"
"3895","phs000586.v1.pht004831.v1.p1",285,768,1053,"08/18/2015","dbgap"
"3896","phs001488.v1.pht007375.v1.p1",24,25,49,"2018/02/08","dbgap"
"3897","phs000840.v1.pht005644.v1.p1",1157,1191,2348,"07/21/2016","dbgap"
"3898","phs001015.v1.pht005778.v1.p1",24,56,80,"09/30/2016","dbgap"
"3899","phs000086.v3.pht000266.v1.p1",750,668,1418,"11/04/2014","dbgap"
"3900","phs002015.v1.pht010382.v1.p1",844,1176,2020,"2020/09/18","dbgap"
"3902","phs001469.v1.pht007168.v1.p1",12,5,17,"2018/02/27","dbgap"
"3903","phs000285.v3.pht001750.v2.p2",63,194,257,"08/20/2013","dbgap"
"3904","phs001747.v1.pht008645.v1.p1",85,257,342,"2019/03/25","dbgap"
"3905","phs001318.v1.pht008016.v1.p1",28,13,41,"2018/05/31","dbgap"
"3906","phs001538.v1.pht008089.v1.p1",215,301,516,"2018/06/01","dbgap"
"3907","phs000285.v3.pht001692.v2.p2",900,1000,1900,"08/20/2013","dbgap"
"3909","phs001653.v1.pht008706.v1.p1",278,347,625,"2019/04/10","dbgap"
"3910","phs002323.v1.pht010884.v1.p1",3,3,6,"2021/05/24","dbgap"
"3911","phs001252.v1.pht006371.v1.p1",1685,1053,2738,"05/16/2017","dbgap"
"3912","phs000007.v32.pht004802.v3.p13",1153,1410,2563,"2020/12/21","dbgap"
"3913","phs000285.v3.pht001586.v2.p2",177,185,362,"08/20/2013","dbgap"
"3915","phs000269.v1.pht001498.v1.p1",371,323,694,"08/05/2010","dbgap"
"3917","phs001256.v2.pht005996.v1.p1",50,18,68,"05/12/2017","dbgap"
"3919","phs000771.v2.pht003983.v2.p1",72,29,101,"2017/10/25","dbgap"
"3921","phs000007.v32.pht003463.v4.p13",1591,1799,3390,"2020/12/21","dbgap"
"3923","phs000621.v1.pht003329.v1.p1",149,66,215,"07/09/2013","dbgap"
"3924","phs000344.v1.pht002170.v1.p1",301,595,896,"06/27/2011","dbgap"
"3925","phs000571.v3.pht003188.v3.p2",44,49,93,"12/01/2015","dbgap"
"3927","phs001057.v1.pht005302.v1.p1",894,99,993,"02/18/2016","dbgap"
"3928","phs000575.v2.pht005887.v2.p1",46,70,116,"2020/02/14","dbgap"
"3929","phs000652.v1.pht003458.v1.p1",4326,2485,6811,"09/03/2013","dbgap"
"3931","phs000280.v7.pht004050.v5.p1",4260,4112,8372,"2020/06/18","dbgap"
"3932","phs000285.v3.pht001606.v2.p2",88,73,161,"08/20/2013","dbgap"
"3933","phs000830.v1.pht004921.v1.p1",11,2,13,"08/21/2015","dbgap"
"3935","phs001048.v2.pht005659.v2.p1",171,136,307,"2019/04/10","dbgap"
"3936","phs000247.v5.pht001284.v4.p3",1349,1370,2719,"07/27/2017","dbgap"
"3937","phs001272.v1.pht007300.v1.p1",550,481,1031,"2018/11/16","dbgap"
"3939","phs000086.v3.pht000214.v1.p1",746,675,1421,"11/04/2014","dbgap"
"3940","phs001839.v1.pht009356.v1.p1",1,2,3,"2019/08/01","dbgap"
"3941","phs001546.v2.pht009973.v1.p1",5,1,6,"2021/07/14","dbgap"
"3942","phs000766.v1.pht003939.v1.p1",2383,2371,4754,"03/26/2015","dbgap"
"3943","phs001328.v1.pht006317.v1.p1",11,3,14,"05/17/2017","dbgap"
"3945","phs000697.v1.pht007704.v1.p1",28,6,34,"2018/03/26","dbgap"
"3946","phs000306.v4.pht001910.v3.p1",9127,13,9140,"04/10/2014","dbgap"
"3948","phs000616.v2.pht003372.v2.p2",467,468,935,"07/15/2015","dbgap"
"3949","phs000928.v1.pht004940.v1.p1",3,8,11,"01/13/2016","dbgap"
"3951","phs001346.v1.pht006255.v1.p1",5,10,15,"2019/03/28","dbgap"
"3953","phs000287.v7.pht001455.v1.p1",2375,3156,5531,"2020/01/23","dbgap"
"3954","phs000925.v1.pht005177.v1.p1",5209,8293,13502,"03/22/2017","dbgap"
"3955","phs000490.v1.pht002967.v1.p1",550,450,1000,"2018/05/07","dbgap"
"3956","phs001025.v1.pht005084.v1.p1",292,1987,2279,"11/06/2015","dbgap"
"3957","phs001662.v2.pht010056.v1.p1",843,758,1601,"2021/08/19","dbgap"
"3958","phs002230.v1.pht010964.v1.p1",233,544,777,"2021/02/23","dbgap"
"3959","phs000511.v1.pht002819.v1.p1",37,11,48,"07/09/2012","dbgap"
"3961","phs000017.v3.pht000367.v1.p1",131,284,415,"Wed Nov 26 07:46:15 2008","dbgap"
"3962","phs000831.v1.pht004908.v1.p1",84,73,157,"08/13/2015","dbgap"
"3963","phs000086.v3.pht000224.v1.p1",32,17,49,"11/04/2014","dbgap"
"3964","phs000577.v1.pht007288.v1.p1",28,39,67,"2017/12/20","dbgap"
"3965","phs000209.v13.pht001111.v4.p3",115,136,251,"11/05/2014","dbgap"
"3966","phs000094.v1.pht001136.v1.p1",4051,3547,7598,"04/12/2010","dbgap"
"3967","phs000285.v3.pht001683.v2.p2",1,2,3,"08/20/2013","dbgap"
"3968","phs000650.v1.pht003487.v1.p1",170,97,267,"08/27/2013","dbgap"
"3970","phs001389.v1.pht006603.v1.p1",6,7,13,"06/27/2017","dbgap"
"3971","phs002394.v1.pht011131.v1.p1",24,29,53,"2021/04/19","dbgap"
"3972","phs001489.v2.pht008583.v2.p2",6057,6807,12864,"2021/03/18","dbgap"
"3974","phs001723.v1.pht009727.v1.p1",2384,2409,4793,"2020/02/04","dbgap"
"3975","phs000873.v1.pht004557.v1.p1",2,6,8,"03/13/2015","dbgap"
"3976","phs000209.v13.pht002098.v2.p3",1896,1931,3827,"11/05/2014","dbgap"
"3977","phs000007.v32.pht005154.v3.p13",1479,1553,3032,"2020/12/21","dbgap"
"3978","phs000748.v7.pht003890.v7.p4",606,400,1006,"2019/02/05","dbgap"
"3979","phs000209.v13.pht003607.v1.p3",2677,2924,5601,"11/05/2014","dbgap"
"3980","phs000128.v3.pht000526.v2.p3",2943,3500,6443,"04/29/2016","dbgap"
"3981","phs001101.v1.pht005367.v1.p1",599,482,1081,"05/09/2016","dbgap"
"3982","phs000588.v1.pht009294.v1.p1",1,4,5,"2019/07/26","dbgap"
"3983","phs000549.v1.pht002991.v1.p1",1,5,6,"09/28/2012","dbgap"
"3984","phs001279.v1.pht007210.v1.p1",15,23,38,"2017/12/08","dbgap"
"3986","phs000285.v3.pht001617.v2.p2",56,84,140,"08/20/2013","dbgap"
"3987","phs000482.v1.pht002881.v1.p1",350,267,617,"12/07/2015","dbgap"
"3988","phs000255.v1.pht001253.v1.p1",56,60,116,"06/09/2010","dbgap"
"3989","phs001363.v1.pht006518.v1.p1",64,44,108,"2017/08/18","dbgap"
"3990","phs000285.v3.pht001784.v2.p2",867,971,1838,"08/20/2013","dbgap"
"3993","phs000308.v1.pht002085.v1.p1",880,1308,2188,"12/16/2010","dbgap"
"3994","phs000574.v1.pht005861.v1.p1",9,158,167,"03/06/2017","dbgap"
"3995","phs001330.v2.pht007526.v2.p1",25,15,40,"2019/11/08","dbgap"
"3996","phs000575.v2.pht005883.v2.p1",177,213,390,"2020/02/14","dbgap"
"3997","phs000571.v3.pht003179.v3.p2",27,18,45,"12/01/2015","dbgap"
"3998","phs002030.v1.pht010264.v1.p1",407,231,638,"2020/06/02","dbgap"
"3999","phs002361.v1.pht011067.v1.p1",1,1,2,"2021/03/18","dbgap"
"4000","phs000007.v32.pht000826.v7.p13",1851,2092,3943,"2020/12/21","dbgap"
"4001","phs000456.v1.pht002644.v1.p1",661,561,1222,"05/02/2012","dbgap"
"4002","phs000128.v3.pht000431.v2.p3",2943,3500,6443,"04/29/2016","dbgap"
"4003","phs002015.v1.pht010391.v1.p1",1810,2380,4190,"2020/09/18","dbgap"
"4004","phs000280.v7.pht004094.v2.p1",4883,6019,10902,"2020/06/18","dbgap"
"4006","phs000209.v13.pht001112.v2.p3",115,136,251,"11/05/2014","dbgap"
"4007","phs000181.v1.pht000793.v1.p1",3008,3211,6219,"12/11/2009","dbgap"
"4008","phs002063.v1.pht010405.v1.p1",21,13,34,"2020/07/24","dbgap"
"4009","phs000866.v1.pht004622.v1.p1",45,42,87,"03/23/2015","dbgap"
"4010","phs001488.v1.pht007424.v1.p1",229,252,481,"2018/02/08","dbgap"
"4011","phs000007.v32.pht002573.v4.p13",1887,2162,4049,"2020/12/21","dbgap"
"4013","phs000490.v1.pht002963.v1.p1",3927,3502,7429,"2018/05/07","dbgap"
"4014","phs001826.v1.pht009139.v1.p1",2995,3119,6114,"2019/07/16","dbgap"
"4015","phs000394.v1.pht002654.v1.p1",633,344,977,"05/24/2012","dbgap"
"4016","phs001195.v1.pht006862.v1.p1",10,3,13,"2018/03/27","dbgap"
"4017","phs000559.v1.pht003614.v1.p1",7858,6558,14416,"12/16/2013","dbgap"
"4018","phs001426.v1.pht006918.v1.p1",43,39,82,"2017/09/19","dbgap"
"4019","phs000998.v2.pht005474.v1.p1",4,4,8,"2020/08/26","dbgap"
"4020","phs001496.v1.pht007341.v1.p1",114,1,115,"2018/02/15","dbgap"
"4021","phs000286.v6.pht008722.v1.p2",1125,1993,3118,"2019/03/11","dbgap"
"4022","phs000007.v32.pht002075.v4.p13",62,77,139,"2020/12/21","dbgap"
"4023","phs001048.v2.pht005660.v2.p1",171,136,307,"2019/04/10","dbgap"
"4024","phs000285.v3.pht001649.v2.p2",189,264,453,"08/20/2013","dbgap"
"4025","phs001796.v1.pht008832.v1.p1",29,49,78,"2019/03/18","dbgap"
"4027","phs000872.v1.pht004576.v1.p1",18,6,24,"03/24/2015","dbgap"
"4028","phs000560.v1.pht003942.v1.p1",204,303,507,"07/25/2014","dbgap"
"4029","phs000862.v1.pht007836.v1.p1",1,4,5,"2018/04/16","dbgap"
"4030","phs000209.v13.pht002105.v3.p3",456,494,950,"11/05/2014","dbgap"
"4032","phs001293.v3.pht008894.v1.p1",16451,16124,32575,"2021/06/09","dbgap"
"4033","phs000500.v1.pht003114.v1.p1",4,2,6,"12/31/2012","dbgap"
"4034","phs002000.v1.pht010119.v1.p1",36,34,70,"2020/06/11","dbgap"
"4035","phs000171.v1.pht000782.v1.p1",321,657,978,"12/11/2009","dbgap"
"4036","phs000211.v1.pht000914.v1.p1",167,233,400,"09/16/2009","dbgap"
"4037","phs001914.v1.pht009889.v1.p1",31,16,47,"2020/02/25","dbgap"
"4040","phs000285.v3.pht001719.v2.p2",877,967,1844,"08/20/2013","dbgap"
"4041","phs001807.v1.pht008978.v1.p1",46,30,76,"2019/06/11","dbgap"
"4043","phs001469.v1.pht007170.v1.p1",12,5,17,"2018/02/27","dbgap"
"4044","phs000219.v1.pht001047.v1.p1",619,969,1588,"01/19/2010","dbgap"
"4045","phs001416.v2.pht009014.v1.p1",2532,2823,5355,"2019/10/01","dbgap"
"4046","phs000385.v1.pht002340.v1.p1",53,47,100,"11/28/2011","dbgap"
"4047","phs001474.v1.pht007153.v1.p1",9,9,18,"2017/11/30","dbgap"
"4049","phs001820.v1.pht010240.v1.p1",5,1,6,"2020/05/26","dbgap"
"4050","phs001542.v2.pht009643.v2.p1",462,528,990,"2021/10/04","dbgap"
"4051","phs000973.v1.pht004988.v1.p1",20,9,29,"11/16/2016","dbgap"
"4052","phs000007.v32.pht000391.v2.p13",375,602,977,"2020/12/21","dbgap"
"4053","phs001367.v1.pht008248.v1.p1",4737,5237,9974,"2018/07/25","dbgap"
"4054","phs001591.v1.pht009694.v1.p1",1789,3342,5131,"2021/08/03","dbgap"
"4055","phs000988.v5.pht005247.v5.p1",2041,1915,3956,"2021/09/28","dbgap"
"4056","phs002304.v1.pht010852.v1.p1",377,244,621,"2021/04/07","dbgap"
"4057","phs002508.v1.pht011501.v1.p1",1,5,6,"2021/08/20","dbgap"
"4058","phs001641.v1.pht010026.v1.p1",559,1278,1837,"2020/03/24","dbgap"
"4059","phs000365.v1.pht002267.v1.p1",2,1,3,"08/11/2011","dbgap"
"4060","phs001038.v1.pht005206.v1.p1",9,11,20,"02/23/2016","dbgap"
"4061","phs001360.v1.pht006295.v1.p1",332,1172,1504,"2020/05/05","dbgap"
"4062","phs001601.v2.pht010667.v1.p2",1271,939,2210,"2021/07/19","dbgap"
"4063","phs001430.v2.pht008061.v2.p1",13,10,23,"2020/02/06","dbgap"
"4064","phs001804.v1.pht008964.v1.p1",2280,721,3001,"2019/04/23","dbgap"
"4065","phs000289.v2.pht001885.v1.p1",1304,1343,2647,"05/26/2011","dbgap"
"4066","phs000267.v5.pht002305.v3.p2",4901,2979,7880,"03/02/2016","dbgap"
"4067","phs000285.v3.pht001867.v2.p2",400,810,1210,"08/20/2013","dbgap"
"4068","phs000124.v2.pht002172.v1.p1",867,766,1633,"03/08/2011","dbgap"
"4069","phs002254.v1.pht010540.v1.p1",70,64,134,"2020/09/28","dbgap"
"4070","phs000574.v1.pht005867.v1.p1",14,539,553,"03/06/2017","dbgap"
"4071","phs000815.v2.pht006791.v2.p1",130,174,304,"2020/02/03","dbgap"
"4072","phs000435.v3.pht002521.v3.p1",104,65,169,"02/27/2017","dbgap"
"4073","phs000454.v1.pht002649.v1.p1",2458,838,3296,"06/17/2013","dbgap"
"4074","phs000682.v1.pht003597.v1.p1",103,59,162,"11/25/2013","dbgap"
"4075","phs000269.v1.pht001496.v1.p1",371,323,694,"08/05/2010","dbgap"
"4076","phs000185.v7.pht008408.v1.p1",46,57,103,"2020/04/29","dbgap"
"4078","phs000007.v32.pht000160.v3.p13",204,323,527,"2020/12/21","dbgap"
"4079","phs000007.v32.pht000140.v7.p13",1087,896,1983,"2020/12/21","dbgap"
"4080","phs001065.v1.pht005406.v1.p1",296,313,609,"05/24/2016","dbgap"
"4081","phs000888.v1.pht005562.v1.p1",225,179,404,"08/12/2016","dbgap"
"4082","phs001134.v1.pht011225.v1.p1",1,3,4,"2021/05/17","dbgap"
"4084","phs002464.v1.pht011335.v1.p1",5,1,6,"2021/07/21","dbgap"
"4085","phs002052.v1.pht010320.v1.p1",20,20,40,"2020/08/05","dbgap"
"4086","phs000817.v1.pht004417.v1.p1",2,6,8,"01/05/2015","dbgap"
"4087","phs000001.v3.pht000382.v2.p1",1966,2546,4512,"02/24/2012","dbgap"
"4089","phs001981.v1.pht010702.v1.p1",32,16,48,"2020/12/16","dbgap"
"4090","phs001065.v1.pht005418.v1.p1",296,312,608,"05/24/2016","dbgap"
"4091","phs001387.v3.pht008968.v2.p1",2720,2747,5467,"2021/06/10","dbgap"
"4093","phs001502.v1.pht007260.v1.p1",674,698,1372,"2018/09/07","dbgap"
"4094","phs001913.v1.pht009512.v1.p1",79,198,277,"2019/12/10","dbgap"
"4096","phs001093.v1.pht005611.v1.p1",908,160,1068,"08/09/2016","dbgap"
"4097","phs000698.v1.pht007669.v1.p1",18,32,50,"2018/03/23","dbgap"
"4098","phs000264.v2.pht001419.v1.p1",114,69,183,"03/04/2011","dbgap"
"4099","phs000291.v2.pht002273.v1.p1",214,123,337,"05/11/2012","dbgap"
"4101","phs001619.v3.pht008174.v3.p1",282,268,550,"2021/03/10","dbgap"
"4104","phs000209.v13.pht003376.v1.p3",2818,3027,5845,"11/05/2014","dbgap"
"4107","phs000101.v5.pht003749.v2.p1",8696,6694,15390,"2018/08/19","dbgap"
"4109","phs000286.v6.pht008738.v1.p2",942,1573,2515,"2019/03/11","dbgap"
"4110","phs001995.v1.pht010398.v1.p1",298,380,678,"2020/07/17","dbgap"
"4111","phs001480.v1.pht010832.v1.p1",80,194,274,"2021/01/13","dbgap"
"4112","phs001786.v1.pht008838.v1.p1",17,19,36,"2019/08/01","dbgap"
"4113","phs001488.v1.pht007392.v1.p1",255,287,542,"2018/02/08","dbgap"
"4114","phs000286.v6.pht008768.v1.p2",1009,1780,2789,"2019/03/11","dbgap"
"4117","phs000285.v3.pht001628.v2.p2",909,1032,1941,"08/20/2013","dbgap"
"4118","phs000007.v32.pht000107.v8.p13",1472,1681,3153,"2020/12/21","dbgap"
"4119","phs000209.v13.pht002515.v1.p3",1435,1545,2980,"11/05/2014","dbgap"
"4120","phs000657.v1.pht003495.v1.p1",6,3,9,"08/30/2013","dbgap"
"4124","phs002008.v1.pht010200.v1.p1",14,4,18,"2020/06/15","dbgap"
"4125","phs000948.v1.pht004851.v1.p1",684,1284,1968,"08/26/2015","dbgap"
"4128","phs001318.v1.pht008031.v1.p1",27,13,40,"2018/05/31","dbgap"
"4129","phs001364.v1.pht007465.v1.p1",523,619,1142,"2018/02/27","dbgap"
"4132","phs000285.v3.pht001585.v2.p2",947,1065,2012,"08/20/2013","dbgap"
"4133","phs000285.v3.pht001753.v2.p2",859,961,1820,"08/20/2013","dbgap"
"4134","phs000867.v1.pht004481.v1.p1",1016,834,1850,"02/13/2015","dbgap"
"4135","phs001331.v2.pht006922.v2.p1",453,296,749,"2019/08/30","dbgap"
"4137","phs000280.v7.pht009472.v1.p1",2820,4159,6979,"2020/06/18","dbgap"
"4138","phs001412.v3.pht006746.v1.p1",170,235,405,"2021/06/16","dbgap"
"4139","phs001725.v2.pht010095.v1.p1",468,172,640,"2021/08/18","dbgap"
"4140","phs000383.v1.pht002868.v1.p1",33,3794,3827,"12/11/2012","dbgap"
"4141","phs001820.v1.pht010243.v1.p1",74,44,118,"2020/05/26","dbgap"
"4142","phs001219.v1.pht007861.v1.p1",236,239,475,"2018/04/23","dbgap"
"4144","phs000565.v1.pht003074.v1.p1",121,71,192,"12/06/2012","dbgap"
"4145","phs000007.v32.pht004810.v3.p13",1192,1512,2704,"2020/12/21","dbgap"
"4148","phs000588.v1.pht009304.v1.p1",42,151,193,"2019/07/26","dbgap"
"4149","phs000760.v1.pht004262.v1.p1",8,7,15,"02/18/2015","dbgap"
"4150","phs000128.v3.pht000559.v2.p3",2943,3500,6443,"04/29/2016","dbgap"
"4151","phs001673.v1.pht008509.v1.p1",936,1160,2096,"2019/04/25","dbgap"
"4152","phs000663.v3.pht003552.v3.p3",669,880,1549,"2021/08/31","dbgap"
"4156","phs000263.v1.pht001233.v1.p1",40,54,94,"06/14/2010","dbgap"
"4157","phs001430.v2.pht008081.v2.p1",13,12,25,"2020/02/06","dbgap"
"4158","phs001641.v1.pht010036.v1.p1",352,569,921,"2020/03/24","dbgap"
"4159","phs000539.v1.pht003022.v1.p1",3,5,8,"11/29/2012","dbgap"
"4160","phs000996.v2.pht005753.v1.p1",698,687,1385,"2019/10/11","dbgap"
"4161","phs001840.v1.pht009146.v1.p1",4,2,6,"2019/06/13","dbgap"
"4162","phs000007.v32.pht005172.v3.p13",223,282,505,"2020/12/21","dbgap"
"4163","phs000007.v32.pht000139.v5.p13",661,736,1397,"2020/12/21","dbgap"
"4164","phs000434.v1.pht002606.v1.p1",4,4,8,"09/10/2012","dbgap"
"4165","phs001278.v1.pht006283.v1.p1",82,111,193,"06/16/2017","dbgap"
"4166","phs000590.v1.pht008273.v1.p1",33,36,69,"2018/08/03","dbgap"
"4167","phs001327.v2.pht006559.v2.p1",2986,3192,6178,"2021/05/07","dbgap"
"4168","phs001588.v1.pht007960.v1.p1",34212,45997,80209,"2018/07/18","dbgap"
"4169","phs000395.v1.pht002361.v1.p1",11,991,1002,"07/18/2012","dbgap"
"4170","phs001819.v2.pht009446.v1.p1",6,8,14,"2020/12/18","dbgap"
"4171","phs002444.v1.pht011386.v1.p1",392,323,715,"2021/07/30","dbgap"
"4172","phs000279.v2.pht001435.v2.p1",409,327,736,"01/11/2016","dbgap"
"4173","phs000286.v6.pht001940.v2.p2",1294,2162,3456,"2019/03/11","dbgap"
"4174","phs001417.v1.pht007367.v1.p1",136,409,545,"2018/01/26","dbgap"
"4176","phs001626.v1.pht008478.v1.p1",47,47,94,"2018/10/29","dbgap"
"4177","phs001433.v1.pht006811.v1.p1",12,9,21,"2017/08/24","dbgap"
"4178","phs002457.v1.pht011515.v1.p1",1,24,25,"2021/08/30","dbgap"
"4179","phs002301.v1.pht010815.v1.p1",50,30,80,"2020/12/22","dbgap"
"4180","phs000128.v3.pht000509.v2.p3",2943,3500,6443,"04/29/2016","dbgap"
"4181","phs001675.v1.pht010219.v1.p1",190,195,385,"2021/02/10","dbgap"
"4182","phs002331.v1.pht011104.v1.p1",1681,544,2225,"2021/05/21","dbgap"
"4183","phs000297.v1.pht002392.v1.p1",2281,2991,5272,"07/27/2012","dbgap"
"4184","phs000577.v1.pht007291.v1.p1",41,159,200,"2017/12/20","dbgap"
"4186","phs000171.v1.pht000780.v1.p1",330,668,998,"12/11/2009","dbgap"
"4187","phs001173.v1.pht005671.v1.p1",2521,812,3333,"2017/09/15","dbgap"
"4189","phs001188.v2.pht006301.v2.p1",57,49,106,"2019/12/16","dbgap"
"4190","phs001796.v1.pht008833.v1.p1",18,28,46,"2019/03/18","dbgap"
"4191","phs001645.v1.pht008209.v1.p1",16,9,25,"2018/07/18","dbgap"
"4192","phs000632.v1.pht003580.v1.p1",6,4,10,"02/07/2014","dbgap"
"4193","phs000166.v2.pht000704.v2.p1",310,411,721,"09/03/2009","dbgap"
"4196","phs001332.v2.pht007447.v2.p1",157,188,345,"2019/11/08","dbgap"
"4197","phs001372.v1.pht006533.v1.p1",3,2,5,"2017/10/10","dbgap"
"4198","phs002039.v1.pht010269.v1.p1",5,13,18,"2020/06/10","dbgap"
"4199","phs001607.v3.pht010150.v3.p2",2528,1111,3639,"2021/07/29","dbgap"
"4200","phs000473.v2.pht002599.v2.p2",6600,5780,12380,"08/15/2016","dbgap"
"4201","phs000169.v1.pht000730.v1.p1",1367,1435,2802,"12/03/2009","dbgap"
"4203","phs001318.v1.pht008022.v1.p1",23,13,36,"2018/05/31","dbgap"
"4204","phs001376.v1.pht006552.v1.p1",4,5,9,"06/15/2017","dbgap"
"4205","phs001649.v1.pht008515.v1.p1",299,170,469,"2019/02/19","dbgap"
"4206","phs001091.v1.pht006064.v1.p1",3,2,5,"05/12/2017","dbgap"
"4207","phs001076.v1.pht005361.v1.p1",2379,2104,4483,"04/24/2017","dbgap"
"4208","phs001607.v3.pht010152.v3.p2",2528,1111,3639,"2021/07/29","dbgap"
"4209","phs002040.v1.pht010257.v1.p1",2,1,3,"2020/06/02","dbgap"
"4210","phs000007.v32.pht002851.v7.p13",1348,1616,2964,"2020/12/21","dbgap"
"4212","phs000454.v1.pht002648.v1.p1",2458,838,3296,"06/17/2013","dbgap"
"4216","phs000086.v3.pht000278.v1.p1",761,680,1441,"11/04/2014","dbgap"
"4218","phs001279.v1.pht007208.v1.p1",15,23,38,"2017/12/08","dbgap"
"4219","phs001093.v1.pht005610.v1.p1",908,160,1068,"07/06/2016","dbgap"
"4220","phs001292.v2.pht007848.v2.p1",226,530,756,"2019/06/03","dbgap"
"4221","phs000007.v32.pht000024.v5.p13",367,692,1059,"2020/12/21","dbgap"
"4222","phs001555.v1.pht007880.v1.p1",72,72,144,"2018/04/30","dbgap"
"4223","phs000285.v3.pht001789.v2.p2",420,446,866,"08/20/2013","dbgap"
"4224","phs001339.v1.pht006787.v1.p1",712,748,1460,"2020/06/02","dbgap"
"4225","phs001526.v1.pht007614.v1.p1",7,5,12,"2018/06/26","dbgap"
"4226","phs002020.v1.pht010230.v1.p1",438,352,790,"2020/05/26","dbgap"
"4228","phs000086.v3.pht000326.v1.p1",724,659,1383,"11/04/2014","dbgap"
"4229","phs000792.v1.pht004251.v1.p1",15,3,18,"09/18/2014","dbgap"
"4232","phs000575.v2.pht005891.v2.p1",170,209,379,"2020/02/14","dbgap"
"4233","phs001000.v1.pht005031.v1.p1",1973,349,2322,"03/16/2016","dbgap"
"4234","phs001767.v1.pht008659.v1.p1",143,55,198,"2019/01/29","dbgap"
"4235","phs001436.v1.pht007248.v1.p1",819,863,1682,"2019/09/20","dbgap"
"4236","phs000437.v1.pht003690.v1.p1",4,8,12,"04/09/2014","dbgap"
"4237","phs000763.v1.pht004252.v1.p1",1848,1709,3557,"01/16/2015","dbgap"
"4238","phs000086.v3.pht000233.v1.p1",761,680,1441,"11/04/2014","dbgap"
"4239","phs000255.v1.pht001255.v1.p1",56,60,116,"06/09/2010","dbgap"
"4241","phs000806.v1.pht004773.v1.p1",1315,653,1968,"01/15/2016","dbgap"
"4242","phs000249.v2.pht001879.v2.p1",254,128,382,"04/16/2014","dbgap"
"4243","phs000445.v1.pht002504.v1.p1",17,3,20,"10/15/2012","dbgap"
"4245","phs001330.v2.pht007528.v2.p1",22,15,37,"2019/11/08","dbgap"
"4246","phs000590.v1.pht008262.v1.p1",7,3,10,"2018/08/03","dbgap"
"4247","phs000128.v3.pht000566.v2.p3",2943,3500,6443,"04/29/2016","dbgap"
"4248","phs000758.v1.pht004002.v1.p1",10,11,21,"08/21/2014","dbgap"
"4249","phs000779.v1.pht003963.v1.p1",1193,1209,2402,"07/25/2014","dbgap"
"4251","phs000567.v1.pht003080.v1.p1",13,13,26,"12/17/2012","dbgap"
"4252","phs000589.v1.pht009191.v1.p1",9,126,135,"2019/06/14","dbgap"
"4253","phs001735.v2.pht009980.v2.p1",2430,2119,4549,"2021/09/08","dbgap"
"4254","phs000612.v1.pht003526.v1.p1",25,35,60,"05/23/2014","dbgap"
"4255","phs000514.v1.pht002838.v1.p1",15,4,19,"08/15/2012","dbgap"
"4257","phs000124.v2.pht002171.v1.p1",867,766,1633,"03/08/2011","dbgap"
"4258","phs001238.v2.pht006034.v1.p1",201,551,752,"2018/06/14","dbgap"
"4259","phs000573.v1.pht003213.v1.p1",49,34,83,"03/20/2013","dbgap"
"4260","phs000285.v3.pht001669.v2.p2",906,1012,1918,"08/20/2013","dbgap"
"4261","phs001326.v1.pht007808.v1.p1",29,3,32,"2018/04/16","dbgap"
"4262","phs000589.v1.pht009199.v1.p1",9,127,136,"2019/06/14","dbgap"
"4263","phs000007.v32.pht003096.v3.p13",1012,1240,2252,"2020/12/21","dbgap"
"4264","phs000020.v2.pht000667.v1.p1",1291,2449,3740,"Mon Oct 27 16:32:31 2008","dbgap"
"4266","phs001377.v1.pht006942.v1.p1",321,44,365,"2017/09/22","dbgap"
"4267","phs001494.v1.pht007192.v1.p1",732,413,1145,"2018/03/08","dbgap"
"4269","phs002034.v1.pht010256.v1.p1",23,16,39,"2020/05/27","dbgap"
"4272","phs000646.v1.pht003434.v1.p1",2,1,3,"08/06/2013","dbgap"
"4273","phs001245.v1.pht005933.v1.p1",3,2,5,"2018/01/29","dbgap"
"4274","phs002323.v1.pht010880.v1.p1",37,34,71,"2021/05/24","dbgap"
"4275","phs000280.v7.pht004040.v3.p1",4865,5989,10854,"2020/06/18","dbgap"
"4277","phs000561.v1.pht003034.v1.p1",6,5,11,"11/05/2012","dbgap"
"4278","phs001194.v3.pht005829.v2.p2",3587,2803,6390,"2020/07/24","dbgap"
"4279","phs000285.v3.pht001793.v2.p2",867,970,1837,"08/20/2013","dbgap"
"4280","phs001428.v1.pht008386.v1.p1",16,1831,1847,"2018/09/20","dbgap"
"4281","phs001488.v1.pht007398.v1.p1",260,293,553,"2018/02/08","dbgap"
"4282","phs000086.v3.pht000230.v1.p1",757,674,1431,"11/04/2014","dbgap"
"4283","phs000343.v3.pht003149.v1.p1",26,12,38,"03/12/2013","dbgap"
"4284","phs001089.v4.pht005486.v4.p1",729,674,1403,"2021/09/23","dbgap"
"4285","phs000086.v3.pht000225.v1.p1",117,100,217,"11/04/2014","dbgap"
"4286","phs001046.v1.pht005294.v1.p1",348,548,896,"2018/06/01","dbgap"
"4287","phs000153.v9.pht000837.v6.p8",6035,7015,13050,"07/16/2015","dbgap"
"4288","phs000609.v1.pht003286.v1.p1",18,9,27,"05/14/2013","dbgap"
"4289","phs002480.v1.pht011395.v1.p1",1059,821,1880,"2021/08/11","dbgap"
"4290","phs001032.v6.pht005675.v3.p2",826,308,1134,"2021/05/20","dbgap"
"4291","phs001143.v4.pht005902.v1.p1",990,867,1857,"2021/06/01","dbgap"
"4292","phs002235.v1.pht010956.v1.p1",19,18,37,"2021/03/25","dbgap"
"4293","phs001392.v1.pht006905.v1.p1",12,7,19,"2017/09/22","dbgap"
"4294","phs000632.v1.pht003578.v1.p1",6,4,10,"02/07/2014","dbgap"
"4295","phs000240.v1.pht002278.v1.p1",472,606,1078,"08/03/2011","dbgap"
"4297","phs001701.v1.pht009377.v1.p1",425,884,1309,"2019/08/06","dbgap"
"4298","phs000285.v3.pht001612.v2.p2",19,16,35,"08/20/2013","dbgap"
"4301","phs000784.v3.pht004287.v1.p1",518,482,1000,"2019/11/15","dbgap"
"4303","phs001678.v1.pht008471.v1.p1",6,2,8,"2018/10/29","dbgap"
"4304","phs000160.v1.pht000734.v1.p1",2598,2867,5465,"Fri Feb 20 11:36:11 2009","dbgap"
"4305","phs001238.v2.pht006648.v2.p1",1137,1902,3039,"2018/06/14","dbgap"
"4306","phs000576.v1.pht006146.v1.p1",96,115,211,"05/24/2017","dbgap"
"4307","phs000007.v32.pht001224.v4.p13",662,732,1394,"2020/12/21","dbgap"
"4308","phs000327.v1.pht003012.v1.p1",58,36,94,"03/22/2013","dbgap"
"4309","phs001704.v1.pht008460.v1.p1",16,7,23,"2018/10/16","dbgap"
"4310","phs001406.v1.pht007745.v1.p1",1153,1764,2917,"2019/10/11","dbgap"
"4311","phs000594.v1.pht006494.v1.p1",5,3,8,"06/12/2017","dbgap"
"4312","phs002176.v2.pht010946.v1.p1",18,20,38,"2021/05/10","dbgap"
"4313","phs000007.v32.pht000167.v8.p13",1463,1696,3159,"2020/12/21","dbgap"
"4314","phs000588.v1.pht009288.v1.p1",2,7,9,"2019/07/26","dbgap"
"4315","phs000817.v1.pht004413.v1.p1",6,10,16,"01/05/2015","dbgap"
"4316","phs000086.v3.pht000345.v1.p1",4,3,7,"11/04/2014","dbgap"
"4318","phs000929.v1.pht007982.v1.p1",15,7275,7290,"2018/05/24","dbgap"
"4319","phs000128.v3.pht000408.v2.p3",2943,3500,6443,"04/29/2016","dbgap"
"4320","phs002046.v1.pht010623.v1.p1",1401,4157,5558,"2020/11/02","dbgap"
"4321","phs000415.v1.pht002415.v1.p1",91,78,169,"08/13/2015","dbgap"
"4322","phs001807.v1.pht008981.v1.p1",8,3,11,"2019/06/11","dbgap"
"4323","phs000219.v1.pht001051.v1.p1",664,1054,1718,"01/19/2010","dbgap"
"4324","phs000742.v1.pht008117.v1.p1",13,16,29,"2018/07/23","dbgap"
"4325","phs001299.v2.pht007623.v1.p1",1135,1317,2452,"2020/03/09","dbgap"
"4326","phs000086.v3.pht000259.v1.p1",411,385,796,"11/04/2014","dbgap"
"4328","phs001247.v1.pht008296.v1.p1",451,448,899,"2018/08/13","dbgap"
"4329","phs001180.v2.pht006989.v1.p1",4,4,8,"2020/06/29","dbgap"
"4330","phs000206.v5.pht000896.v4.p3",4813,4624,9437,"08/18/2015","dbgap"
"4331","phs001109.v3.pht005448.v2.p2",1121,673,1794,"2020/02/28","dbgap"
"4332","phs002448.v1.pht011300.v1.p1",1,6,7,"2021/06/09","dbgap"
"4334","phs000732.v1.pht003801.v1.p1",12,8,20,"04/14/2014","dbgap"
"4335","phs001606.v2.pht010091.v1.p1",134,190,324,"2021/07/19","dbgap"
"4336","phs000797.v1.pht004267.v1.p1",4,1,5,"09/29/2014","dbgap"
"4337","phs000001.v3.pht000379.v2.p1",2098,2659,4757,"02/24/2012","dbgap"
"4338","phs001197.v1.pht007562.v1.p1",111,84,195,"2018/04/27","dbgap"
"4339","phs002506.v1.pht011540.v1.p1",4037,3056,7093,"2021/09/29","dbgap"
"4340","phs001272.v1.pht007301.v1.p1",550,481,1031,"2018/11/16","dbgap"
"4341","phs001625.v1.pht008186.v1.p1",112,140,252,"2018/06/30","dbgap"
"4342","phs000959.v1.pht009700.v1.p1",1343,194,1537,"2019/12/16","dbgap"
"4344","phs001388.v2.pht006877.v2.p1",1230,2066,3296,"2021/03/05","dbgap"
"4345","phs001380.v1.pht009226.v1.p1",2337,959,3296,"2019/10/11","dbgap"
"4347","phs000540.v1.pht003046.v1.p1",5,3,8,"11/08/2012","dbgap"
"4349","phs000285.v3.pht001576.v2.p2",947,1065,2012,"08/20/2013","dbgap"
"4350","phs000171.v1.pht000763.v1.p1",636,1284,1920,"12/11/2009","dbgap"
"4351","phs001466.v2.pht009579.v1.p1",425,409,834,"2021/06/25","dbgap"
"4352","phs000518.v1.pht002848.v1.p1",7,17,24,"10/13/2012","dbgap"
"4353","phs000086.v3.pht000341.v1.p1",14,13,27,"11/04/2014","dbgap"
"4354","phs000581.v1.pht003204.v1.p1",61,59,120,"06/04/2013","dbgap"
"4355","phs000348.v2.pht002231.v2.p1",26,12,38,"12/19/2014","dbgap"
"4356","phs000128.v3.pht000540.v2.p3",2943,3500,6443,"04/29/2016","dbgap"
"4357","phs001521.v1.pht007722.v1.p1",62,31,93,"2018/06/13","dbgap"
"4360","phs001036.v1.pht005269.v1.p1",21,13,34,"02/27/2017","dbgap"
"4362","phs000007.v32.pht006013.v4.p13",864,996,1860,"2020/12/21","dbgap"
"4363","phs001422.v2.pht006761.v2.p1",23,13,36,"2021/02/08","dbgap"
"4364","phs001106.v1.pht008459.v1.p1",29,30,59,"2018/10/15","dbgap"
"4365","phs000285.v3.pht001837.v2.p2",876,990,1866,"08/20/2013","dbgap"
"4366","phs001326.v1.pht007807.v1.p1",14,2,16,"2018/04/16","dbgap"
"4367","phs000343.v3.pht002213.v2.p1",1345,777,2122,"03/12/2013","dbgap"
"4368","phs001310.v1.pht006867.v1.p1",30,25,55,"2017/09/18","dbgap"
"4369","phs002298.v1.pht010760.v1.p1",359,36,395,"2020/12/09","dbgap"
"4370","phs000886.v1.pht004649.v1.p1",30,44,74,"05/26/2016","dbgap"
"4371","phs001624.v2.pht008231.v2.p2",1507,1159,2666,"2021/07/29","dbgap"
"4372","phs001318.v1.pht008019.v1.p1",27,13,40,"2018/05/31","dbgap"
"4373","phs000086.v3.pht000244.v1.p1",414,312,726,"11/04/2014","dbgap"
"4374","phs001551.v1.pht008349.v1.p1",49,52,101,"2018/09/07","dbgap"
"4375","phs000128.v3.pht000466.v2.p3",2943,3500,6443,"04/29/2016","dbgap"
"4376","phs001143.v4.pht005906.v1.p1",454,549,1003,"2021/06/01","dbgap"
"4377","phs000209.v13.pht001123.v7.p3",3060,3369,6429,"11/05/2014","dbgap"
"4378","phs000653.v3.pht003464.v3.p1",1041,1145,2186,"2018/09/11","dbgap"
"4379","phs001080.v1.pht005373.v1.p1",62,41,103,"04/06/2016","dbgap"
"4380","phs000674.v1.pht003638.v1.p1",32008,46478,78486,"01/27/2014","dbgap"
"4381","phs001266.v2.pht007221.v1.p1",773,592,1365,"2020/03/09","dbgap"
"4382","phs000866.v1.pht004619.v1.p1",45,42,87,"03/23/2015","dbgap"
"4383","phs000927.v1.pht004752.v1.p1",71,131,202,"04/05/2017","dbgap"
"4385","phs000751.v1.pht003868.v1.p1",1090,526,1616,"05/30/2014","dbgap"
"4387","phs000282.v1.pht001443.v1.p1",3544,4281,7825,"06/24/2010","dbgap"
"4388","phs001725.v2.pht010093.v1.p1",468,172,640,"2021/08/18","dbgap"
"4389","phs001003.v2.pht010323.v2.p1",56,89,145,"2021/03/01","dbgap"
"4391","phs000128.v3.pht000577.v2.p3",2943,3500,6443,"04/29/2016","dbgap"
"4393","phs001329.v2.pht007182.v2.p1",1,4,5,"2019/05/07","dbgap"
"4394","phs000629.v1.pht003386.v1.p1",595,976,1571,"04/24/2015","dbgap"
"4396","phs001339.v1.pht006786.v1.p1",712,748,1460,"2020/06/02","dbgap"
"4398","phs000742.v1.pht008105.v1.p1",3862,4008,7870,"2018/07/23","dbgap"
"4399","phs001578.v1.pht007876.v1.p1",40,42,82,"2018/11/30","dbgap"
"4400","phs002088.v2.pht010716.v1.p1",22,18,40,"2021/06/16","dbgap"
"4401","phs000448.v1.pht002511.v1.p1",2164,932,3096,"08/28/2012","dbgap"
"4403","phs001065.v1.pht005411.v1.p1",296,313,609,"05/24/2016","dbgap"
"4404","phs000280.v7.pht004107.v2.p1",6781,8155,14936,"2020/06/18","dbgap"
"4405","phs000285.v3.pht001738.v2.p2",177,185,362,"08/20/2013","dbgap"
"4406","phs000280.v7.pht004041.v2.p1",6653,8000,14653,"2020/06/18","dbgap"
"4407","phs000922.v2.pht004927.v2.p1",252,83,335,"2021/05/24","dbgap"
"4408","phs000285.v3.pht001712.v2.p2",873,956,1829,"08/20/2013","dbgap"
"4410","phs001065.v1.pht005423.v1.p1",12,4,16,"05/24/2016","dbgap"
"4411","phs001188.v2.pht006615.v2.p1",57,49,106,"2019/12/16","dbgap"
"4412","phs000143.v1.pht000646.v1.p1",692,1340,2032,"02/25/2011","dbgap"
"4414","phs000280.v7.pht004027.v2.p1",6784,8156,14940,"2020/06/18","dbgap"
"4415","phs000577.v1.pht007262.v1.p1",174,341,515,"2017/12/20","dbgap"
"4417","phs001517.v2.pht007483.v2.p2",514,480,994,"2020/04/30","dbgap"
"4418","phs000235.v17.pht001133.v17.p4",113,144,257,"2021/08/30","dbgap"
"4419","phs000578.v1.pht007018.v1.p1",49,45,94,"2017/10/11","dbgap"
"4420","phs000830.v1.pht004920.v1.p1",11,2,13,"08/21/2015","dbgap"
"4422","phs001168.v2.pht007580.v2.p2",755,623,1378,"2019/03/19","dbgap"
"4423","phs001696.v1.pht008431.v1.p1",6,4,10,"2018/10/02","dbgap"
"4424","phs001315.v1.pht006192.v1.p1",4482,4243,8725,"2018/05/18","dbgap"
"4425","phs001675.v1.pht010220.v1.p1",151,168,319,"2021/02/10","dbgap"
"4426","phs001795.v1.pht008949.v1.p1",46,49,95,"2019/06/24","dbgap"
"4427","phs000267.v5.pht002304.v4.p2",4901,2979,7880,"03/02/2016","dbgap"
"4429","phs001209.v1.pht006804.v1.p1",9,11,20,"2017/08/22","dbgap"
"4430","phs001244.v1.pht006058.v1.p1",73,30,103,"01/09/2017","dbgap"
"4431","phs000899.v1.pht008945.v1.p1",85,81,166,"2019/04/25","dbgap"
"4432","phs000286.v6.pht001975.v2.p2",1291,2160,3451,"2019/03/11","dbgap"
"4433","phs001488.v1.pht007425.v1.p1",260,293,553,"2018/02/08","dbgap"
"4434","phs000144.v1.pht000720.v1.p1",165,216,381,"Wed Jan 21 13:20:37 2009","dbgap"
"4435","phs000285.v3.pht001787.v2.p2",867,971,1838,"08/20/2013","dbgap"
"4436","phs000571.v3.pht003173.v3.p2",3344,2916,6260,"12/01/2015","dbgap"
"4438","phs000511.v1.pht002817.v1.p1",37,11,48,"07/09/2012","dbgap"
"4439","phs000918.v1.pht004750.v1.p1",6842,4560,11402,"06/10/2015","dbgap"
"4440","phs001296.v2.pht006361.v2.p1",11,30,41,"2019/05/31","dbgap"
"4442","phs000577.v1.pht007276.v1.p1",24,40,64,"2017/12/20","dbgap"
"4444","phs000201.v2.pht000887.v1.p1",49,37,86,"04/09/2014","dbgap"
"4445","phs000219.v1.pht001052.v1.p1",240,331,571,"01/19/2010","dbgap"
"4446","phs000935.v1.pht004819.v1.p1",93,66,159,"11/16/2016","dbgap"
"4447","phs000630.v1.pht003382.v1.p1",466,480,946,"04/29/2014","dbgap"
"4449","phs000594.v1.pht006510.v1.p1",5,3,8,"06/12/2017","dbgap"
"4451","phs000592.v1.pht006590.v1.p1",179,145,324,"07/12/2017","dbgap"
"4452","phs001370.v1.pht006644.v1.p1",28,21,49,"07/06/2017","dbgap"
"4453","phs000959.v1.pht009701.v1.p1",1343,194,1537,"2019/12/16","dbgap"
"4454","phs000574.v1.pht005863.v1.p1",41,940,981,"03/06/2017","dbgap"
"4455","phs001231.v2.pht006179.v1.p1",12,8,20,"2018/04/20","dbgap"
"4456","phs002545.v1.pht011485.v1.p1",19,7,26,"2021/09/14","dbgap"
"4457","phs000007.v32.pht003632.v5.p13",1677,1895,3572,"2020/12/21","dbgap"
"4459","phs001252.v1.pht006403.v1.p1",1515,992,2507,"05/16/2017","dbgap"
"4460","phs000862.v1.pht007838.v1.p1",1,4,5,"2018/04/16","dbgap"
"4462","phs000128.v3.pht000531.v2.p3",2943,3500,6443,"04/29/2016","dbgap"
"4463","phs002050.v1.pht010360.v1.p1",1113,1415,2528,"2020/11/19","dbgap"
"4464","phs000993.v5.pht005015.v2.p2",464,245,709,"2021/05/20","dbgap"
"4465","phs000021.v3.pht000067.v2.p2",981,421,1402,"10/25/2010","dbgap"
"4466","phs000285.v3.pht001790.v2.p2",867,965,1832,"08/20/2013","dbgap"
"4467","phs001065.v1.pht005415.v1.p1",159,164,323,"05/24/2016","dbgap"
"4468","phs002024.v1.pht010233.v1.p1",271,228,499,"2020/05/13","dbgap"
"4469","phs001994.v1.pht010009.v1.p1",46,15,61,"2020/04/14","dbgap"
"4470","phs001177.v2.pht006091.v1.p1",60,56,116,"2019/11/27","dbgap"
"4471","phs000128.v3.pht000536.v2.p3",2943,3500,6443,"04/29/2016","dbgap"
"4473","phs000888.v1.pht005581.v1.p1",183,93,276,"08/12/2016","dbgap"
"4475","phs000394.v1.pht002653.v1.p1",633,344,977,"05/24/2012","dbgap"
"4476","phs001165.v1.pht007985.v1.p1",452,440,892,"2018/05/22","dbgap"
"4477","phs001194.v3.pht005824.v2.p2",3587,2804,6391,"2020/07/24","dbgap"
"4478","phs001358.v1.pht006334.v1.p1",27,37,64,"05/02/2017","dbgap"
"4479","phs000209.v13.pht003091.v3.p3",3060,3369,6429,"11/05/2014","dbgap"
"4480","phs001238.v2.pht006030.v1.p1",168,443,611,"2018/06/14","dbgap"
"4481","phs000864.v1.pht004492.v1.p1",3979,19,3998,"05/08/2015","dbgap"
"4482","phs001761.v1.pht009029.v1.p1",34,120,154,"2019/05/16","dbgap"
"4484","phs000287.v7.pht001491.v2.p1",2140,2763,4903,"2020/01/23","dbgap"
"4485","phs000622.v1.pht003951.v1.p1",1612,1991,3603,"07/25/2014","dbgap"
"4486","phs001868.v1.pht009778.v1.p1",5418,5814,11232,"2020/04/17","dbgap"
"4487","phs001107.v1.pht005491.v1.p1",3,3,6,"05/26/2016","dbgap"
"4489","phs000086.v3.pht000269.v1.p1",683,615,1298,"11/04/2014","dbgap"
"4491","phs000924.v4.pht006322.v4.p1",98,126,224,"2019/10/07","dbgap"
"4492","phs001252.v1.pht006399.v1.p1",365,221,586,"05/16/2017","dbgap"
"4493","phs001037.v1.pht005918.v1.p1",3570,3442,7012,"11/09/2016","dbgap"
"4495","phs000086.v3.pht000357.v1.p1",319,328,647,"11/04/2014","dbgap"
"4496","phs001839.v1.pht009357.v1.p1",1,2,3,"2019/08/01","dbgap"
"4497","phs002068.v1.pht010871.v1.p1",807,637,1444,"2021/01/26","dbgap"
"4498","phs000886.v1.pht004648.v1.p1",30,44,74,"05/26/2016","dbgap"
"4499","phs001305.v1.pht007105.v1.p1",5,7,12,"2017/11/01","dbgap"
"4500","phs000128.v3.pht000520.v2.p3",2943,3500,6443,"04/29/2016","dbgap"
"4501","phs000368.v1.pht002293.v1.p1",21,4118,4139,"10/07/2011","dbgap"
"4503","phs000167.v1.pht000715.v1.p1",700,685,1385,"04/22/2009","dbgap"
"4504","phs000287.v7.pht001456.v1.p1",2375,3156,5531,"2020/01/23","dbgap"
"4505","phs001424.v1.pht007000.v1.p1",7,5,12,"2017/10/10","dbgap"
"4506","phs001496.v1.pht007339.v1.p1",114,1,115,"2018/02/15","dbgap"
"4509","phs001717.v1.pht008579.v1.p1",152,150,302,"2019/03/11","dbgap"
"4510","phs000007.v32.pht002425.v2.p13",402,501,903,"2020/12/21","dbgap"
"4511","phs000594.v1.pht006499.v1.p1",6,3,9,"06/12/2017","dbgap"
"4512","phs000362.v1.pht003231.v1.p1",10,2,12,"08/26/2013","dbgap"
"4513","phs000091.v2.pht000798.v2.p1",2612,3440,6052,"08/24/2009","dbgap"
"4514","phs001810.v1.pht009066.v1.p1",831,716,1547,"2019/07/01","dbgap"
"4516","phs001935.v1.pht009769.v1.p1",3,3,6,"2020/02/06","dbgap"
"4517","phs000806.v1.pht004772.v1.p1",1315,653,1968,"01/15/2016","dbgap"
"4519","phs000086.v3.pht000333.v1.p1",130,121,251,"11/04/2014","dbgap"
"4520","phs000285.v3.pht001749.v2.p2",947,1065,2012,"08/20/2013","dbgap"
"4521","phs000663.v3.pht003550.v3.p3",669,880,1549,"2021/08/31","dbgap"
"4522","phs000458.v1.pht003592.v1.p1",59,63,122,"11/26/2013","dbgap"
"4523","phs001448.v1.pht007032.v1.p1",27,31,58,"2017/10/19","dbgap"
"4524","phs002035.v1.pht010412.v1.p1",25,34,59,"2020/07/21","dbgap"
"4525","phs001195.v1.pht006859.v1.p1",10,3,13,"2018/03/27","dbgap"
"4526","phs001776.v1.pht009208.v1.p1",51,40,91,"2019/06/19","dbgap"
"4528","phs000285.v3.pht001702.v2.p2",529,838,1367,"08/20/2013","dbgap"
"4529","phs000128.v3.pht000595.v2.p3",2943,3500,6443,"04/29/2016","dbgap"
"4530","phs001848.v1.pht009206.v1.p1",1,2,3,"2019/06/24","dbgap"
"4531","phs000577.v1.pht007278.v1.p1",14,22,36,"2017/12/20","dbgap"
"4532","phs000758.v1.pht003998.v1.p1",15,13,28,"08/21/2014","dbgap"
"4533","phs001581.v1.pht008381.v1.p1",17,5,22,"2018/09/19","dbgap"
"4534","phs001065.v1.pht005426.v1.p1",284,313,597,"05/24/2016","dbgap"
"4535","phs000521.v2.pht007043.v2.p1",70,57,127,"2020/03/13","dbgap"
"4536","phs001488.v1.pht007433.v1.p1",260,293,553,"2018/02/08","dbgap"
"4537","phs000372.v1.pht002859.v1.p1",2595,3470,6065,"02/13/2014","dbgap"
"4538","phs001349.v2.pht010329.v1.p1",10093,515,10608,"2021/04/07","dbgap"
"4539","phs000418.v2.pht002617.v1.p1",7,1,8,"04/10/2014","dbgap"
"4540","phs002034.v1.pht010255.v1.p1",23,16,39,"2020/05/27","dbgap"
"4542","phs000276.v2.pht002003.v2.p1",2592,2810,5402,"01/22/2014","dbgap"
"4543","phs001330.v2.pht007538.v2.p1",16,9,25,"2019/11/08","dbgap"
"4544","phs001008.v1.pht005107.v1.p1",913,988,1901,"11/13/2015","dbgap"
"4545","phs002222.v1.pht010525.v1.p1",3,8,11,"2020/09/17","dbgap"
"4548","phs001091.v1.pht006063.v1.p1",3,2,5,"05/12/2017","dbgap"
"4549","phs000810.v1.pht004714.v1.p1",5444,7746,13190,"12/02/2015","dbgap"
"4550","phs000285.v3.pht001656.v2.p2",908,1016,1924,"08/20/2013","dbgap"
"4551","phs000618.v1.pht003301.v1.p1",2046,2304,4350,"10/24/2013","dbgap"
"4552","phs000578.v1.pht007013.v1.p1",49,44,93,"2017/10/11","dbgap"
"4553","phs001296.v2.pht006360.v2.p1",11,30,41,"2019/05/31","dbgap"
"4555","phs001819.v2.pht009448.v1.p1",6,8,14,"2020/12/18","dbgap"
"4556","phs000209.v13.pht002103.v1.p3",492,509,1001,"11/05/2014","dbgap"
"4557","phs000287.v7.pht001477.v1.p1",2375,3156,5531,"2020/01/23","dbgap"
"4558","phs000286.v6.pht008719.v1.p2",940,1565,2505,"2019/03/11","dbgap"
"4559","phs000007.v32.pht005164.v3.p13",1318,1406,2724,"2020/12/21","dbgap"
"4560","phs001598.v2.pht009998.v1.p1",222,68,290,"2021/06/28","dbgap"
"4561","phs000908.v1.pht004708.v1.p1",96,104,200,"01/19/2016","dbgap"
"4562","phs001430.v2.pht008056.v2.p1",11,10,21,"2020/02/06","dbgap"
"4563","phs000744.v4.pht003979.v4.p2",1030,851,1881,"08/01/2016","dbgap"
"4564","phs001375.v2.pht006522.v2.p1",408,628,1036,"2021/03/22","dbgap"
"4565","phs000582.v1.pht003245.v1.p1",7,5,12,"05/16/2013","dbgap"
"4566","phs000086.v3.pht000342.v1.p1",21,20,41,"11/04/2014","dbgap"
"4567","phs001691.v1.pht008536.v1.p1",1,1,2,"2018/11/07","dbgap"
"4569","phs000697.v1.pht007691.v1.p1",28,6,34,"2018/03/26","dbgap"
"4570","phs000287.v7.pht001468.v1.p1",2375,3156,5531,"2020/01/23","dbgap"
"4571","phs001578.v1.pht007875.v1.p1",40,42,82,"2018/11/30","dbgap"
"4572","phs001442.v3.pht010303.v1.p2",6519,7314,13833,"2021/08/13","dbgap"
"4573","phs001037.v1.pht005920.v1.p1",3570,3442,7012,"11/09/2016","dbgap"
"4575","phs001015.v1.pht005779.v1.p1",24,56,80,"09/30/2016","dbgap"
"4577","phs000576.v1.pht006144.v1.p1",116,128,244,"05/24/2017","dbgap"
"4578","phs000294.v1.pht001533.v1.p1",4620,1422,6042,"08/17/2010","dbgap"
"4579","phs000341.v2.pht003165.v1.p1",152,89,241,"11/21/2016","dbgap"
"4580","phs001541.v1.pht008306.v1.p1",387,10506,10893,"2019/11/25","dbgap"
"4581","phs001833.v1.pht009151.v1.p1",134,165,299,"2019/06/14","dbgap"
"4582","phs000254.v2.pht002224.v2.p1",217,214,431,"10/11/2012","dbgap"
"4583","phs000708.v1.pht003727.v1.p1",91,109,200,"07/14/2014","dbgap"
"4585","phs000007.v32.pht006010.v1.p13",160,228,388,"2020/12/21","dbgap"
"4586","phs000474.v3.pht002696.v3.p2",285,261,546,"04/25/2016","dbgap"
"4587","phs001106.v1.pht007335.v1.p1",29,30,59,"2018/10/15","dbgap"
"4588","phs000871.v1.pht004570.v1.p1",16,17,33,"05/08/2017","dbgap"
"4589","phs000280.v7.pht004038.v3.p1",6104,7376,13480,"2020/06/18","dbgap"
"4590","phs001525.v1.pht007474.v1.p1",33,29,62,"2018/02/12","dbgap"
"4591","phs000128.v3.pht000447.v2.p3",2943,3500,6443,"04/29/2016","dbgap"
"4592","phs001156.v2.pht007049.v1.p1",137,159,296,"2017/10/20","dbgap"
"4593","phs001036.v1.pht005271.v1.p1",21,13,34,"02/27/2017","dbgap"
"4594","phs000285.v3.pht001767.v2.p2",34,59,93,"08/20/2013","dbgap"
"4596","phs001292.v2.pht009127.v1.p1",48,169,217,"2019/06/03","dbgap"
"4598","phs001919.v1.pht009595.v1.p1",28,11,39,"2020/03/11","dbgap"
"4599","phs002428.v1.pht011267.v1.p1",72,137,209,"2021/06/02","dbgap"
"4601","phs001041.v1.pht005390.v1.p1",39,25,64,"06/09/2016","dbgap"
"4603","phs001831.v1.pht009167.v1.p1",101,88,189,"2020/08/26","dbgap"
"4604","phs001661.v3.pht010560.v1.p1",2791,2673,5464,"2021/08/17","dbgap"
"4605","phs000888.v1.pht005552.v1.p1",509,216,725,"08/12/2016","dbgap"
"4606","phs001895.v2.pht009445.v2.p1",184,102,286,"2020/01/02","dbgap"
"4607","phs000209.v13.pht004317.v1.p3",2028,2239,4267,"11/05/2014","dbgap"
"4608","phs000595.v1.pht006628.v1.p1",287,330,617,"07/05/2017","dbgap"
"4609","phs001630.v1.pht008171.v1.p1",1956,720,2676,"2020/06/26","dbgap"
"4610","phs000180.v3.pht002744.v1.p2",2152,1886,4038,"05/20/2015","dbgap"
"4611","phs001385.v1.pht007165.v1.p1",24,165,189,"2017/12/04","dbgap"
"4612","phs000128.v3.pht000570.v2.p3",2943,3500,6443,"04/29/2016","dbgap"
"4614","phs002283.v1.pht010685.v1.p1",856,467,1323,"2020/11/30","dbgap"
"4615","phs000086.v3.pht000331.v1.p1",708,649,1357,"11/04/2014","dbgap"
"4616","phs000478.v1.pht002657.v1.p1",7,6,13,"05/02/2012","dbgap"
"4617","phs001311.v1.pht007932.v1.p1",35,26,61,"2018/05/15","dbgap"
"4618","phs001538.v1.pht008094.v1.p1",222,317,539,"2018/06/01","dbgap"
"4620","phs000816.v2.pht004341.v2.p1",199,224,423,"04/17/2017","dbgap"
"4621","phs001188.v2.pht006302.v2.p1",57,49,106,"2020/01/06","dbgap"
"4622","phs001686.v1.pht008565.v1.p1",3,3,6,"2018/11/26","dbgap"
"4623","phs001364.v1.pht007463.v1.p1",1001,1078,2079,"2018/02/27","dbgap"
"4624","phs000839.v1.pht004391.v1.p1",1,2,3,"12/01/2014","dbgap"
"4625","phs001430.v2.pht008055.v2.p1",13,8,21,"2020/02/06","dbgap"
"4626","phs000848.v1.pht004409.v1.p1",1,2,3,"12/10/2014","dbgap"
"4629","phs000590.v1.pht008282.v1.p1",1,4,5,"2018/08/03","dbgap"
"4630","phs001697.v1.pht010579.v1.p1",57,175,232,"2021/01/12","dbgap"
"4631","phs000007.v32.pht002346.v3.p13",456,465,921,"2020/12/21","dbgap"
"4632","phs002045.v1.pht010309.v1.p1",9,6,15,"2020/06/30","dbgap"
"4633","phs001423.v3.pht006983.v3.p2",973,678,1651,"2021/05/13","dbgap"
"4634","phs002440.v1.pht011283.v1.p1",1,1,2,"2021/06/07","dbgap"
"4636","phs000592.v1.pht006599.v1.p1",170,136,306,"07/12/2017","dbgap"
"4637","phs002208.v1.pht010498.v1.p1",104,77,181,"2021/06/11","dbgap"
"4638","phs000387.v1.pht002444.v1.p1",716,194,910,"12/19/2011","dbgap"
"4639","phs001281.v2.pht006136.v2.p1",15,25,40,"2019/02/21","dbgap"
"4640","phs000171.v1.pht000761.v1.p1",633,1280,1913,"12/11/2009","dbgap"
"4641","phs000428.v2.pht005036.v1.p2",5119,7386,12505,"01/27/2017","dbgap"
"4642","phs001984.v1.pht010785.v1.p1",706,388,1094,"2020/12/14","dbgap"
"4644","phs001969.v1.pht009934.v1.p1",14,6,20,"2020/03/04","dbgap"
"4645","phs001677.v1.pht008379.v1.p1",182,911,1093,"2018/09/17","dbgap"
"4646","phs000280.v7.pht006452.v1.p1",716,1008,1724,"2020/06/18","dbgap"
"4648","phs000128.v3.pht000576.v2.p3",2943,3500,6443,"04/29/2016","dbgap"
"4649","phs001055.v1.pht005914.v1.p1",782,782,1564,"2017/08/16","dbgap"
"4650","phs001782.v2.pht008801.v2.p1",330,472,802,"2021/07/02","dbgap"
"4651","phs000285.v3.pht001622.v2.p2",22,43,65,"08/20/2013","dbgap"
"4652","phs000484.v1.pht002683.v1.p1",5,2,7,"06/01/2012","dbgap"
"4654","phs002049.v1.pht010297.v1.p1",64,53,117,"2020/06/30","dbgap"
"4656","phs002001.v1.pht010098.v1.p1",6,9,15,"2021/09/28","dbgap"
"4657","phs000280.v7.pht004148.v2.p1",6120,7410,13530,"2020/06/18","dbgap"
"4659","phs000742.v1.pht008120.v1.p1",552,656,1208,"2018/07/23","dbgap"
"4660","phs000086.v3.pht000328.v1.p1",680,654,1334,"11/04/2014","dbgap"
"4661","phs001604.v2.pht009985.v1.p1",29,27,56,"2021/07/16","dbgap"
"4662","phs000128.v3.pht000561.v2.p3",2943,3500,6443,"04/29/2016","dbgap"
"4665","phs001918.v2.pht010048.v1.p1",5164,3924,9088,"2021/10/07","dbgap"
"4668","phs001430.v2.pht008064.v2.p1",12,10,22,"2020/02/06","dbgap"
"4669","phs000140.v1.pht000630.v1.p1",377,594,971,"11/24/2010","dbgap"
"4670","phs001653.v1.pht008703.v1.p1",278,347,625,"2019/04/10","dbgap"
"4671","phs001169.v2.pht006184.v2.p1",104,28,132,"2020/06/10","dbgap"
"4672","phs001210.v1.pht005964.v1.p1",2501,2834,5335,"11/30/2016","dbgap"
"4673","phs000007.v32.pht002888.v6.p13",1425,1727,3152,"2020/12/21","dbgap"
"4674","phs000440.v1.pht002493.v1.p1",403,543,946,"03/15/2012","dbgap"
"4676","phs000438.v1.pht003319.v1.p1",341,380,721,"04/18/2014","dbgap"
"4677","phs001430.v2.pht008076.v2.p1",12,10,22,"2020/02/06","dbgap"
"4678","phs000598.v2.pht003322.v2.p2",42,9,51,"10/28/2013","dbgap"
"4679","phs001011.v2.pht005529.v1.p1",935,633,1568,"2020/07/21","dbgap"
"4680","phs000538.v1.pht003041.v1.p1",2,4,6,"11/07/2012","dbgap"
"4681","phs002440.v1.pht011284.v1.p1",1,1,2,"2021/06/07","dbgap"
"4682","phs000751.v1.pht003867.v1.p1",1090,526,1616,"05/30/2014","dbgap"
"4684","phs000199.v1.pht000893.v1.p1",922,1104,2026,"01/06/2010","dbgap"
"4685","phs000346.v2.pht002183.v2.p2",9054,2370,11424,"06/01/2015","dbgap"
"4688","phs002008.v1.pht010199.v1.p1",14,4,18,"2020/06/15","dbgap"
"4689","phs000452.v3.pht002589.v3.p1",144,86,230,"2020/02/27","dbgap"
"4690","phs000572.v8.pht005179.v1.p4",4582,6331,10913,"2019/11/19","dbgap"
"4691","phs000007.v32.pht000138.v3.p13",245,418,663,"2020/12/21","dbgap"
"4692","phs000492.v3.pht002709.v3.p2",53,55,108,"2018/10/19","dbgap"
"4693","phs000636.v1.pht003427.v1.p1",15,30,45,"08/09/2013","dbgap"
"4694","phs001586.v1.pht008150.v1.p1",98,101,199,"2018/06/18","dbgap"
"4696","phs000007.v32.pht000681.v7.p13",1414,1640,3054,"2020/12/21","dbgap"
"4697","phs000007.v32.pht002147.v2.p13",239,201,440,"2020/12/21","dbgap"
"4698","phs001779.v1.pht010205.v1.p1",46,125,171,"2020/06/25","dbgap"
"4699","phs000521.v2.pht007044.v2.p1",70,57,127,"2020/03/13","dbgap"
"4701","phs001199.v1.pht005705.v1.p1",138,59,197,"08/29/2016","dbgap"
"4702","phs000623.v1.pht003338.v1.p1",47,59,106,"08/16/2013","dbgap"
"4703","phs000286.v6.pht008767.v1.p2",370,569,939,"2019/03/11","dbgap"
"4704","phs001717.v1.pht008578.v1.p1",152,150,302,"2019/03/11","dbgap"
"4705","phs000406.v1.pht002404.v1.p1",31,26,57,"10/25/2011","dbgap"
"4706","phs001038.v1.pht005207.v1.p1",9,11,20,"02/23/2016","dbgap"
"4708","phs000285.v3.pht001667.v2.p2",902,1001,1903,"08/20/2013","dbgap"
"4710","phs000222.v6.pht002875.v3.p2",427,742,1169,"2019/08/01","dbgap"
"4711","phs000007.v32.pht000031.v9.p13",1822,1942,3764,"2020/12/21","dbgap"
"4712","phs000289.v2.pht001883.v1.p1",1305,1347,2652,"05/26/2011","dbgap"
"4713","phs000691.v2.pht003654.v2.p1",291,197,488,"03/11/2015","dbgap"
"4714","phs001664.v1.pht008437.v1.p1",827,392,1219,"2018/10/02","dbgap"
"4716","phs000586.v1.pht004830.v1.p1",285,768,1053,"08/18/2015","dbgap"
"4717","phs000574.v1.pht005868.v1.p1",41,972,1013,"03/06/2017","dbgap"
"4718","phs000431.v2.pht002485.v2.p1",2333,1282,3615,"02/20/2015","dbgap"
"4719","phs000590.v1.pht008286.v1.p1",4,7,11,"2018/08/03","dbgap"
"4720","phs001052.v2.pht005466.v2.p1",57,26,83,"2020/11/24","dbgap"
"4721","phs001609.v1.pht008141.v1.p1",89,875,964,"2019/01/10","dbgap"
"4722","phs000387.v1.pht002442.v1.p1",716,194,910,"12/19/2011","dbgap"
"4723","phs000778.v1.pht003969.v1.p1",1,4,5,"07/28/2014","dbgap"
"4724","phs000285.v3.pht001755.v2.p2",407,435,842,"08/20/2013","dbgap"
"4726","phs001404.v1.pht010789.v1.p1",33,125,158,"2020/12/15","dbgap"
"4728","phs001238.v2.pht006048.v1.p1",432,1050,1482,"2018/06/14","dbgap"
"4729","phs000219.v1.pht001082.v1.p1",200,311,511,"01/19/2010","dbgap"
"4730","phs000708.v1.pht003728.v1.p1",90,109,199,"07/14/2014","dbgap"
"4731","phs000144.v1.pht000723.v1.p1",165,216,381,"Wed Jan 21 13:20:41 2009","dbgap"
"4732","phs001325.v3.pht006352.v2.p1",121,152,273,"2019/11/22","dbgap"
"4733","phs001065.v1.pht005396.v1.p1",273,283,556,"05/24/2016","dbgap"
"4734","phs000462.v1.pht002541.v1.p1",676,718,1394,"05/07/2013","dbgap"
"4735","phs000285.v3.pht001875.v2.p2",40,52,92,"08/20/2013","dbgap"
"4736","phs001491.v2.pht007253.v2.p1",134,171,305,"2020/03/09","dbgap"
"4737","phs000128.v3.pht000429.v2.p3",2943,3500,6443,"04/29/2016","dbgap"
"4739","phs001675.v1.pht010221.v1.p1",190,195,385,"2021/02/10","dbgap"
"4740","phs001872.v1.pht009365.v1.p1",290,309,599,"2019/07/31","dbgap"
"4741","phs001400.v1.pht006823.v1.p1",2,2,4,"2017/11/09","dbgap"
"4742","phs000976.v2.pht005686.v1.p1",1792,2096,3888,"2020/11/09","dbgap"
"4744","phs001326.v1.pht007816.v1.p1",27,5,32,"2018/04/16","dbgap"
"4747","phs001370.v1.pht006647.v1.p1",28,21,49,"07/06/2017","dbgap"
"4748","phs001331.v2.pht006920.v2.p1",451,295,746,"2019/08/30","dbgap"
"4749","phs001329.v2.pht007172.v2.p1",1,4,5,"2019/05/07","dbgap"
"4750","phs000280.v7.pht006417.v1.p1",2260,2984,5244,"2020/06/18","dbgap"
"4751","phs000755.v2.pht004991.v1.p1",34,27,61,"2019/01/04","dbgap"
"4752","phs001516.v1.pht007493.v1.p1",9564,12137,21701,"2018/03/15","dbgap"
"4753","phs001493.v2.pht007296.v1.p1",44,24,68,"2020/01/10","dbgap"
"4754","phs001328.v1.pht006312.v1.p1",52,34,86,"05/17/2017","dbgap"
"4755","phs000128.v3.pht000469.v2.p3",2943,3500,6443,"04/29/2016","dbgap"
"4756","phs001259.v1.pht006090.v1.p1",726,1423,2149,"2019/04/23","dbgap"
"4757","phs000286.v6.pht001967.v2.p2",1293,2161,3454,"2019/03/11","dbgap"
"4758","phs000219.v1.pht001095.v1.p1",522,755,1277,"01/19/2010","dbgap"
"4760","phs000088.v1.pht000713.v1.p1",587,619,1206,"Tue Nov 18 09:14:40 2008","dbgap"
"4761","phs001290.v1.pht010334.v1.p1",3202,2867,6069,"2020/07/29","dbgap"
"4762","phs001387.v3.pht008969.v2.p1",1151,1178,2329,"2021/06/10","dbgap"
"4763","phs000782.v1.pht003992.v1.p1",15,1,16,"2017/10/04","dbgap"
"4764","phs001271.v1.pht006118.v1.p1",3208,2099,5307,"02/08/2017","dbgap"
"4765","phs001398.v1.pht007141.v1.p1",1734,256,1990,"2018/08/06","dbgap"
"4766","phs001279.v1.pht007212.v1.p1",12,12,24,"2017/12/08","dbgap"
"4767","phs000606.v1.pht007566.v1.p1",745,276,1021,"2018/03/09","dbgap"
"4768","phs000007.v32.pht000746.v7.p13",1316,1560,2876,"2020/12/21","dbgap"
"4769","phs000206.v5.pht000895.v4.p3",4813,4624,9437,"08/18/2015","dbgap"
"4770","phs001422.v2.pht006760.v2.p1",23,13,36,"2021/02/08","dbgap"
"4771","phs000939.v2.pht004790.v2.p1",13,7,20,"2017/08/31","dbgap"
"4772","phs002069.v1.pht010469.v1.p1",154,184,338,"2020/08/20","dbgap"
"4775","phs000285.v3.pht001687.v2.p2",48,47,95,"08/20/2013","dbgap"
"4776","phs000787.v1.pht004260.v1.p1",6,3,9,"09/23/2014","dbgap"
"4777","phs001630.v1.pht008172.v1.p1",1956,720,2676,"2020/06/26","dbgap"
"4779","phs000567.v1.pht003079.v1.p1",13,13,26,"12/17/2012","dbgap"
"4781","phs000908.v1.pht004706.v1.p1",211,219,430,"01/19/2016","dbgap"
"4782","phs000285.v3.pht001668.v2.p2",905,1014,1919,"08/20/2013","dbgap"
"4783","phs001682.v2.pht009764.v1.p1",220,212,432,"2021/08/06","dbgap"
"4784","phs000285.v3.pht001827.v2.p2",876,991,1867,"08/20/2013","dbgap"
"4785","phs000285.v3.pht001589.v2.p2",947,1065,2012,"08/20/2013","dbgap"
"4786","phs000007.v32.pht004806.v1.p13",206,281,487,"2020/12/21","dbgap"
"4787","phs001818.v3.pht009020.v2.p1",8,8,16,"2021/03/11","dbgap"
"4788","phs001109.v3.pht005446.v2.p2",1121,673,1794,"2020/02/28","dbgap"
"4789","phs001747.v1.pht008642.v1.p1",85,257,342,"2019/03/25","dbgap"
"4790","phs001795.v1.pht008953.v1.p1",27,35,62,"2019/06/24","dbgap"
"4791","phs000304.v3.pht001906.v2.p1",438,731,1169,"2018/05/03","dbgap"
"4792","phs001378.v1.pht006691.v1.p1",4,2,6,"2019/05/02","dbgap"
"4793","phs000128.v3.pht000420.v2.p3",2943,3500,6443,"04/29/2016","dbgap"
"4794","phs001852.v1.pht009276.v1.p1",225,192,417,"2019/07/26","dbgap"
"4795","phs000615.v1.pht003305.v1.p1",5703,5475,11178,"08/14/2014","dbgap"
"4796","phs000820.v1.pht004331.v1.p1",410,133,543,"11/13/2015","dbgap"
"4797","phs001488.v1.pht007394.v1.p1",260,293,553,"2018/02/08","dbgap"
"4799","phs001713.v1.pht008524.v1.p1",722,1352,2074,"2019/12/19","dbgap"
"4800","phs001238.v2.pht006655.v1.p1",701,879,1580,"2018/06/14","dbgap"
"4801","phs000437.v1.pht003689.v1.p1",4,8,12,"04/09/2014","dbgap"
"4803","phs000007.v32.pht000830.v2.p13",422,638,1060,"2020/12/21","dbgap"
"4804","phs001630.v1.pht008170.v1.p1",2021,784,2805,"2020/06/26","dbgap"
"4806","phs000994.v1.pht005062.v1.p1",12,7,19,"11/02/2015","dbgap"
"4807","phs002230.v1.pht010962.v1.p1",515,814,1329,"2021/02/23","dbgap"
"4809","phs001328.v1.pht006307.v1.p1",49,33,82,"05/17/2017","dbgap"
"4810","phs000285.v3.pht001768.v1.p2",7,6,13,"08/20/2013","dbgap"
"4811","phs000670.v1.pht003557.v1.p1",194,335,529,"01/22/2014","dbgap"
"4812","phs000421.v1.pht003233.v1.p1",728,1045,1773,"05/21/2013","dbgap"
"4814","phs000017.v3.pht000384.v1.p1",277,409,686,"Wed Nov 26 07:50:03 2008","dbgap"
"4815","phs001580.v1.pht008288.v1.p1",15,26,41,"2018/08/06","dbgap"
"4816","phs002020.v1.pht010229.v1.p1",438,352,790,"2020/05/26","dbgap"
"4817","phs000007.v32.pht002073.v4.p13",444,495,939,"2020/12/21","dbgap"
"4818","phs000673.v4.pht003662.v4.p1",731,557,1288,"2020/03/12","dbgap"
"4820","phs001786.v1.pht008837.v1.p1",17,19,36,"2019/08/01","dbgap"
"4821","phs000595.v1.pht006642.v1.p1",214,262,476,"07/05/2017","dbgap"
"4822","phs000280.v7.pht004052.v2.p1",6105,7373,13478,"2020/06/18","dbgap"
"4824","phs001201.v2.pht007559.v1.p1",19,22,41,"2019/08/18","dbgap"
"4825","phs000563.v1.pht003084.v1.p1",1,3,4,"06/28/2013","dbgap"
"4826","phs001247.v1.pht008298.v1.p1",451,448,899,"2018/08/13","dbgap"
"4827","phs000209.v13.pht002514.v1.p3",1697,1964,3661,"11/05/2014","dbgap"
"4828","phs000691.v2.pht003653.v1.p1",114,68,182,"12/12/2014","dbgap"
"4829","phs001884.v1.pht009639.v1.p1",81,273,354,"2019/11/27","dbgap"
"4831","phs000280.v7.pht006422.v1.p1",2332,3077,5409,"2020/06/18","dbgap"
"4832","phs001797.v1.pht008892.v1.p1",5,2,7,"2019/03/28","dbgap"
"4833","phs001867.v1.pht009351.v1.p1",8,9,17,"2019/08/05","dbgap"
"4834","phs001388.v2.pht006878.v2.p1",1230,2066,3296,"2021/03/05","dbgap"
"4835","phs000222.v6.pht002877.v3.p2",535,950,1485,"2019/08/01","dbgap"
"4837","phs000128.v3.pht000546.v2.p3",2943,3500,6443,"04/29/2016","dbgap"
"4838","phs001430.v2.pht008058.v2.p1",12,10,22,"2020/02/06","dbgap"
"4839","phs001305.v1.pht007102.v1.p1",5,7,12,"2017/11/01","dbgap"
"4840","phs000285.v3.pht001570.v2.p2",501,1065,1566,"08/20/2013","dbgap"
"4841","phs001912.v1.pht009622.v1.p1",72,8,80,"2020/10/14","dbgap"
"4842","phs000973.v1.pht004987.v1.p1",20,9,29,"11/16/2016","dbgap"
"4843","phs001947.v1.pht010136.v1.p1",15,8,23,"2020/04/14","dbgap"
"4845","phs001247.v1.pht008297.v1.p1",451,448,899,"2018/08/13","dbgap"
"4846","phs000524.v1.pht002918.v1.p1",1986,1612,3598,"12/27/2012","dbgap"
"4847","phs000607.v3.pht003447.v2.p2",4477,4790,9267,"2018/05/01","dbgap"
"4848","phs001238.v2.pht006662.v1.p1",535,704,1239,"2018/06/14","dbgap"
"4849","phs001030.v1.pht005090.v1.p1",187,201,388,"05/31/2017","dbgap"
"4850","phs000021.v3.pht002002.v1.p2",2786,2278,5064,"10/25/2010","dbgap"
"4851","phs000646.v1.pht003435.v1.p1",2,1,3,"08/06/2013","dbgap"
"4852","phs000594.v1.pht006503.v1.p1",6,3,9,"06/12/2017","dbgap"
"4853","phs000171.v1.pht000781.v1.p1",330,670,1000,"12/11/2009","dbgap"
"4854","phs000095.v4.pht001210.v3.p2",2090,2440,4530,"2021/09/13","dbgap"
"4855","phs001481.v1.pht008129.v1.p1",238,218,456,"2018/06/07","dbgap"
"4857","phs001164.v1.pht008871.v1.p1",22,19,41,"2019/03/25","dbgap"
"4858","phs001772.v2.pht008634.v2.p1",41,41,82,"2021/07/09","dbgap"
"4859","phs001457.v1.pht007055.v1.p1",14,38,52,"2018/04/12","dbgap"
"4860","phs001310.v1.pht006870.v1.p1",29,25,54,"2017/09/18","dbgap"
"4862","phs000337.v1.pht005334.v1.p1",56,38,94,"03/15/2016","dbgap"
"4863","phs001143.v4.pht005905.v3.p1",778,749,1527,"2021/06/01","dbgap"
"4864","phs000280.v7.pht004066.v2.p1",4804,5920,10724,"2020/06/18","dbgap"
"4865","phs000518.v1.pht002846.v1.p1",7,17,24,"08/17/2012","dbgap"
"4866","phs000595.v1.pht006637.v1.p1",286,329,615,"07/05/2017","dbgap"
"4867","phs001507.v1.pht008695.v1.p1",8,8,16,"2020/02/04","dbgap"
"4868","phs001406.v1.pht007748.v1.p1",1146,1747,2893,"2019/10/11","dbgap"
"4869","phs001406.v1.pht007752.v1.p1",6,7,13,"2019/10/11","dbgap"
"4871","phs001245.v1.pht005931.v1.p1",3,2,5,"2018/01/29","dbgap"
"4873","phs000589.v1.pht009193.v1.p1",9,127,136,"2019/06/14","dbgap"
"4874","phs000734.v1.pht003770.v1.p1",409,285,694,"04/04/2014","dbgap"
"4875","phs002045.v1.pht010308.v1.p1",9,6,15,"2020/06/30","dbgap"
"4876","phs000086.v3.pht000242.v1.p1",758,679,1437,"11/04/2014","dbgap"
"4877","phs001328.v1.pht006313.v1.p1",44,37,81,"05/17/2017","dbgap"
"4878","phs000285.v3.pht001681.v2.p2",906,1011,1917,"08/20/2013","dbgap"
"4879","phs001733.v1.pht008617.v1.p1",7,10,17,"2019/01/07","dbgap"
"4880","phs001979.v1.pht009999.v1.p1",5,2,7,"2020/03/19","dbgap"
"4882","phs000756.v1.pht007373.v1.p1",4392,4943,9335,"2018/12/27","dbgap"
"4883","phs001479.v1.pht008101.v1.p1",1,1,2,"2018/06/07","dbgap"
"4884","phs000182.v2.pht000797.v1.p1",1375,2028,3403,"08/06/2010","dbgap"
"4885","phs000290.v1.pht002276.v1.p1",16,78,94,"08/23/2011","dbgap"
"4886","phs001525.v1.pht007477.v1.p1",33,29,62,"2018/02/12","dbgap"
"4888","phs000776.v1.pht003950.v1.p1",7,26,33,"08/04/2014","dbgap"
"4889","phs000514.v1.pht002837.v1.p1",15,4,19,"08/15/2012","dbgap"
"4890","phs000951.v5.pht005050.v5.p5",5660,4987,10647,"2021/09/27","dbgap"
"4891","phs000180.v3.pht000790.v2.p2",2171,1895,4066,"05/20/2015","dbgap"
"4892","phs001490.v1.pht008138.v1.p1",1065,1522,2587,"2018/06/13","dbgap"
"4893","phs000007.v32.pht003901.v4.p13",1427,1736,3163,"2020/12/21","dbgap"
"4895","phs000546.v1.pht003142.v1.p1",40,35,75,"07/09/2013","dbgap"
"4896","phs001289.v1.pht007790.v1.p1",5,6,11,"2018/04/16","dbgap"
"4897","phs000796.v1.pht005387.v1.p1",1092,2012,3104,"05/17/2016","dbgap"
"4898","phs000353.v1.pht002248.v1.p1",2487,2524,5011,"08/08/2011","dbgap"
"4901","phs001238.v2.pht006050.v1.p1",432,1050,1482,"2018/06/14","dbgap"
"4902","phs002224.v1.pht010845.v1.p1",31,85,116,"2021/05/18","dbgap"
"4903","phs001848.v1.pht009205.v1.p1",1,2,3,"2019/06/24","dbgap"
"4904","phs001718.v1.pht009427.v1.p1",1240,855,2095,"2019/09/16","dbgap"
"4907","phs001780.v1.pht008711.v1.p1",379,316,695,"2019/02/11","dbgap"
"4909","phs000285.v3.pht001839.v2.p2",876,990,1866,"08/20/2013","dbgap"
"4911","phs001013.v3.pht005310.v2.p2",606,408,1014,"2017/11/13","dbgap"
"4912","phs000910.v1.pht004727.v1.p1",4063,3942,8005,"08/20/2015","dbgap"
"4913","phs001958.v1.pht009931.v1.p1",56,29,85,"2020/08/26","dbgap"
"4914","phs000727.v1.pht003864.v1.p1",116,95,211,"10/27/2014","dbgap"
"4916","phs001278.v1.pht006278.v1.p1",85,111,196,"06/16/2017","dbgap"
"4917","phs000827.v3.pht004469.v3.p1",241,351,592,"11/14/2016","dbgap"
"4920","phs000697.v1.pht007702.v1.p1",17,3,20,"2018/03/26","dbgap"
"4921","phs000842.v2.pht004403.v2.p1",994,586,1580,"2019/03/22","dbgap"
"4922","phs000126.v2.pht000385.v2.p1",1058,1041,2099,"08/29/2016","dbgap"
"4923","phs000007.v32.pht000908.v10.p13",1218,1107,2325,"2020/12/21","dbgap"
"4924","phs001980.v1.pht010077.v1.p1",4,1,5,"2020/12/22","dbgap"
"4925","phs001725.v2.pht010092.v1.p1",468,172,640,"2021/08/18","dbgap"
"4926","phs001289.v1.pht007785.v1.p1",13,11,24,"2018/04/16","dbgap"
"4927","phs000561.v1.pht003035.v1.p1",6,5,11,"11/05/2012","dbgap"
"4928","phs001994.v1.pht010008.v1.p1",46,15,61,"2020/04/14","dbgap"
"4929","phs000171.v1.pht000758.v1.p1",165,316,481,"12/11/2009","dbgap"
"4930","phs000086.v3.pht000262.v1.p1",761,680,1441,"11/04/2014","dbgap"
"4933","phs000286.v6.pht008783.v1.p2",942,1573,2515,"2019/03/11","dbgap"
"4934","phs000285.v3.pht001823.v2.p2",880,993,1873,"08/20/2013","dbgap"
"4936","phs000888.v1.pht005554.v1.p1",158,63,221,"08/12/2016","dbgap"
"4937","phs001749.v2.pht009317.v2.p1",911,1204,2115,"2021/05/14","dbgap"
"4938","phs000209.v13.pht003120.v3.p3",2771,2985,5756,"11/05/2014","dbgap"
"4939","phs000701.v1.pht005516.v1.p1",48,43,91,"06/01/2017","dbgap"
"4940","phs001074.v1.pht005343.v1.p1",115,135,250,"03/15/2016","dbgap"
"4943","phs000480.v1.pht002905.v1.p1",120,246,366,"2020/07/17","dbgap"
"4944","phs000815.v2.pht008405.v1.p1",114,148,262,"2020/02/03","dbgap"
"4945","phs000575.v2.pht005898.v2.p1",177,212,389,"2020/02/14","dbgap"
"4946","phs000595.v1.pht006634.v1.p1",286,328,614,"07/05/2017","dbgap"
"4947","phs001206.v1.pht007347.v1.p1",6,6,12,"2018/02/27","dbgap"
"4948","phs002197.v1.pht010611.v1.p1",9,7,16,"2020/11/17","dbgap"
"4949","phs001765.v1.pht008666.v1.p1",26,13,39,"2019/01/29","dbgap"
"4950","phs001108.v1.pht007714.v1.p1",10,36,46,"2018/03/30","dbgap"
"4951","phs000813.v1.pht004305.v1.p1",1168,1786,2954,"10/21/2015","dbgap"
"4953","phs000086.v3.pht000271.v1.p1",761,680,1441,"11/04/2014","dbgap"
"4954","phs001710.v1.pht011293.v1.p1",235,181,416,"2021/06/07","dbgap"
"4955","phs000681.v2.pht003871.v1.p1",859,1676,2535,"2019/05/03","dbgap"
"4956","phs001914.v1.pht009890.v1.p1",31,16,47,"2020/02/25","dbgap"
"4957","phs000007.v32.pht003634.v2.p13",379,312,691,"2020/12/21","dbgap"
"4958","phs001252.v1.pht006388.v1.p1",1685,1053,2738,"05/16/2017","dbgap"
"4959","phs002487.v1.pht011545.v1.p1",42,16,58,"2021/09/13","dbgap"
"4960","phs001299.v2.pht007621.v2.p1",1135,1317,2452,"2020/03/09","dbgap"
"4961","phs001901.v1.pht009500.v1.p1",901,567,1468,"2019/10/02","dbgap"
"4962","phs001158.v2.pht005594.v2.p1",11,10,21,"2019/02/05","dbgap"
"4963","phs000701.v1.pht005509.v1.p1",48,43,91,"06/01/2017","dbgap"
"4964","phs000521.v2.pht007047.v2.p1",2,4,6,"2020/03/13","dbgap"
"4965","phs001538.v1.pht008097.v1.p1",216,301,517,"2018/06/01","dbgap"
"4966","phs000962.v1.pht006965.v1.p1",157,149,306,"2017/10/02","dbgap"
"4970","phs001238.v2.pht006037.v1.p1",201,551,752,"2018/06/14","dbgap"
"4971","phs001191.v1.pht006226.v1.p1",312,588,900,"03/29/2017","dbgap"
"4972","phs000744.v4.pht003977.v4.p2",386,377,763,"08/01/2016","dbgap"
"4973","phs002015.v1.pht010385.v1.p1",828,986,1814,"2020/09/18","dbgap"
"4974","phs000263.v1.pht001428.v1.p1",40,54,94,"06/14/2010","dbgap"
"4975","phs001726.v2.pht009834.v2.p1",1401,1241,2642,"2021/09/24","dbgap"
"4976","phs000581.v1.pht003206.v1.p1",22,29,51,"06/04/2013","dbgap"
"4977","phs000755.v2.pht004993.v1.p1",34,27,61,"2019/01/04","dbgap"
"4979","phs000007.v32.pht000202.v8.p13",1705,1896,3601,"2020/12/21","dbgap"
"4980","phs000180.v3.pht000789.v2.p2",2171,1895,4066,"05/20/2015","dbgap"
"4981","phs002059.v1.pht010423.v1.p1",935,894,1829,"2020/12/18","dbgap"
"4983","phs002035.v1.pht010414.v1.p1",25,34,59,"2020/07/21","dbgap"
"4984","phs001109.v3.pht009221.v1.p2",1165,704,1869,"2020/02/28","dbgap"
"4985","phs000209.v13.pht002296.v2.p3",87,111,198,"11/05/2014","dbgap"
"4986","phs001432.v1.pht006977.v1.p1",4,2,6,"2017/10/05","dbgap"
"4987","phs000590.v1.pht008267.v1.p1",32,36,68,"2018/08/03","dbgap"
"4988","phs000007.v32.pht006023.v4.p13",7046,8098,15144,"2020/12/21","dbgap"
"4989","phs001211.v4.pht005754.v4.p3",6142,7501,13643,"2021/09/22","dbgap"
"4990","phs000228.v4.pht002158.v1.p1",149,151,300,"03/21/2017","dbgap"
"4992","phs000589.v1.pht009187.v1.p1",8,127,135,"2019/06/14","dbgap"
"4993","phs000592.v1.pht006585.v1.p1",71,33,104,"07/12/2017","dbgap"
"4996","phs000128.v3.pht000578.v2.p3",2943,3500,6443,"04/29/2016","dbgap"
"4997","phs001786.v1.pht008836.v1.p1",17,19,36,"2019/08/01","dbgap"
"4998","phs002068.v1.pht010872.v1.p1",807,637,1444,"2021/01/26","dbgap"
"4999","phs000100.v3.pht001126.v1.p1",944,762,1706,"04/11/2011","dbgap"
"5000","phs001984.v1.pht010782.v1.p1",706,388,1094,"2020/12/14","dbgap"
"5001","phs000280.v7.pht001440.v5.p1",7053,8623,15676,"2020/06/18","dbgap"
"5002","phs000335.v3.pht002115.v2.p2",2639,1555,4194,"07/25/2014","dbgap"
"5003","phs001286.v1.pht007888.v1.p1",10463,2691,13154,"2019/03/27","dbgap"
"5006","phs000287.v7.pht001483.v1.p1",2375,3156,5531,"2020/01/23","dbgap"
"5008","phs001488.v1.pht007427.v1.p1",260,293,553,"2018/02/08","dbgap"
"5009","phs001618.v1.pht008228.v1.p1",25,24,49,"2018/07/18","dbgap"
"5010","phs001754.v4.pht009109.v3.p2",3664,6253,9917,"2021/02/26","dbgap"
"5011","phs001270.v1.pht006250.v1.p1",5,9,14,"2017/10/04","dbgap"
"5012","phs001164.v1.pht008872.v1.p1",22,19,41,"2019/03/25","dbgap"
"5013","phs002230.v1.pht010963.v1.p1",233,543,776,"2021/02/23","dbgap"
"5014","phs000873.v1.pht004555.v1.p1",5,7,12,"03/13/2015","dbgap"
"5015","phs000551.v1.pht003063.v1.p1",387,207,594,"12/03/2013","dbgap"
"5016","phs001333.v2.pht006529.v2.p1",9,10,19,"2019/08/29","dbgap"
"5018","phs001293.v3.pht008895.v1.p1",774,1326,2100,"2021/06/09","dbgap"
"5020","phs000299.v2.pht001553.v2.p1",15,6,21,"02/27/2014","dbgap"
"5021","phs000171.v1.pht000787.v1.p1",636,1284,1920,"12/11/2009","dbgap"
"5022","phs000357.v2.pht002334.v1.p1",82,710,792,"2018/09/19","dbgap"
"5024","phs000620.v1.pht003892.v1.p1",3546,3831,7377,"03/03/2015","dbgap"
"5025","phs000285.v3.pht001631.v2.p2",909,1026,1935,"08/20/2013","dbgap"
"5026","phs000442.v1.pht002490.v1.p1",53,38,91,"04/12/2012","dbgap"
"5027","phs000401.v1.pht002474.v1.p1",153,54,207,"03/01/2012","dbgap"
"5028","phs000286.v6.pht001923.v2.p2",279,564,843,"2019/03/11","dbgap"
"5029","phs000007.v32.pht009750.v2.p13",1311,1558,2869,"2020/12/21","dbgap"
"5030","phs000280.v7.pht006425.v1.p1",1121,1407,2528,"2020/06/18","dbgap"
"5034","phs000974.v4.pht004911.v3.p3",1902,2253,4155,"2019/09/26","dbgap"
"5035","phs001288.v1.pht006767.v1.p1",62,41,103,"2017/10/19","dbgap"
"5036","phs001586.v1.pht008151.v1.p1",98,101,199,"2018/06/18","dbgap"
"5038","phs000222.v6.pht003448.v2.p2",413,696,1109,"2019/08/01","dbgap"
"5039","phs001584.v2.pht009069.v2.p2",48082,56838,104920,"2020/11/13","dbgap"
"5040","phs000007.v32.pht000206.v2.p13",1099,1514,2613,"2020/12/21","dbgap"
"5041","phs001238.v2.pht006041.v1.p1",573,1281,1854,"2018/06/14","dbgap"
"5042","phs001982.v1.pht010007.v1.p1",26,36,62,"2020/03/19","dbgap"
"5043","phs001623.v2.pht008364.v2.p1",30,11,41,"2019/10/31","dbgap"
"5044","phs001252.v1.pht006372.v1.p1",1691,1055,2746,"05/16/2017","dbgap"
"5045","phs000290.v1.pht002274.v1.p1",16,80,96,"08/23/2011","dbgap"
"5046","phs001538.v1.pht008095.v1.p1",222,317,539,"2018/06/01","dbgap"
"5047","phs001598.v2.pht009997.v1.p1",222,68,290,"2021/06/28","dbgap"
"5048","phs000673.v4.pht003663.v4.p1",731,557,1288,"2020/03/12","dbgap"
"5049","phs000285.v3.pht001871.v2.p2",31,27,58,"08/20/2013","dbgap"
"5050","phs001678.v1.pht008472.v1.p1",6,2,8,"2018/10/29","dbgap"
"5052","phs000128.v3.pht000532.v2.p3",2943,3500,6443,"04/29/2016","dbgap"
"5053","phs001427.v2.pht007486.v1.p1",13,4,17,"2021/01/26","dbgap"
"5054","phs000793.v1.pht004021.v1.p1",13,5,18,"09/12/2014","dbgap"
"5055","phs001525.v1.pht007476.v1.p1",33,29,62,"2018/02/12","dbgap"
"5056","phs000942.v1.pht004837.v1.p1",26,232,258,"03/01/2016","dbgap"
"5057","phs001286.v1.pht007890.v1.p1",10463,2691,13154,"2019/03/27","dbgap"
"5058","phs000280.v7.pht004163.v2.p1",5425,6639,12064,"2020/06/18","dbgap"
"5060","phs000425.v1.pht002501.v1.p1",1645,1302,2947,"03/06/2012","dbgap"
"5061","phs000222.v6.pht003449.v2.p2",413,696,1109,"2019/08/01","dbgap"
"5062","phs001178.v1.pht008549.v1.p1",149,150,299,"2018/11/19","dbgap"
"5063","phs000285.v3.pht001833.v2.p2",876,990,1866,"08/20/2013","dbgap"
"5065","phs000128.v3.pht000473.v2.p3",2943,3500,6443,"04/29/2016","dbgap"
"5066","phs001065.v1.pht005438.v1.p1",278,285,563,"05/24/2016","dbgap"
"5067","phs000128.v3.pht000448.v2.p3",2943,3500,6443,"04/29/2016","dbgap"
"5068","phs001572.v1.pht007840.v1.p1",195,117,312,"2018/04/20","dbgap"
"5069","phs000832.v1.pht004426.v1.p1",199,182,381,"03/31/2015","dbgap"
"5070","phs000354.v1.pht003347.v1.p1",18,28,46,"06/25/2013","dbgap"
"5072","phs001678.v1.pht008473.v1.p1",6,2,8,"2018/10/29","dbgap"
"5073","phs001381.v1.pht006566.v1.p1",352,315,667,"06/19/2017","dbgap"
"5074","phs000171.v1.pht000783.v1.p1",329,670,999,"12/11/2009","dbgap"
"5075","phs001164.v1.pht008868.v1.p1",22,19,41,"2019/03/25","dbgap"
"5076","phs000567.v1.pht003078.v1.p1",13,13,26,"12/17/2012","dbgap"
"5077","phs001419.v1.pht007091.v1.p1",265,268,533,"2017/12/04","dbgap"
"5079","phs000964.v5.pht004838.v1.p1",2407,3044,5451,"2021/05/12","dbgap"
"5080","phs000589.v1.pht009192.v1.p1",9,127,136,"2019/06/14","dbgap"
"5082","phs000291.v2.pht002269.v1.p1",214,123,337,"05/11/2012","dbgap"
"5083","phs001327.v2.pht011193.v1.p1",103,176,279,"2021/05/07","dbgap"
"5084","phs000588.v1.pht009289.v1.p1",1,1,2,"2019/07/26","dbgap"
"5086","phs000622.v1.pht003953.v1.p1",1559,1948,3507,"07/25/2014","dbgap"
"5087","phs000219.v1.pht001088.v1.p1",664,1052,1716,"01/19/2010","dbgap"
"5088","phs000101.v5.pht000186.v1.p1",175,101,276,"2018/08/19","dbgap"
"5089","phs001412.v3.pht006743.v2.p1",466,517,983,"2021/06/16","dbgap"
"5090","phs000280.v7.pht004112.v2.p1",6120,7410,13530,"2020/06/18","dbgap"
"5092","phs001976.v2.pht009901.v2.p1",4,8,12,"2020/03/31","dbgap"
"5093","phs000007.v32.pht004813.v2.p13",176,228,404,"2020/12/21","dbgap"
"5094","phs000285.v3.pht001652.v2.p2",909,1015,1924,"08/20/2013","dbgap"
"5095","phs000431.v2.pht004307.v1.p1",1075,444,1519,"02/20/2015","dbgap"
"5096","phs000250.v1.pht002187.v1.p1",196,155,351,"07/06/2011","dbgap"
"5097","phs000286.v6.pht001983.v6.p2",1271,2108,3379,"2019/03/11","dbgap"
"5098","phs000991.v1.pht005255.v1.p1",320,235,555,"01/21/2016","dbgap"
"5099","phs000869.v1.pht004611.v1.p1",5547,1376,6923,"03/19/2015","dbgap"
"5100","phs001191.v1.pht006225.v1.p1",312,588,900,"03/29/2017","dbgap"
"5101","phs001417.v1.pht007364.v1.p1",136,409,545,"2018/01/26","dbgap"
"5102","phs001688.v1.pht008591.v1.p1",23,12,35,"2018/12/06","dbgap"
"5103","phs000737.v1.pht004447.v1.p1",565,750,1315,"01/29/2015","dbgap"
"5104","phs001292.v2.pht007853.v2.p1",166,408,574,"2019/06/03","dbgap"
"5105","phs001514.v2.pht009814.v1.p1",211,234,445,"2021/06/28","dbgap"
"5106","phs000741.v2.pht003916.v2.p1",4251,4157,8408,"11/14/2016","dbgap"
"5107","phs001901.v1.pht009502.v1.p1",901,567,1468,"2019/10/02","dbgap"
"5108","phs000086.v3.pht000359.v1.p1",24,12,36,"11/04/2014","dbgap"
"5109","phs000568.v1.pht003110.v1.p1",8,9,17,"01/02/2013","dbgap"
"5110","phs000327.v1.pht003013.v1.p1",58,36,94,"03/22/2013","dbgap"
"5111","phs000658.v1.pht003498.v1.p1",493,945,1438,"01/13/2014","dbgap"
"5113","phs001342.v1.pht008050.v1.p1",30,16,46,"2018/06/01","dbgap"
"5114","phs001783.v2.pht008819.v2.p1",372,465,837,"2021/08/06","dbgap"
"5115","phs000182.v2.pht000796.v1.p1",1375,2028,3403,"08/06/2010","dbgap"
"5117","phs000286.v6.pht008758.v1.p2",695,1251,1946,"2019/03/11","dbgap"
"5118","phs000086.v3.pht000361.v1.p1",44,26,70,"11/04/2014","dbgap"
"5119","phs002361.v1.pht011068.v1.p1",1,1,2,"2021/03/18","dbgap"
"5120","phs001009.v1.pht005353.v1.p1",73,105,178,"03/28/2016","dbgap"
"5121","phs000478.v1.pht002656.v1.p1",7,6,13,"05/02/2012","dbgap"
"5122","phs001620.v1.pht008182.v1.p1",673,1338,2011,"2018/06/30","dbgap"
"5123","phs001464.v1.pht006970.v1.p1",9,5,14,"2017/10/03","dbgap"
"5124","phs000007.v32.pht002233.v6.p13",1579,1777,3356,"2020/12/21","dbgap"
"5127","phs001712.v1.pht008676.v1.p1",61,91,152,"2019/01/31","dbgap"
"5128","phs001619.v3.pht008178.v3.p1",210,215,425,"2021/03/10","dbgap"
"5130","phs000001.v3.pht000375.v2.p1",2098,2659,4757,"02/24/2012","dbgap"
"5131","phs001252.v1.pht006385.v1.p1",1258,713,1971,"05/16/2017","dbgap"
"5132","phs000222.v6.pht003451.v2.p2",413,696,1109,"2019/08/01","dbgap"
"5133","phs001313.v1.pht007974.v1.p1",1,4,5,"2018/05/17","dbgap"
"5134","phs001815.v1.pht009011.v1.p1",573,1064,1637,"2020/08/05","dbgap"
"5135","phs000219.v1.pht001089.v1.p1",3,5,8,"01/19/2010","dbgap"
"5136","phs000280.v7.pht004072.v2.p1",5413,6593,12006,"2020/06/18","dbgap"
"5137","phs000289.v2.pht001884.v1.p1",35,32,67,"05/26/2011","dbgap"
"5138","phs000365.v1.pht002265.v1.p1",3,1,4,"08/11/2011","dbgap"
"5139","phs001433.v1.pht006813.v1.p1",12,9,21,"2017/08/24","dbgap"
"5140","phs001485.v2.pht007188.v2.p1",11,13,24,"2021/03/10","dbgap"
"5141","phs000806.v1.pht004770.v1.p1",1315,653,1968,"01/15/2016","dbgap"
"5142","phs001655.v1.pht008257.v1.p1",35,47,82,"2018/08/06","dbgap"
"5143","phs002244.v1.pht010553.v1.p1",23,10,33,"2020/10/02","dbgap"
"5144","phs000007.v32.pht002893.v6.p13",1415,1723,3138,"2020/12/21","dbgap"
"5145","phs001890.v1.pht009547.v1.p1",10,7,17,"2020/05/01","dbgap"
"5147","phs001497.v2.pht007241.v2.p1",1819,1354,3173,"2021/09/08","dbgap"
"5148","phs001956.v1.pht009787.v1.p1",8,7,15,"2020/01/10","dbgap"
"5149","phs000918.v1.pht004748.v1.p1",6842,4560,11402,"06/10/2015","dbgap"
"5150","phs000280.v7.pht006427.v1.p1",2374,3175,5549,"2020/06/18","dbgap"
"5151","phs001936.v1.pht009646.v1.p1",2,7,9,"2020/01/21","dbgap"
"5152","phs001732.v2.pht010140.v1.p1",43,46,89,"2021/08/26","dbgap"
"5155","phs000701.v1.pht005523.v1.p1",48,43,91,"06/01/2017","dbgap"
"5156","phs000712.v1.pht003709.v1.p1",382,251,633,"09/25/2015","dbgap"
"5157","phs000961.v1.pht005330.v1.p1",1431,1634,3065,"03/07/2016","dbgap"
"5159","phs002298.v1.pht010761.v1.p1",359,36,395,"2020/12/09","dbgap"
"5161","phs000285.v3.pht001555.v3.p2",949,1064,2013,"08/20/2013","dbgap"
"5162","phs000409.v1.pht002736.v1.p1",63,27,90,"05/23/2012","dbgap"
"5163","phs000007.v32.pht009756.v2.p13",1415,1730,3145,"2020/12/21","dbgap"
"5164","phs001590.v2.pht007893.v2.p1",9873,12975,22848,"2021/04/08","dbgap"
"5165","phs002238.v1.pht011519.v1.p1",121,81,202,"2021/10/04","dbgap"
"5168","phs002015.v1.pht010374.v1.p1",27,17,44,"2020/09/18","dbgap"
"5169","phs001466.v2.pht009577.v1.p1",425,409,834,"2021/06/25","dbgap"
"5171","phs000592.v1.pht006583.v1.p1",106,87,193,"07/12/2017","dbgap"
"5172","phs000007.v32.pht002154.v6.p13",1971,2297,4268,"2020/12/21","dbgap"
"5175","phs000142.v1.pht000889.v1.p1",590,2402,2992,"07/21/2009","dbgap"
"5176","phs001479.v1.pht008104.v1.p1",1,1,2,"2018/06/07","dbgap"
"5177","phs000086.v3.pht000226.v1.p1",725,658,1383,"11/04/2014","dbgap"
"5178","phs000313.v4.pht002064.v4.p2",2292,2426,4718,"2017/11/22","dbgap"
"5179","phs001233.v1.pht005946.v1.p1",3,3,6,"11/21/2016","dbgap"
"5180","phs000007.v32.pht005162.v3.p13",1442,1537,2979,"2020/12/21","dbgap"
"5181","phs001929.v1.pht010013.v1.p1",325,275,600,"2020/03/26","dbgap"
"5182","phs000285.v3.pht001814.v2.p2",304,445,749,"08/20/2013","dbgap"
"5184","phs000239.v2.pht001219.v1.p1",5,7,12,"07/21/2010","dbgap"
"5186","phs000001.v3.pht000381.v2.p1",1338,1857,3195,"02/24/2012","dbgap"
"5187","phs002276.v1.pht011555.v1.p1",12,3,15,"2021/10/06","dbgap"
"5188","phs000662.v1.pht003561.v1.p1",299,342,641,"12/17/2013","dbgap"
"5189","phs000286.v6.pht001974.v2.p2",1294,2158,3452,"2019/03/11","dbgap"
"5190","phs001024.v5.pht005117.v2.p1",84,44,128,"2021/05/20","dbgap"
"5191","phs001427.v2.pht007487.v2.p1",13,4,17,"2021/01/26","dbgap"
"5192","phs000128.v3.pht000579.v2.p3",2943,3500,6443,"04/29/2016","dbgap"
"5193","phs001608.v2.pht009733.v1.p1",290,352,642,"2021/09/29","dbgap"
"5194","phs000589.v1.pht009194.v1.p1",9,127,136,"2019/06/14","dbgap"
"5195","phs000285.v3.pht001751.v2.p2",138,130,268,"08/20/2013","dbgap"
"5196","phs000698.v1.pht007681.v1.p1",18,32,50,"2018/03/23","dbgap"
"5197","phs000343.v3.pht002722.v1.p1",1233,713,1946,"03/12/2013","dbgap"
"5198","phs000421.v1.pht003232.v1.p1",2134,3255,5389,"05/21/2013","dbgap"
"5199","phs000806.v1.pht004771.v1.p1",1315,653,1968,"01/15/2016","dbgap"
"5201","phs000125.v1.pht000634.v1.p1",1025,888,1913,"Thu Oct  2 11:13:21 2008","dbgap"
"5203","phs000564.v2.pht003058.v2.p1",141,137,278,"07/09/2015","dbgap"
"5204","phs001382.v1.pht006975.v1.p1",113,354,467,"2017/10/03","dbgap"
"5205","phs001794.v1.pht008906.v1.p1",6,6,12,"2019/03/28","dbgap"
"5207","phs000094.v1.pht001135.v1.p1",1498,1001,2499,"04/12/2010","dbgap"
"5209","phs000572.v8.pht003392.v7.p4",4800,6682,11482,"2019/11/19","dbgap"
"5210","phs000007.v32.pht000100.v8.p13",1726,1868,3594,"2020/12/21","dbgap"
"5211","phs001403.v1.pht006840.v1.p1",7,14,21,"2017/09/12","dbgap"
"5212","phs000285.v3.pht001609.v2.p2",30,55,85,"08/20/2013","dbgap"
"5213","phs001252.v1.pht006405.v1.p1",1691,1055,2746,"05/16/2017","dbgap"
"5214","phs000280.v7.pht004208.v2.p1",6616,7960,14576,"2020/06/18","dbgap"
"5215","phs000285.v3.pht001826.v2.p2",880,993,1873,"08/20/2013","dbgap"
"5216","phs001238.v2.pht006047.v1.p1",432,1050,1482,"2018/06/14","dbgap"
"5217","phs002317.v1.pht011164.v1.p1",232,183,415,"2021/05/04","dbgap"
"5218","phs000187.v1.pht000815.v1.p1",1861,1340,3201,"04/23/2010","dbgap"
"5219","phs000454.v1.pht002650.v1.p1",2420,806,3226,"06/17/2013","dbgap"
"5220","phs000589.v1.pht009183.v1.p1",9,127,136,"2019/06/14","dbgap"
"5222","phs000753.v1.pht003875.v1.p1",1302,988,2290,"06/05/2014","dbgap"
"5223","phs001748.v1.pht008574.v1.p1",7,14,21,"2021/02/04","dbgap"
"5224","phs000974.v4.pht004910.v4.p3",1902,2253,4155,"2019/09/26","dbgap"
"5225","phs000584.v1.pht010797.v1.p1",884,1250,2134,"2021/01/27","dbgap"
"5227","phs001316.v1.pht008004.v1.p1",2,1,3,"2018/05/31","dbgap"
"5228","phs000166.v2.pht000700.v1.p1",500,313,813,"09/03/2009","dbgap"
"5229","phs000438.v1.pht003321.v1.p1",341,380,721,"04/18/2014","dbgap"
"5230","phs000280.v7.pht001441.v7.p1",6744,8360,15104,"2020/06/18","dbgap"
"5231","phs000405.v1.pht002609.v1.p1",6,7,13,"11/15/2012","dbgap"
"5233","phs000280.v7.pht004137.v2.p1",513,465,978,"2020/06/18","dbgap"
"5234","phs001474.v1.pht007154.v1.p1",9,9,18,"2017/11/30","dbgap"
"5235","phs001467.v2.pht009729.v2.p2",1706,3165,4871,"2021/08/10","dbgap"
"5236","phs001396.v1.pht006735.v1.p1",749,821,1570,"2018/05/14","dbgap"
"5237","phs000583.v1.pht003296.v1.p1",860,756,1616,"03/21/2014","dbgap"
"5238","phs001743.v1.pht008921.v1.p1",23,3,26,"2019/03/28","dbgap"
"5239","phs000267.v5.pht002302.v2.p2",4901,2979,7880,"03/02/2016","dbgap"
"5240","phs001969.v1.pht009936.v1.p1",14,6,20,"2020/03/04","dbgap"
"5241","phs001135.v2.pht005986.v1.p1",685,293,978,"2020/03/09","dbgap"
"5242","phs001281.v2.pht006128.v2.p1",15,25,40,"2019/02/21","dbgap"
"5243","phs000128.v3.pht000554.v2.p3",2943,3500,6443,"04/29/2016","dbgap"
"5246","phs001110.v3.pht006512.v2.p1",306,288,594,"2020/09/08","dbgap"
"5247","phs001515.v2.pht009564.v2.p2",6402,2702,9104,"2021/09/09","dbgap"
"5248","phs001828.v1.pht009367.v1.p1",799,593,1392,"2019/08/01","dbgap"
"5249","phs000286.v6.pht008741.v1.p2",727,1267,1994,"2019/03/11","dbgap"
"5250","phs002015.v1.pht010370.v1.p1",1812,2385,4197,"2020/09/18","dbgap"
"5251","phs000007.v32.pht002570.v4.p13",1091,900,1991,"2020/12/21","dbgap"
"5252","phs001729.v2.pht010127.v1.p1",11,8,19,"2021/08/26","dbgap"
"5253","phs001233.v1.pht005945.v1.p1",3,3,6,"11/21/2016","dbgap"
"5254","phs000682.v1.pht003596.v1.p1",103,59,162,"11/25/2013","dbgap"
"5256","phs001494.v1.pht007193.v1.p1",730,410,1140,"2018/03/08","dbgap"
"5257","phs000343.v3.pht002720.v1.p1",1379,785,2164,"03/12/2013","dbgap"
"5258","phs001065.v1.pht005407.v1.p1",296,313,609,"05/24/2016","dbgap"
"5259","phs000280.v7.pht004210.v2.p1",1446,2,1448,"2020/06/18","dbgap"
"5260","phs000007.v32.pht003782.v2.p13",533,541,1074,"2020/12/21","dbgap"
"5261","phs002188.v1.pht011034.v1.p1",5,5,10,"2021/03/22","dbgap"
"5264","phs001296.v2.pht006357.v2.p1",11,30,41,"2019/05/31","dbgap"
"5265","phs001576.v2.pht008222.v2.p2",27,14,41,"2019/09/27","dbgap"
"5266","phs000128.v3.pht000535.v2.p3",2943,3500,6443,"04/29/2016","dbgap"
"5267","phs001218.v3.pht005960.v1.p1",736,1047,1783,"2021/06/08","dbgap"
"5268","phs001317.v1.pht008046.v1.p1",23,27,50,"2018/06/01","dbgap"
"5269","phs001325.v3.pht006351.v2.p1",121,152,273,"2019/11/22","dbgap"
"5270","phs000612.v1.pht003527.v1.p1",25,35,60,"05/23/2014","dbgap"
"5271","phs000018.v2.pht004357.v1.p1",835,972,1807,"12/16/2014","dbgap"
"5272","phs000286.v6.pht001920.v5.p2",2409,3046,5455,"2019/03/11","dbgap"
"5274","phs001684.v1.pht008389.v1.p1",16,18,34,"2018/09/19","dbgap"
"5275","phs000670.v1.pht003554.v1.p1",194,335,529,"01/22/2014","dbgap"
"5276","phs000128.v3.pht000573.v2.p3",2943,3500,6443,"04/29/2016","dbgap"
"5277","phs001328.v1.pht006306.v1.p1",9,8,17,"05/17/2017","dbgap"
"5279","phs000007.v32.pht006018.v2.p13",532,583,1115,"2020/12/21","dbgap"
"5280","phs002059.v1.pht010422.v1.p1",1084,953,2037,"2020/12/18","dbgap"
"5281","phs001503.v1.pht007314.v1.p1",12,870,882,"2018/01/04","dbgap"
"5282","phs000293.v1.pht003366.v1.p1",904,1603,2507,"07/25/2013","dbgap"
"5283","phs000606.v1.pht007569.v1.p1",726,257,983,"2018/03/09","dbgap"
"5284","phs001961.v1.pht011030.v1.p1",6,4,10,"2021/06/03","dbgap"
"5285","phs001273.v3.pht006172.v3.p2",23125,13760,36885,"2019/10/10","dbgap"
"5287","phs000595.v1.pht006633.v1.p1",287,330,617,"07/05/2017","dbgap"
"5289","phs000343.v3.pht002215.v1.p1",1379,785,2164,"03/12/2013","dbgap"
"5290","phs001564.v3.pht007991.v3.p1",49,41,90,"2020/02/13","dbgap"
"5291","phs001406.v1.pht007751.v1.p1",6,7,13,"2019/10/11","dbgap"
"5292","phs000424.v8.pht002740.v8.p2",655,327,982,"2019/05/30","dbgap"
"5294","phs001366.v1.pht006576.v1.p1",3,9,12,"2017/12/04","dbgap"
"5295","phs000541.v1.pht003048.v1.p1",2,5,7,"11/29/2012","dbgap"
"5296","phs000775.v1.pht003945.v1.p1",497,362,859,"07/18/2014","dbgap"
"5298","phs000222.v6.pht007352.v1.p2",79,105,184,"2019/08/01","dbgap"
"5299","phs001852.v1.pht009277.v1.p1",212,187,399,"2019/07/26","dbgap"
"5300","phs001017.v1.pht005075.v1.p1",79,1680,1759,"2021/07/02","dbgap"
"5302","phs002437.v1.pht011432.v1.p1",8,9,17,"2021/07/29","dbgap"
"5304","phs000793.v1.pht004023.v1.p1",13,5,18,"09/12/2014","dbgap"
"5305","phs001597.v1.pht008124.v1.p1",38,24,62,"2019/03/22","dbgap"
"5306","phs001600.v2.pht011022.v2.p2",653,618,1271,"2021/07/15","dbgap"
"5307","phs000598.v2.pht003325.v2.p2",42,9,51,"10/28/2013","dbgap"
"5308","phs001027.v4.pht005217.v3.p1",94,61,155,"2021/06/23","dbgap"
"5309","phs002088.v2.pht010652.v1.p1",22,18,40,"2021/06/16","dbgap"
"5310","phs000590.v1.pht008277.v1.p1",26,28,54,"2018/08/03","dbgap"
"5311","phs000309.v2.pht001999.v2.p2",903,1023,1926,"10/19/2011","dbgap"
"5313","phs000007.v32.pht000101.v8.p13",1491,1662,3153,"2020/12/21","dbgap"
"5314","phs000285.v3.pht001856.v2.p2",304,440,744,"08/20/2013","dbgap"
"5316","phs000128.v3.pht000507.v2.p3",2943,3500,6443,"04/29/2016","dbgap"
"5317","phs001012.v1.pht005551.v1.p1",549,628,1177,"06/22/2016","dbgap"
"5318","phs001333.v2.pht006525.v2.p1",9,10,19,"2019/08/29","dbgap"
"5319","phs001434.v2.pht009859.v1.p1",47,18,65,"2021/06/23","dbgap"
"5320","phs001620.v1.pht008181.v1.p1",692,1360,2052,"2018/06/30","dbgap"
"5321","phs000128.v3.pht000489.v2.p3",2943,3500,6443,"04/29/2016","dbgap"
"5323","phs001488.v1.pht007377.v1.p1",241,270,511,"2018/02/08","dbgap"
"5324","phs001807.v1.pht008977.v1.p1",54,33,87,"2019/06/11","dbgap"
"5325","phs000209.v13.pht001110.v8.p3",3866,4521,8387,"11/05/2014","dbgap"
"5326","phs001758.v1.pht008611.v1.p1",2,8,10,"2018/12/31","dbgap"
"5327","phs000091.v2.pht000115.v2.p1",2604,3429,6033,"08/24/2009","dbgap"
"5328","phs001279.v1.pht007218.v1.p1",8,16,24,"2017/12/08","dbgap"
"5330","phs000287.v7.pht001472.v1.p1",2375,3156,5531,"2020/01/23","dbgap"
"5331","phs001998.v1.pht010503.v1.p1",4,6,10,"2021/06/07","dbgap"
"5332","phs001513.v1.pht007356.v1.p1",71,38,109,"2018/01/18","dbgap"
"5333","phs000280.v7.pht004035.v2.p1",4883,6019,10902,"2020/06/18","dbgap"
"5335","phs001210.v1.pht005963.v1.p1",2501,2834,5335,"11/30/2016","dbgap"
"5337","phs000374.v1.pht002356.v1.p1",4,3,7,"08/31/2011","dbgap"
"5338","phs000086.v3.pht000626.v1.p1",24,36,60,"11/04/2014","dbgap"
"5339","phs000220.v2.pht006616.v1.p2",9725,11407,21132,"2018/06/11","dbgap"
"5341","phs001084.v1.pht005328.v1.p1",8,10,18,"03/07/2016","dbgap"
"5342","phs001392.v1.pht006901.v1.p1",1,1,2,"2017/09/22","dbgap"
"5343","phs000209.v13.pht003605.v1.p3",2813,3040,5853,"11/05/2014","dbgap"
"5345","phs000286.v6.pht008790.v1.p2",938,1570,2508,"2019/03/11","dbgap"
"5346","phs000594.v1.pht006492.v1.p1",5,3,8,"06/12/2017","dbgap"
"5347","phs000019.v1.pht000064.v1.p1",638,788,1426,"Thu Jan 17 21:45:39 2008","dbgap"
"5348","phs000589.v1.pht009195.v1.p1",9,127,136,"2019/06/14","dbgap"
"5350","phs000128.v3.pht000523.v2.p3",2943,3500,6443,"04/29/2016","dbgap"
"5351","phs000280.v7.pht004034.v2.p1",5440,6657,12097,"2020/06/18","dbgap"
"5352","phs001554.v1.pht007609.v1.p1",1075,1817,2892,"2018/03/09","dbgap"
"5353","phs001289.v1.pht007797.v1.p1",16,13,29,"2018/04/16","dbgap"
"5354","phs000766.v1.pht003941.v1.p1",2383,2371,4754,"03/26/2015","dbgap"
"5355","phs002446.v1.pht011403.v1.p1",3,9,12,"2021/07/21","dbgap"
"5356","phs000280.v7.pht004147.v2.p1",6784,8156,14940,"2020/06/18","dbgap"
"5357","phs000285.v3.pht001835.v2.p2",880,993,1873,"08/20/2013","dbgap"
"5358","phs001370.v1.pht006646.v1.p1",28,21,49,"07/06/2017","dbgap"
"5359","phs002105.v1.pht010706.v1.p1",69,150,219,"2020/12/01","dbgap"
"5360","phs000286.v6.pht008775.v1.p2",931,1562,2493,"2019/03/11","dbgap"
"5361","phs000911.v1.pht004979.v1.p1",3375,3294,6669,"05/06/2016","dbgap"
"5362","phs001448.v1.pht007029.v1.p1",27,31,58,"2017/10/19","dbgap"
"5363","phs001903.v1.pht009893.v1.p1",18421,19016,37437,"2020/09/03","dbgap"
"5364","phs000579.v1.pht003279.v1.p1",26,25,51,"11/04/2013","dbgap"
"5365","phs001488.v1.pht007430.v1.p1",260,293,553,"2018/02/08","dbgap"
"5366","phs001817.v1.pht009133.v1.p1",85,177,262,"2019/06/04","dbgap"
"5368","phs000238.v1.pht002008.v1.p1",2300,2753,5053,"11/15/2013","dbgap"
"5369","phs001488.v1.pht007429.v1.p1",260,293,553,"2018/02/08","dbgap"
"5370","phs001803.v1.pht008937.v1.p1",223,696,919,"2019/04/04","dbgap"
"5371","phs000779.v1.pht003961.v1.p1",1193,1209,2402,"07/25/2014","dbgap"
"5372","phs001538.v1.pht008090.v1.p1",102,133,235,"2018/06/01","dbgap"
"5373","phs001357.v1.pht006699.v1.p1",41,33,74,"07/26/2017","dbgap"
"5374","phs001741.v1.pht009166.v1.p1",573,332,905,"2020/01/07","dbgap"
"5375","phs001073.v2.pht005953.v2.p1",18,47,65,"2020/12/18","dbgap"
"5377","phs002037.v1.pht010267.v1.p1",126,112,238,"2020/06/10","dbgap"
"5378","phs001774.v1.pht008805.v1.p1",22,28,50,"2020/02/27","dbgap"
"5379","phs000410.v1.pht002449.v1.p1",30,135,165,"03/11/2014","dbgap"
"5380","phs000128.v3.pht000560.v2.p3",2943,3500,6443,"04/29/2016","dbgap"
"5381","phs001647.v1.pht008199.v1.p1",331,183,514,"2018/08/19","dbgap"
"5383","phs001864.v1.pht009263.v1.p1",13,9,22,"2019/07/25","dbgap"
"5384","phs001389.v1.pht006604.v1.p1",6,7,13,"06/27/2017","dbgap"
"5386","phs000343.v3.pht002725.v1.p1",114,74,188,"03/12/2013","dbgap"
"5387","phs001001.v1.pht005655.v1.p1",811,214,1025,"2018/02/28","dbgap"
"5388","phs000285.v3.pht001679.v2.p2",198,251,449,"08/20/2013","dbgap"
"5389","phs000358.v1.pht002243.v1.p1",763,620,1383,"05/23/2011","dbgap"
"5390","phs000621.v1.pht003331.v1.p1",149,66,215,"07/09/2013","dbgap"
"5391","phs000558.v1.pht006228.v1.p1",91,84,175,"03/31/2017","dbgap"
"5392","phs000128.v3.pht000524.v2.p3",2943,3500,6443,"04/29/2016","dbgap"
"5394","phs001981.v1.pht010700.v1.p1",32,16,48,"2020/12/16","dbgap"
"5395","phs002259.v1.pht011025.v1.p1",5,20,25,"2021/05/28","dbgap"
"5396","phs000017.v3.pht000291.v1.p1",559,522,1081,"Wed Nov 26 07:45:09 2008","dbgap"
"5397","phs000952.v1.pht005321.v1.p1",1540,1332,2872,"03/10/2016","dbgap"
"5399","phs001617.v1.pht010618.v1.p1",105,89,194,"2021/01/12","dbgap"
"5401","phs000518.v1.pht002847.v1.p1",7,17,24,"08/17/2012","dbgap"
"5402","phs000138.v2.pht000619.v2.p1",766,2257,3023,"06/01/2010","dbgap"
"5403","phs001318.v1.pht008018.v1.p1",27,13,40,"2018/05/31","dbgap"
"5404","phs000007.v32.pht000390.v2.p13",1087,1488,2575,"2020/12/21","dbgap"
"5405","phs000553.v1.pht003131.v1.p1",1,4,5,"06/26/2013","dbgap"
"5406","phs000565.v1.pht003076.v1.p1",121,71,192,"12/06/2012","dbgap"
"5407","phs000285.v3.pht001620.v2.p2",8,35,43,"08/20/2013","dbgap"
"5408","phs000550.v1.pht003127.v1.p1",2,1,3,"01/18/2013","dbgap"
"5409","phs001710.v1.pht011291.v1.p1",235,181,416,"2021/06/07","dbgap"
"5410","phs000007.v32.pht005155.v3.p13",1306,1325,2631,"2020/12/21","dbgap"
"5411","phs000542.v1.pht003015.v1.p1",2,2,4,"10/24/2012","dbgap"
"5412","phs001782.v2.pht008799.v2.p1",330,472,802,"2021/07/02","dbgap"
"5413","phs000128.v3.pht000516.v2.p3",2943,3500,6443,"04/29/2016","dbgap"
"5414","phs000360.v3.pht003253.v2.p1",4448,5427,9875,"08/05/2016","dbgap"
"5415","phs001616.v2.pht008543.v2.p2",11472,13446,24918,"2020/10/27","dbgap"
"5416","phs001771.v1.pht008715.v1.p1",163,280,443,"2021/02/12","dbgap"
"5417","phs001007.v1.pht005069.v1.p1",19,4,23,"11/30/2015","dbgap"
"5418","phs000274.v1.pht001278.v1.p1",742,1558,2300,"11/28/2011","dbgap"
"5419","phs001737.v2.pht008561.v2.p1",2,1,3,"2019/09/18","dbgap"
"5420","phs001590.v2.pht007894.v2.p1",9873,12975,22848,"2021/04/08","dbgap"
"5422","phs001727.v2.pht010100.v1.p1",29,44,73,"2021/08/26","dbgap"
"5423","phs001180.v2.pht006988.v1.p1",2196,2266,4462,"2020/06/29","dbgap"
"5426","phs000482.v1.pht002882.v1.p1",350,267,617,"12/07/2015","dbgap"
"5427","phs001933.v1.pht011514.v1.p1",89,24,113,"2021/08/30","dbgap"
"5428","phs000578.v1.pht007011.v1.p1",49,43,92,"2017/10/11","dbgap"
"5429","phs000280.v7.pht004237.v2.p1",5438,6639,12077,"2020/06/18","dbgap"
"5430","phs000285.v3.pht001810.v2.p2",880,993,1873,"08/20/2013","dbgap"
"5431","phs000007.v32.pht002072.v7.p13",1577,1777,3354,"2020/12/21","dbgap"
"5432","phs000862.v1.pht007837.v1.p1",1,4,5,"2018/04/16","dbgap"
"5433","phs000285.v3.pht001560.v2.p2",947,1065,2012,"08/20/2013","dbgap"
"5435","phs000574.v1.pht005864.v1.p1",4,24,28,"03/06/2017","dbgap"
"5436","phs000549.v1.pht002993.v1.p1",1,5,6,"09/28/2012","dbgap"
"5437","phs001309.v1.pht007913.v1.p1",26,20,46,"2018/05/15","dbgap"
"5438","phs000575.v2.pht005896.v2.p1",157,187,344,"2020/02/14","dbgap"
"5439","phs000086.v3.pht000353.v1.p1",86,124,210,"11/04/2014","dbgap"
"5441","phs001890.v1.pht009545.v1.p1",10,7,17,"2020/05/01","dbgap"
"5442","phs001584.v2.pht009216.v2.p2",45,47,92,"2020/11/13","dbgap"
"5443","phs000343.v3.pht003156.v1.p1",1379,785,2164,"03/12/2013","dbgap"
"5444","phs000285.v3.pht001850.v2.p2",166,196,362,"08/20/2013","dbgap"
"5445","phs001998.v1.pht010504.v1.p1",4,6,10,"2021/06/07","dbgap"
"5447","phs000343.v3.pht002212.v1.p1",8,10,18,"03/12/2013","dbgap"
"5448","phs000494.v1.pht002801.v1.p1",2543,2019,4562,"07/19/2012","dbgap"
"5449","phs001900.v1.pht009633.v1.p1",123,96,219,"2020/03/02","dbgap"
"5450","phs001065.v1.pht005431.v1.p1",296,313,609,"05/24/2016","dbgap"
"5451","phs001468.v3.pht009553.v1.p1",1298,1450,2748,"2021/09/23","dbgap"
"5452","phs002292.v1.pht011106.v1.p1",11,12,23,"2021/04/09","dbgap"
"5453","phs001564.v3.pht007992.v3.p1",49,41,90,"2020/02/13","dbgap"
"5455","phs000128.v3.pht000493.v2.p3",2943,3500,6443,"04/29/2016","dbgap"
"5456","phs000711.v7.pht003723.v6.p2",1239,1193,2432,"2021/03/24","dbgap"
"5459","phs000007.v32.pht000163.v8.p13",1349,1388,2737,"2020/12/21","dbgap"
"5460","phs000588.v1.pht009297.v1.p1",35,134,169,"2019/07/26","dbgap"
"5461","phs000751.v1.pht003869.v1.p1",1090,526,1616,"05/30/2014","dbgap"
"5462","phs001024.v5.pht005118.v2.p1",84,44,128,"2021/05/20","dbgap"
"5463","phs000285.v3.pht001745.v2.p2",873,956,1829,"08/20/2013","dbgap"
"5464","phs000606.v1.pht007574.v1.p1",745,276,1021,"2018/03/09","dbgap"
"5465","phs002484.v1.pht011399.v1.p1",49,37,86,"2021/07/14","dbgap"
"5466","phs001664.v1.pht008440.v1.p1",827,392,1219,"2018/10/02","dbgap"
"5467","phs001329.v2.pht007180.v2.p1",1,4,5,"2019/05/07","dbgap"
"5468","phs000128.v3.pht000522.v2.p3",2943,3500,6443,"04/29/2016","dbgap"
"5469","phs000171.v1.pht000770.v1.p1",636,1282,1918,"12/11/2009","dbgap"
"5470","phs001317.v1.pht008047.v1.p1",25,34,59,"2018/06/01","dbgap"
"5471","phs000574.v1.pht005869.v1.p1",41,960,1001,"03/06/2017","dbgap"
"5472","phs001289.v1.pht007798.v1.p1",12,11,23,"2018/04/16","dbgap"
"5473","phs001310.v1.pht006869.v1.p1",29,25,54,"2017/09/18","dbgap"
"5474","phs000007.v32.pht002430.v4.p13",1580,1791,3371,"2020/12/21","dbgap"
"5475","phs000839.v1.pht004390.v1.p1",1,2,3,"12/01/2014","dbgap"
"5476","phs000086.v3.pht000267.v1.p1",760,678,1438,"11/04/2014","dbgap"
"5477","phs002002.v1.pht010191.v1.p1",6,2,8,"2020/04/27","dbgap"
"5478","phs000578.v1.pht007012.v1.p1",49,44,93,"2017/10/11","dbgap"
"5479","phs000019.v1.pht000181.v1.p1",638,788,1426,"Thu Jan 17 21:45:42 2008","dbgap"
"5480","phs000205.v6.pht001430.v6.p2",21065,14622,35687,"06/13/2016","dbgap"
"5481","phs000492.v3.pht002708.v3.p2",52,55,107,"2018/10/19","dbgap"
"5482","phs001749.v2.pht009319.v2.p1",911,1204,2115,"2021/05/14","dbgap"
"5483","phs001311.v1.pht007924.v1.p1",34,26,60,"2018/05/15","dbgap"
"5484","phs000144.v1.pht000725.v1.p1",165,216,381,"Wed Jan 21 13:20:49 2009","dbgap"
"5485","phs001876.v1.pht009388.v1.p1",611,405,1016,"2019/08/10","dbgap"
"5486","phs000128.v3.pht000494.v2.p3",2943,3500,6443,"04/29/2016","dbgap"
"5487","phs000128.v3.pht000553.v2.p3",2943,3500,6443,"04/29/2016","dbgap"
"5489","phs000603.v1.pht007551.v1.p1",4,9,13,"2018/03/06","dbgap"
"5491","phs001270.v1.pht006253.v1.p1",3,7,10,"2017/10/04","dbgap"
"5493","phs000252.v2.pht001268.v2.p1",7,4,11,"03/07/2011","dbgap"
"5494","phs000007.v32.pht000088.v7.p13",1054,1245,2299,"2020/12/21","dbgap"
"5495","phs001309.v1.pht007916.v1.p1",51,54,105,"2018/05/15","dbgap"
"5496","phs000180.v3.pht000792.v2.p2",2152,1886,4038,"05/20/2015","dbgap"
"5498","phs000086.v3.pht000217.v1.p1",756,677,1433,"11/04/2014","dbgap"
"5499","phs000007.v32.pht009758.v2.p13",871,1085,1956,"2020/12/21","dbgap"
"5500","phs000196.v3.pht000876.v1.p1",2150,1899,4049,"03/24/2015","dbgap"
"5501","phs000777.v1.pht003971.v1.p1",4,6,10,"08/20/2014","dbgap"
"5502","phs001515.v2.pht009566.v2.p2",6402,2702,9104,"2021/09/09","dbgap"
"5503","phs000128.v3.pht000598.v2.p3",2943,3500,6443,"04/29/2016","dbgap"
"5504","phs000196.v3.pht000877.v2.p1",2147,1899,4046,"03/24/2015","dbgap"
"5505","phs000285.v3.pht001695.v2.p2",900,1000,1900,"08/20/2013","dbgap"
"5506","phs000335.v3.pht002117.v2.p2",2769,1622,4391,"07/25/2014","dbgap"
"5507","phs001270.v1.pht006251.v1.p1",3,7,10,"2017/10/04","dbgap"
"5508","phs000306.v4.pht001908.v2.p1",9454,13,9467,"04/10/2014","dbgap"
"5509","phs000793.v1.pht004022.v1.p1",13,5,18,"09/12/2014","dbgap"
"5510","phs001749.v2.pht009318.v2.p1",911,1204,2115,"2021/05/14","dbgap"
"5511","phs001488.v1.pht007381.v1.p1",237,270,507,"2018/02/08","dbgap"
"5513","phs000086.v3.pht000231.v1.p1",761,680,1441,"11/04/2014","dbgap"
"5514","phs001332.v2.pht007452.v2.p1",2,2,4,"2019/11/08","dbgap"
"5517","phs000007.v32.pht002891.v6.p13",1414,1723,3137,"2020/12/21","dbgap"
"5520","phs001976.v2.pht009902.v1.p1",4,8,12,"2020/03/31","dbgap"
"5522","phs000160.v1.pht000733.v1.p1",2598,2867,5465,"Fri Feb 20 11:36:06 2009","dbgap"
"5523","phs000477.v1.pht002687.v1.p1",12,9,21,"04/16/2012","dbgap"
"5524","phs000007.v32.pht006024.v4.p13",7046,8098,15144,"2020/12/21","dbgap"
"5525","phs002025.v1.pht010237.v1.p1",2281,1718,3999,"2020/07/20","dbgap"
"5526","phs001065.v1.pht005416.v1.p1",296,313,609,"05/24/2016","dbgap"
"5527","phs000209.v13.pht002192.v1.p3",115,135,250,"11/05/2014","dbgap"
"5528","phs001908.v2.pht009534.v2.p1",5,7,12,"2021/04/27","dbgap"
"5529","phs000228.v4.pht002157.v1.p1",522,583,1105,"03/21/2017","dbgap"
"5532","phs000594.v1.pht006504.v1.p1",6,3,9,"06/12/2017","dbgap"
"5534","phs000017.v3.pht000056.v1.p1",93,85,178,"Wed Nov 26 07:33:36 2008","dbgap"
"5535","phs002146.v1.pht011086.v1.p1",2,1,3,"2021/03/30","dbgap"
"5536","phs001065.v1.pht005435.v1.p1",296,313,609,"05/24/2016","dbgap"
"5537","phs002392.v1.pht011253.v1.p1",18,23,41,"2021/07/13","dbgap"
"5538","phs002035.v1.pht010415.v1.p1",25,34,59,"2020/07/21","dbgap"
"5539","phs000309.v2.pht001997.v2.p2",904,1024,1928,"10/19/2011","dbgap"
"5540","phs001199.v1.pht005704.v1.p1",138,59,197,"08/29/2016","dbgap"
"5541","phs000303.v1.pht001898.v1.p1",980,1000,1980,"10/25/2011","dbgap"
"5542","phs000007.v32.pht000105.v8.p13",1132,1197,2329,"2020/12/21","dbgap"
"5543","phs000007.v32.pht002148.v5.p13",1277,1488,2765,"2020/12/21","dbgap"
"5546","phs002389.v1.pht011094.v1.p1",38,22,60,"2021/04/06","dbgap"
"5547","phs001331.v2.pht006933.v2.p1",144,92,236,"2019/08/30","dbgap"
"5548","phs001313.v1.pht007970.v1.p1",1,3,4,"2018/05/17","dbgap"
"5549","phs000171.v1.pht000757.v1.p1",165,316,481,"12/11/2009","dbgap"
"5550","phs000171.v1.pht000754.v1.p1",326,665,991,"12/11/2009","dbgap"
"5551","phs000971.v3.pht004918.v2.p1",646,831,1477,"2021/06/07","dbgap"
"5552","phs002444.v1.pht011384.v1.p1",392,323,715,"2021/07/30","dbgap"
"5553","phs001430.v2.pht008084.v2.p1",13,12,25,"2020/02/06","dbgap"
"5554","phs000166.v2.pht000727.v1.p1",2164,1882,4046,"09/03/2009","dbgap"
"5555","phs001700.v1.pht008501.v1.p1",39,85,124,"2020/11/24","dbgap"
"5556","phs001200.v1.pht005925.v1.p1",4,3,7,"11/16/2016","dbgap"
"5557","phs001332.v2.pht007458.v2.p1",157,187,344,"2019/11/08","dbgap"
"5558","phs000476.v1.pht002671.v1.p1",10,10,20,"04/16/2012","dbgap"
"5559","phs000415.v1.pht002412.v1.p1",137,119,256,"08/13/2015","dbgap"
"5561","phs000415.v1.pht002413.v1.p1",91,79,170,"08/13/2015","dbgap"
"5562","phs000433.v1.pht002434.v1.p1",2233,3635,5868,"04/04/2012","dbgap"
"5564","phs001800.v2.pht008925.v2.p1",13,2,15,"2020/12/16","dbgap"
"5565","phs002493.v1.pht011461.v1.p1",57,32,89,"2021/09/21","dbgap"
"5566","phs000285.v3.pht001781.v2.p2",847,930,1777,"08/20/2013","dbgap"
"5567","phs000944.v1.pht004845.v1.p1",2050,2878,4928,"02/05/2016","dbgap"
"5568","phs002023.v1.pht010195.v1.p1",3,11,14,"2020/05/06","dbgap"
"5569","phs002188.v1.pht011031.v1.p1",5,5,10,"2021/03/22","dbgap"
"5570","phs002240.v1.pht010864.v1.p1",30,66,96,"2021/01/15","dbgap"
"5573","phs001473.v1.pht009688.v1.p1",38,23,61,"2020/12/15","dbgap"
"5574","phs000507.v2.pht002929.v2.p2",427,773,1200,"2018/11/05","dbgap"
"5575","phs000285.v3.pht001564.v2.p2",947,1065,2012,"08/20/2013","dbgap"
"5577","phs000292.v1.pht001526.v1.p1",1051,779,1830,"07/15/2010","dbgap"
"5578","phs001101.v1.pht005366.v1.p1",599,482,1081,"05/09/2016","dbgap"
"5579","phs001729.v2.pht010129.v1.p1",11,8,19,"2021/08/26","dbgap"
"5580","phs000128.v3.pht000418.v2.p3",2943,3500,6443,"04/29/2016","dbgap"
"5581","phs000007.v32.pht000193.v8.p13",1732,1997,3729,"2020/12/21","dbgap"
"5584","phs001009.v1.pht005350.v1.p1",2,6,8,"03/28/2016","dbgap"
"5586","phs000341.v2.pht002673.v2.p1",150,88,238,"11/21/2016","dbgap"
"5587","phs001458.v1.pht007781.v1.p1",990,1582,2572,"2018/04/12","dbgap"
"5588","phs001080.v1.pht005369.v1.p1",62,41,103,"04/06/2016","dbgap"
"5590","phs001024.v5.pht005693.v1.p1",84,44,128,"2021/05/20","dbgap"
"5591","phs001315.v1.pht006191.v1.p1",4482,4243,8725,"2018/05/18","dbgap"
"5593","phs000007.v32.pht002890.v6.p13",1416,1724,3140,"2020/12/21","dbgap"
"5594","phs000298.v4.pht002283.v3.p3",7742,4936,12678,"2018/06/22","dbgap"
"5596","phs000286.v6.pht001969.v2.p2",1228,2061,3289,"2019/03/11","dbgap"
"5598","phs001481.v1.pht008132.v1.p1",238,218,456,"2018/06/07","dbgap"
"5599","phs001037.v1.pht005917.v1.p1",10165,10037,20202,"11/09/2016","dbgap"
"5600","phs000093.v2.pht000699.v2.p2",4067,1555,5622,"10/09/2009","dbgap"
"5601","phs000962.v1.pht006967.v1.p1",221,156,377,"2017/10/02","dbgap"
"5603","phs000007.v32.pht000683.v7.p13",949,1009,1958,"2020/12/21","dbgap"
"5605","phs001686.v1.pht008566.v1.p1",3,3,6,"2018/11/26","dbgap"
"5606","phs001289.v1.pht007783.v1.p1",16,13,29,"2018/04/16","dbgap"
"5608","phs000007.v32.pht002076.v7.p13",1580,2026,3606,"2020/12/21","dbgap"
"5609","phs001979.v1.pht010001.v1.p1",5,2,7,"2020/03/19","dbgap"
"5611","phs001394.v1.pht006950.v1.p1",314,451,765,"2017/09/22","dbgap"
"5612","phs000823.v1.pht005049.v1.p1",178,209,387,"05/11/2016","dbgap"
"5613","phs000571.v3.pht003181.v3.p2",1654,1221,2875,"12/01/2015","dbgap"
"5614","phs000007.v32.pht006011.v1.p13",110,178,288,"2020/12/21","dbgap"
"5616","phs001032.v6.pht005100.v2.p2",826,308,1134,"2021/05/20","dbgap"
"5617","phs000607.v3.pht007881.v1.p2",4586,4909,9495,"2018/05/01","dbgap"
"5619","phs001430.v2.pht008073.v2.p1",13,9,22,"2020/02/06","dbgap"
"5620","phs000595.v1.pht006639.v1.p1",285,329,614,"07/05/2017","dbgap"
"5621","phs000086.v3.pht000285.v1.p1",731,667,1398,"11/04/2014","dbgap"
"5622","phs000917.v1.pht004740.v1.p1",5982,1309,7291,"01/05/2016","dbgap"
"5623","phs000588.v1.pht009293.v1.p1",9,17,26,"2019/07/26","dbgap"
"5624","phs001430.v2.pht009849.v1.p1",3,4,7,"2020/02/06","dbgap"
"5625","phs002121.v1.pht011550.v1.p1",63,57,120,"2021/09/14","dbgap"
"5626","phs002311.v1.pht010935.v1.p1",40,66,106,"2021/03/30","dbgap"
"5629","phs000219.v1.pht001063.v1.p1",200,311,511,"01/19/2010","dbgap"
"5631","phs000957.v1.pht004854.v1.p1",3625,5582,9207,"07/31/2015","dbgap"
"5632","phs000285.v3.pht001783.v2.p2",863,967,1830,"08/20/2013","dbgap"
"5633","phs002481.v1.pht011373.v1.p1",82,63,145,"2021/07/13","dbgap"
"5634","phs000280.v7.pht006434.v1.p1",284,298,582,"2020/06/18","dbgap"
"5636","phs001780.v1.pht008714.v1.p1",379,316,695,"2019/02/11","dbgap"
"5637","phs000285.v3.pht001812.v2.p2",84,49,133,"08/20/2013","dbgap"
"5638","phs001297.v1.pht006201.v1.p1",47,50,97,"06/14/2017","dbgap"
"5639","phs001737.v2.pht008560.v2.p1",2,1,3,"2019/09/18","dbgap"
"5642","phs001326.v1.pht007825.v1.p1",29,4,33,"2018/04/16","dbgap"
"5643","phs000588.v1.pht009310.v1.p1",4,10,14,"2019/07/26","dbgap"
"5644","phs001122.v1.pht008641.v1.p1",137,102,239,"2021/03/23","dbgap"
"5645","phs000007.v32.pht001044.v8.p13",802,1116,1918,"2020/12/21","dbgap"
"5648","phs001608.v2.pht009734.v1.p1",289,351,640,"2021/09/29","dbgap"
"5649","phs000445.v1.pht002505.v1.p1",17,3,20,"10/25/2012","dbgap"
"5650","phs000703.v1.pht003668.v1.p1",1880,1378,3258,"07/23/2014","dbgap"
"5651","phs001486.v3.pht008700.v3.p3",545,531,1076,"2021/10/06","dbgap"
"5652","phs001163.v1.pht011095.v1.p1",181,167,348,"2021/04/06","dbgap"
"5653","phs001427.v2.pht007485.v2.p1",13,4,17,"2021/01/26","dbgap"
"5654","phs001278.v1.pht006271.v1.p1",85,111,196,"06/16/2017","dbgap"
"5656","phs000588.v1.pht009285.v1.p1",2,7,9,"2019/07/26","dbgap"
"5657","phs001207.v3.pht005793.v3.p1",376,959,1335,"2021/07/09","dbgap"
"5658","phs001428.v1.pht008388.v1.p1",16,1831,1847,"2018/09/20","dbgap"
"5659","phs000286.v6.pht008737.v1.p2",1009,1780,2789,"2019/03/11","dbgap"
"5662","phs001804.v1.pht008962.v1.p1",2357,790,3147,"2019/04/23","dbgap"
"5663","phs000280.v7.pht004127.v2.p1",878,1183,2061,"2020/06/18","dbgap"
"5664","phs000280.v7.pht004223.v2.p1",2976,3485,6461,"2020/06/18","dbgap"
"5665","phs001303.v1.pht006614.v1.p1",1437,72,1509,"06/28/2017","dbgap"
"5666","phs000518.v1.pht002850.v1.p1",7,17,24,"08/17/2012","dbgap"
"5667","phs000559.v1.pht003615.v1.p1",7858,6558,14416,"12/16/2013","dbgap"
"5669","phs000128.v3.pht000525.v2.p3",2943,3500,6443,"04/29/2016","dbgap"
"5670","phs000286.v6.pht001946.v2.p2",842,1498,2340,"2019/03/11","dbgap"
"5671","phs000595.v1.pht006635.v1.p1",285,329,614,"07/05/2017","dbgap"
"5672","phs001788.v1.pht008815.v1.p1",3910,867,4777,"2019/03/05","dbgap"
"5673","phs001875.v1.pht009652.v1.p1",3,3,6,"2019/12/06","dbgap"
"5676","phs001207.v3.pht005791.v3.p1",569,827,1396,"2021/07/09","dbgap"
"5677","phs000652.v1.pht003455.v1.p1",4326,2485,6811,"09/03/2013","dbgap"
"5678","phs001625.v1.pht008184.v1.p1",112,140,252,"2018/06/30","dbgap"
"5680","phs000280.v7.pht004048.v5.p1",1539,1568,3107,"2020/06/18","dbgap"
"5682","phs000490.v1.pht002966.v1.p1",1445,1506,2951,"2018/05/07","dbgap"
"5683","phs000545.v1.pht003763.v1.p1",482,282,764,"06/10/2015","dbgap"
"5685","phs000720.v4.pht003879.v4.p1",509,294,803,"2021/03/24","dbgap"
"5686","phs000738.v1.pht003834.v1.p1",117,99,216,"05/07/2014","dbgap"
"5687","phs000285.v3.pht001588.v2.p2",941,1061,2002,"08/20/2013","dbgap"
"5688","phs001770.v1.pht008685.v1.p1",196,160,356,"2019/02/01","dbgap"
"5689","phs001441.v1.pht007112.v1.p1",271,294,565,"2017/11/06","dbgap"
"5690","phs000536.v2.pht002949.v2.p1",22,12,34,"02/11/2016","dbgap"
"5691","phs000280.v7.pht004109.v2.p1",1489,1706,3195,"2020/06/18","dbgap"
"5692","phs000285.v3.pht001665.v2.p2",909,1016,1925,"08/20/2013","dbgap"
"5693","phs001458.v1.pht007780.v1.p1",721,1165,1886,"2018/04/12","dbgap"
"5695","phs001826.v1.pht009137.v1.p1",2995,3119,6114,"2019/07/16","dbgap"
"5696","phs001481.v1.pht008128.v1.p1",238,218,456,"2018/06/07","dbgap"
"5697","phs000166.v2.pht000701.v1.p1",500,313,813,"09/03/2009","dbgap"
"5699","phs000285.v3.pht001747.v2.p2",586,637,1223,"08/20/2013","dbgap"
"5700","phs000145.v4.pht002999.v1.p2",3078,2838,5916,"04/16/2013","dbgap"
"5701","phs000007.v32.pht002900.v4.p13",1498,1724,3222,"2020/12/21","dbgap"
"5704","phs000973.v1.pht004990.v1.p1",20,9,29,"11/16/2016","dbgap"
"5705","phs000738.v1.pht003835.v1.p1",117,99,216,"05/07/2014","dbgap"
"5706","phs001420.v1.pht009144.v1.p1",437,391,828,"2019/06/06","dbgap"
"5707","phs001003.v2.pht010326.v2.p1",56,89,145,"2021/03/01","dbgap"
"5708","phs000942.v1.pht004834.v1.p1",26,232,258,"03/01/2016","dbgap"
"5709","phs001219.v1.pht007858.v1.p1",236,239,475,"2018/04/23","dbgap"
"5710","phs001331.v2.pht006927.v2.p1",516,344,860,"2019/08/30","dbgap"
"5711","phs000980.v1.pht004962.v1.p1",16,18,34,"11/16/2015","dbgap"
"5712","phs001328.v1.pht006314.v1.p1",54,37,91,"05/17/2017","dbgap"
"5713","phs000674.v1.pht003639.v1.p1",32008,46478,78486,"01/27/2014","dbgap"
"5714","phs000691.v2.pht003651.v2.p1",291,197,488,"03/11/2015","dbgap"
"5715","phs001959.v1.pht009789.v1.p1",2,3,5,"2020/03/05","dbgap"
"5716","phs000171.v1.pht000786.v1.p1",635,1284,1919,"12/11/2009","dbgap"
"5717","phs002001.v1.pht010097.v1.p1",6,9,15,"2021/09/28","dbgap"
"5718","phs000096.v4.pht001423.v4.p1",7546,7514,15060,"11/16/2011","dbgap"
"5720","phs000209.v13.pht002104.v2.p3",3060,3369,6429,"11/05/2014","dbgap"
"5721","phs000994.v1.pht005064.v1.p1",12,7,19,"11/02/2015","dbgap"
"5722","phs000285.v3.pht001822.v2.p2",877,989,1866,"08/20/2013","dbgap"
"5725","phs001876.v1.pht009389.v1.p1",611,405,1016,"2019/08/10","dbgap"
"5726","phs000653.v3.pht003465.v3.p1",1041,1145,2186,"2018/09/11","dbgap"
"5727","phs000086.v3.pht000274.v1.p1",761,680,1441,"11/04/2014","dbgap"
"5728","phs000007.v32.pht000032.v8.p13",1818,1957,3775,"2020/12/21","dbgap"
"5729","phs002020.v1.pht010226.v1.p1",544,458,1002,"2020/05/26","dbgap"
"5730","phs000917.v1.pht004739.v1.p1",5982,1309,7291,"01/05/2016","dbgap"
"5731","phs000086.v3.pht000253.v1.p1",761,680,1441,"11/04/2014","dbgap"
"5732","phs001377.v1.pht006943.v1.p1",321,44,365,"2017/09/22","dbgap"
"5733","phs001248.v1.pht006093.v1.p1",42,52,94,"03/06/2017","dbgap"
"5734","phs000583.v1.pht003294.v1.p1",860,756,1616,"03/21/2014","dbgap"
"5735","phs002323.v1.pht010881.v1.p1",37,34,71,"2021/05/24","dbgap"
"5736","phs001457.v1.pht007052.v1.p1",14,38,52,"2018/04/12","dbgap"
"5737","phs000166.v2.pht000703.v2.p1",522,312,834,"09/03/2009","dbgap"
"5738","phs000726.v1.pht003779.v1.p1",546,426,972,"10/27/2014","dbgap"
"5739","phs000568.v1.pht003112.v1.p1",8,9,17,"01/02/2013","dbgap"
"5740","phs001325.v3.pht006349.v1.p1",178,207,385,"2019/11/22","dbgap"
"5741","phs000402.v1.pht002537.v1.p1",125,78,203,"03/21/2012","dbgap"
"5744","phs001831.v1.pht009168.v1.p1",101,88,189,"2020/08/26","dbgap"
"5745","phs001603.v2.pht009969.v1.p1",54,102,156,"2021/07/16","dbgap"
"5747","phs000285.v3.pht001650.v2.p2",55,61,116,"08/20/2013","dbgap"
"5748","phs001727.v2.pht010102.v1.p1",29,44,73,"2021/08/26","dbgap"
"5750","phs001850.v1.pht009235.v1.p1",37,296,333,"2019/07/03","dbgap"
"5751","phs000285.v3.pht001680.v2.p2",896,1002,1898,"08/20/2013","dbgap"
"5753","phs000086.v3.pht000349.v1.p1",18,31,49,"11/04/2014","dbgap"
"5754","phs001025.v1.pht005083.v1.p1",292,1987,2279,"11/06/2015","dbgap"
"5755","phs001448.v1.pht007030.v1.p1",27,31,58,"2017/10/19","dbgap"
"5756","phs001279.v1.pht007205.v1.p1",10,11,21,"2017/12/08","dbgap"
"5757","phs001213.v2.pht005840.v1.p1",761,282,1043,"2020/02/27","dbgap"
"5758","phs000086.v3.pht000282.v1.p1",761,680,1441,"11/04/2014","dbgap"
"5760","phs000086.v3.pht000669.v2.p1",799,717,1516,"11/04/2014","dbgap"
"5761","phs001310.v1.pht006875.v1.p1",29,25,54,"2017/09/18","dbgap"
"5762","phs000592.v1.pht006579.v1.p1",179,145,324,"07/12/2017","dbgap"
"5763","phs000007.v32.pht000204.v8.p13",1523,1746,3269,"2020/12/21","dbgap"
"5764","phs000285.v3.pht001870.v2.p2",49,41,90,"08/20/2013","dbgap"
"5765","phs001341.v1.pht006244.v1.p1",36,54,90,"2017/11/30","dbgap"
"5766","phs000287.v7.pht001493.v1.p1",2375,3156,5531,"2020/01/23","dbgap"
"5767","phs000286.v6.pht008777.v1.p2",314,598,912,"2019/03/11","dbgap"
"5768","phs000546.v1.pht003143.v1.p1",40,35,75,"07/09/2013","dbgap"
"5769","phs000280.v7.pht006485.v1.p1",6672,7923,14595,"2020/06/18","dbgap"
"5770","phs000291.v2.pht002272.v1.p1",214,123,337,"05/11/2012","dbgap"
"5771","phs000222.v6.pht005789.v2.p2",13,26,39,"2019/08/01","dbgap"
"5772","phs000927.v1.pht004751.v1.p1",71,131,202,"04/05/2017","dbgap"
"5773","phs000590.v1.pht008284.v1.p1",29,36,65,"2018/08/03","dbgap"
"5774","phs000007.v32.pht001178.v10.p13",3517,4146,7663,"2020/12/21","dbgap"
"5775","phs000648.v1.pht004580.v1.p1",4525,3478,8003,"06/23/2015","dbgap"
"5776","phs000285.v3.pht001794.v2.p2",865,971,1836,"08/20/2013","dbgap"
"5778","phs000578.v1.pht007021.v1.p1",1,1,2,"2017/10/11","dbgap"
"5779","phs001803.v1.pht008938.v1.p1",223,696,919,"2019/04/04","dbgap"
"5780","phs000267.v5.pht002303.v2.p2",4901,2979,7880,"03/02/2016","dbgap"
"5781","phs000698.v1.pht007674.v1.p1",18,32,50,"2018/03/23","dbgap"
"5782","phs001881.v1.pht010562.v1.p1",2839,1545,4384,"2020/10/01","dbgap"
"5783","phs000922.v2.pht004926.v2.p1",252,83,335,"2021/05/24","dbgap"
"5784","phs001289.v1.pht007792.v1.p1",16,13,29,"2018/04/16","dbgap"
"5785","phs001382.v1.pht006974.v1.p1",113,354,467,"2017/10/03","dbgap"
"5786","phs001740.v1.pht008621.v1.p1",353,226,579,"2019/08/01","dbgap"
"5787","phs000558.v1.pht006229.v1.p1",91,84,175,"03/31/2017","dbgap"
"5788","phs000397.v3.pht003356.v3.p3",2173,2675,4848,"2020/08/17","dbgap"
"5789","phs001831.v1.pht009169.v1.p1",101,88,189,"2020/08/26","dbgap"
"5791","phs000340.v3.pht002209.v2.p1",73,33,106,"04/10/2014","dbgap"
"5793","phs001765.v1.pht008665.v1.p1",26,13,39,"2019/01/29","dbgap"
"5794","phs000638.v1.pht003568.v1.p1",1341,1146,2487,"11/20/2013","dbgap"
"5795","phs000669.v1.pht003731.v1.p1",34,6855,6889,"10/18/2016","dbgap"
"5796","phs000588.v1.pht009281.v1.p1",13,66,79,"2019/07/26","dbgap"
"5797","phs001917.v1.pht009549.v1.p1",454,370,824,"2019/10/22","dbgap"
"5798","phs000285.v3.pht001852.v2.p2",149,180,329,"08/20/2013","dbgap"
"5799","phs001857.v1.pht010764.v1.p1",676,1352,2028,"2020/12/09","dbgap"
"5800","phs000280.v7.pht004193.v2.p1",6120,7410,13530,"2020/06/18","dbgap"
"5801","phs000128.v3.pht000453.v2.p3",2943,3500,6443,"04/29/2016","dbgap"
"5802","phs000333.v1.pht002314.v1.p1",1032,1590,2622,"10/06/2011","dbgap"
"5803","phs000508.v2.pht002811.v1.p1",19,16,35,"04/15/2014","dbgap"
"5804","phs000007.v32.pht003313.v3.p13",991,1184,2175,"2020/12/21","dbgap"
"5805","phs001378.v1.pht006692.v1.p1",4,2,6,"2019/05/02","dbgap"
"5806","phs000729.v1.pht003774.v1.p1",4,5,9,"04/08/2014","dbgap"
"5807","phs000007.v32.pht000906.v7.p13",1111,907,2018,"2020/12/21","dbgap"
"5808","phs000698.v1.pht007677.v1.p1",17,29,46,"2018/03/23","dbgap"
"5809","phs000007.v32.pht007772.v2.p13",1522,1727,3249,"2020/12/21","dbgap"
"5811","phs000333.v1.pht002312.v1.p1",100,111,211,"10/06/2011","dbgap"
"5815","phs001606.v2.pht010090.v1.p1",134,190,324,"2021/07/19","dbgap"
"5816","phs000007.v32.pht000103.v3.p13",495,728,1223,"2020/12/21","dbgap"
"5817","phs001949.v1.pht009706.v1.p1",13495,15325,28820,"2019/12/26","dbgap"
"5818","phs000280.v7.pht004203.v2.p1",5436,6656,12092,"2020/06/18","dbgap"
"5819","phs001836.v1.pht009217.v1.p1",1,3,4,"2019/06/24","dbgap"
"5820","phs002039.v1.pht010272.v1.p1",5,13,18,"2020/06/10","dbgap"
"5822","phs001496.v1.pht007338.v1.p1",114,1,115,"2018/02/15","dbgap"
"5824","phs001107.v1.pht005489.v1.p1",3,3,6,"05/26/2016","dbgap"
"5825","phs000343.v3.pht002723.v1.p1",96,31,127,"03/12/2013","dbgap"
"5828","phs001046.v1.pht005295.v1.p1",44,65,109,"2018/06/01","dbgap"
"5829","phs000896.v1.pht005125.v1.p1",5,7,12,"11/16/2015","dbgap"
"5830","phs001065.v1.pht005436.v1.p1",296,313,609,"05/24/2016","dbgap"
"5831","phs000634.v1.pht003832.v1.p1",801,1519,2320,"06/25/2015","dbgap"
"5832","phs001327.v2.pht011194.v1.p1",2408,2643,5051,"2021/05/07","dbgap"
"5833","phs000280.v7.pht006435.v1.p1",8,11,19,"2020/06/18","dbgap"
"5834","phs000587.v1.pht003520.v1.p1",16,13,29,"04/25/2014","dbgap"
"5835","phs000739.v1.pht003827.v1.p1",5,2,7,"05/02/2014","dbgap"
"5836","phs000280.v7.pht004077.v2.p1",4874,6004,10878,"2020/06/18","dbgap"
"5837","phs001673.v1.pht008511.v1.p1",914,1144,2058,"2019/04/25","dbgap"
"5839","phs000007.v32.pht005389.v4.p13",3590,4224,7814,"2020/12/21","dbgap"
"5840","phs002457.v1.pht011516.v1.p1",1,24,25,"2021/08/30","dbgap"
"5841","phs001065.v1.pht005432.v1.p1",296,313,609,"05/24/2016","dbgap"
"5842","phs001238.v2.pht006657.v1.p1",701,879,1580,"2018/06/14","dbgap"
"5843","phs000285.v3.pht001799.v2.p2",860,964,1824,"08/20/2013","dbgap"
"5844","phs001472.v2.pht007118.v1.p1",1574,891,2465,"2021/07/07","dbgap"
"5846","phs000564.v2.pht003056.v2.p1",142,137,279,"07/09/2015","dbgap"
"5847","phs000171.v1.pht000788.v1.p1",636,1284,1920,"12/11/2009","dbgap"
"5848","phs001545.v2.pht009967.v1.p1",315,152,467,"2021/07/13","dbgap"
"5850","phs000254.v2.pht002227.v2.p1",130,123,253,"10/11/2012","dbgap"
"5851","phs001005.v2.pht005040.v2.p1",3,1,4,"2019/11/01","dbgap"
"5852","phs000103.v1.pht001887.v1.p1",3197,3080,6277,"09/27/2010","dbgap"
"5853","phs002311.v1.pht010931.v1.p1",41,67,108,"2021/03/30","dbgap"
"5854","phs000365.v1.pht002264.v1.p1",3,1,4,"08/11/2011","dbgap"
"5855","phs000761.v1.pht004496.v1.p1",1428,2018,3446,"03/26/2015","dbgap"
"5856","phs001748.v1.pht008575.v1.p1",7,14,21,"2021/02/04","dbgap"
"5858","phs002481.v1.pht011372.v1.p1",82,63,145,"2021/07/13","dbgap"
"5859","phs001919.v1.pht009593.v1.p1",28,11,39,"2020/03/11","dbgap"
"5862","phs001014.v1.pht005114.v1.p1",72,101,173,"02/25/2016","dbgap"
"5863","phs000416.v2.pht002746.v2.p1",1723,1846,3569,"2018/07/06","dbgap"
"5864","phs000327.v1.pht003009.v1.p1",107,85,192,"03/22/2013","dbgap"
"5865","phs000582.v1.pht003241.v1.p1",16,14,30,"05/16/2013","dbgap"
"5866","phs000280.v7.pht006441.v1.p1",1115,1406,2521,"2020/06/18","dbgap"
"5867","phs000775.v1.pht003944.v1.p1",497,362,859,"07/18/2014","dbgap"
"5868","phs001326.v1.pht007829.v1.p1",171,56,227,"2018/04/16","dbgap"
"5869","phs000280.v7.pht006473.v1.p1",1049,1264,2313,"2020/06/18","dbgap"
"5870","phs000286.v6.pht001963.v2.p2",1287,2149,3436,"2019/03/11","dbgap"
"5871","phs001772.v2.pht008636.v2.p1",41,41,82,"2021/07/09","dbgap"
"5872","phs000086.v3.pht000219.v1.p1",470,420,890,"11/04/2014","dbgap"
"5873","phs000001.v3.pht000380.v2.p1",598,508,1106,"02/24/2012","dbgap"
"5874","phs001207.v3.pht005794.v3.p1",376,957,1333,"2021/07/09","dbgap"
"5875","phs001093.v1.pht005613.v1.p1",908,160,1068,"07/06/2016","dbgap"
"5876","phs001416.v2.pht009013.v1.p1",2532,2823,5355,"2019/10/01","dbgap"
"5877","phs000490.v1.pht002962.v1.p1",3928,3501,7429,"2018/05/07","dbgap"
"5879","phs001182.v2.pht005720.v2.p1",8,13,21,"2020/09/18","dbgap"
"5883","phs000007.v32.pht009753.v2.p13",1144,1386,2530,"2020/12/21","dbgap"
"5884","phs000128.v3.pht000479.v2.p3",2943,3500,6443,"04/29/2016","dbgap"
"5885","phs000021.v3.pht000287.v1.p2",370,609,979,"10/25/2010","dbgap"
"5886","phs000933.v2.pht004777.v2.p1",169,121,290,"2018/03/09","dbgap"
"5887","phs000314.v1.pht002069.v1.p1",1220,948,2168,"07/17/2012","dbgap"
"5888","phs000203.v1.pht001988.v1.p1",2095,1290,3385,"10/12/2010","dbgap"
"5889","phs000906.v1.pht007148.v1.p1",2766,2936,5702,"2017/12/04","dbgap"
"5890","phs000007.v32.pht000019.v3.p13",802,1227,2029,"2020/12/21","dbgap"
"5891","phs000914.v1.pht005252.v1.p1",1283,1904,3187,"04/20/2016","dbgap"
"5892","phs001817.v1.pht009135.v1.p1",85,177,262,"2019/06/04","dbgap"
"5893","phs000219.v1.pht001071.v1.p1",133,223,356,"01/19/2010","dbgap"
"5894","phs002073.v1.pht010827.v1.p1",18,22,40,"2021/01/07","dbgap"
"5895","phs000606.v1.pht007570.v1.p1",718,255,973,"2018/03/09","dbgap"
"5896","phs000007.v32.pht001182.v8.p13",853,1015,1868,"2020/12/21","dbgap"
"5897","phs001441.v1.pht007114.v1.p1",271,294,565,"2017/11/06","dbgap"
"5898","phs000994.v1.pht005065.v1.p1",12,7,19,"11/02/2015","dbgap"
"5899","phs000956.v5.pht005768.v2.p1",1104,1088,2192,"2021/05/07","dbgap"
"5900","phs000871.v1.pht004569.v1.p1",16,17,33,"05/08/2017","dbgap"
"5901","phs000145.v4.pht000659.v2.p2",3078,2838,5916,"04/16/2013","dbgap"
"5902","phs000007.v32.pht007774.v2.p13",1185,1440,2625,"2020/12/21","dbgap"
"5903","phs001281.v2.pht006137.v2.p1",4,6,10,"2019/02/21","dbgap"
"5904","phs001219.v1.pht007860.v1.p1",236,239,475,"2018/04/23","dbgap"
"5905","phs001327.v2.pht011187.v1.p1",2457,1798,4255,"2021/05/07","dbgap"
"5907","phs000935.v1.pht004817.v1.p1",93,66,159,"11/16/2016","dbgap"
"5909","phs001193.v1.pht005976.v1.p1",901,696,1597,"12/06/2016","dbgap"
"5910","phs001311.v1.pht007928.v1.p1",34,26,60,"2018/05/15","dbgap"
"5911","phs000949.v1.pht005226.v1.p1",1325,1861,3186,"02/08/2016","dbgap"
"5912","phs000007.v32.pht004803.v4.p13",2106,2423,4529,"2020/12/21","dbgap"
"5913","phs000287.v7.pht005981.v1.p1",2375,3156,5531,"2020/01/23","dbgap"
"5914","phs001096.v1.pht005609.v1.p1",519,568,1087,"06/30/2016","dbgap"
"5916","phs000697.v1.pht007699.v1.p1",28,6,34,"2018/03/26","dbgap"
"5918","phs001326.v1.pht007821.v1.p1",169,56,225,"2018/04/16","dbgap"
"5919","phs000007.v32.pht000102.v9.p13",1791,2017,3808,"2020/12/21","dbgap"
"5920","phs002323.v1.pht010879.v1.p1",37,34,71,"2021/05/24","dbgap"
"5921","phs000511.v1.pht002818.v1.p1",37,11,48,"07/09/2012","dbgap"
"5922","phs001862.v1.pht009749.v1.p1",278,380,658,"2019/12/26","dbgap"
"5923","phs000265.v3.pht001274.v3.p1",37,32,69,"10/17/2011","dbgap"
"5926","phs000462.v1.pht002540.v1.p1",676,718,1394,"05/07/2013","dbgap"
"5927","phs000808.v1.pht004466.v1.p1",117,128,245,"02/05/2015","dbgap"
"5929","phs000623.v1.pht003336.v1.p1",47,59,106,"08/16/2013","dbgap"
"5930","phs000145.v4.pht000660.v2.p2",2109,2175,4284,"04/16/2013","dbgap"
"5931","phs000431.v2.pht002482.v2.p1",2333,1282,3615,"02/20/2015","dbgap"
"5932","phs001014.v1.pht005115.v1.p1",72,101,173,"02/25/2016","dbgap"
"5933","phs001091.v1.pht006066.v1.p1",3,2,5,"05/12/2017","dbgap"
"5934","phs000007.v32.pht000612.v8.p13",1664,1952,3616,"2020/12/21","dbgap"
"5935","phs000883.v1.pht004595.v1.p1",1331,723,2054,"01/15/2016","dbgap"
"5937","phs000007.v32.pht000018.v4.p13",898,1338,2236,"2020/12/21","dbgap"
"5938","phs001779.v1.pht010207.v1.p1",34,119,153,"2020/06/25","dbgap"
"5939","phs000378.v1.pht002318.v1.p1",438,813,1251,"04/23/2014","dbgap"
"5940","phs001457.v1.pht007053.v1.p1",14,38,52,"2018/04/12","dbgap"
"5941","phs000365.v1.pht002268.v1.p1",2,1,3,"08/11/2011","dbgap"
"5942","phs001057.v1.pht005300.v1.p1",894,99,993,"02/18/2016","dbgap"
"5943","phs002015.v1.pht010367.v1.p1",162,98,260,"2020/09/18","dbgap"
"5944","phs001879.v1.pht009456.v1.p1",92,77,169,"2019/09/19","dbgap"
"5945","phs001561.v1.pht010997.v1.p1",70,65,135,"2021/03/31","dbgap"
"5946","phs000352.v1.pht002284.v1.p1",21,25,46,"10/28/2011","dbgap"
"5947","phs001555.v1.pht007879.v1.p1",24,21,45,"2018/04/30","dbgap"
"5948","phs000007.v32.pht000087.v8.p13",1519,1750,3269,"2020/12/21","dbgap"
"5949","phs001057.v1.pht005299.v1.p1",894,99,993,"02/18/2016","dbgap"
"5950","phs000357.v2.pht002335.v2.p1",85,748,833,"2018/09/19","dbgap"
"5951","phs001313.v1.pht007975.v1.p1",1,4,5,"2018/05/17","dbgap"
"5952","phs000273.v1.pht001432.v1.p1",16,9,25,"07/08/2011","dbgap"
"5953","phs001677.v1.pht008378.v1.p1",182,911,1093,"2018/09/17","dbgap"
"5954","phs000285.v3.pht001838.v2.p2",876,990,1866,"08/20/2013","dbgap"
"5955","phs000285.v3.pht001676.v2.p2",907,1012,1919,"08/20/2013","dbgap"
"5956","phs001618.v1.pht008225.v1.p1",25,24,49,"2018/07/18","dbgap"
"5957","phs000007.v32.pht005141.v1.p13",61,157,218,"2020/12/21","dbgap"
"5958","phs001288.v1.pht006775.v1.p1",61,38,99,"2017/10/19","dbgap"
"5959","phs000462.v1.pht002844.v1.p1",431,617,1048,"05/07/2013","dbgap"
"5960","phs000698.v1.pht007684.v1.p1",18,32,50,"2018/03/23","dbgap"
"5961","phs001332.v2.pht007445.v2.p1",158,188,346,"2019/11/08","dbgap"
"5962","phs000086.v3.pht000257.v1.p1",55,50,105,"11/04/2014","dbgap"
"5963","phs000888.v1.pht005577.v1.p1",15,10,25,"08/12/2016","dbgap"
"5966","phs001306.v1.pht006188.v1.p1",5394,6280,11674,"06/01/2017","dbgap"
"5967","phs002410.v1.pht011552.v1.p1",500,313,813,"2021/09/14","dbgap"
"5969","phs002252.v1.pht010669.v1.p1",9,4,13,"2021/01/06","dbgap"
"5970","phs000418.v2.pht002616.v1.p1",7,1,8,"04/10/2014","dbgap"
"5971","phs001026.v1.pht005121.v1.p1",68,57,125,"11/16/2015","dbgap"
"5973","phs001201.v2.pht007558.v1.p1",24,29,53,"2019/08/18","dbgap"
"5974","phs000285.v3.pht001682.v2.p2",1,2,3,"08/20/2013","dbgap"
"5975","phs001012.v1.pht005547.v1.p1",1033,1097,2130,"06/22/2016","dbgap"
"5976","phs001596.v1.pht007966.v1.p1",15,22,37,"2018/05/17","dbgap"
"5978","phs000816.v2.pht004342.v2.p1",199,225,424,"04/17/2017","dbgap"
"5979","phs001927.v1.pht011579.v1.p1",1224,1075,2299,"2021/09/24","dbgap"
"5980","phs000007.v32.pht000608.v3.p13",110,39,149,"2020/12/21","dbgap"
"5981","phs001312.v1.pht007199.v1.p1",2045,3143,5188,"2017/12/07","dbgap"
"5983","phs001217.v3.pht007763.v1.p1",981,882,1863,"2021/06/08","dbgap"
"5984","phs000086.v3.pht000220.v1.p1",761,680,1441,"11/04/2014","dbgap"
"5985","phs000701.v1.pht005510.v1.p1",48,43,91,"06/01/2017","dbgap"
"5986","phs000948.v1.pht004848.v1.p1",684,1284,1968,"08/26/2015","dbgap"
"5987","phs001519.v1.pht008435.v1.p1",4,6,10,"2018/10/02","dbgap"
"5988","phs000125.v1.pht000647.v1.p1",1041,904,1945,"Thu Nov 13 11:10:50 2008","dbgap"
"5989","phs001216.v1.pht005785.v1.p1",241,206,447,"09/29/2016","dbgap"
"5990","phs002361.v1.pht011069.v1.p1",1,1,2,"2021/03/18","dbgap"
"5991","phs000007.v32.pht010727.v1.p13",283,233,516,"2020/12/21","dbgap"
"5992","phs000567.v1.pht003081.v1.p1",13,13,26,"12/17/2012","dbgap"
"5993","phs001781.v1.pht008859.v1.p1",72,36,108,"2019/03/25","dbgap"
"5994","phs001549.v1.pht008252.v1.p1",81,70,151,"2018/08/18","dbgap"
"5995","phs001398.v1.pht007143.v1.p1",1734,256,1990,"2018/08/06","dbgap"
"5999","phs002015.v1.pht010392.v1.p1",1812,2387,4199,"2020/09/18","dbgap"
"6000","phs001860.v1.pht009451.v1.p1",86,120,206,"2020/05/15","dbgap"
"6001","phs002001.v1.pht010099.v1.p1",6,9,15,"2021/09/28","dbgap"
"6002","phs001402.v3.pht008238.v2.p1",795,739,1534,"2021/06/16","dbgap"
"6003","phs000092.v1.pht000635.v1.p1",1908,2261,4169,"Wed Nov 19 17:41:20 2008","dbgap"
"6005","phs000998.v2.pht005056.v2.p1",14,20,34,"2020/08/26","dbgap"
"6006","phs000350.v1.pht002200.v1.p1",190,90,280,"03/28/2014","dbgap"
"6009","phs001451.v3.pht007132.v3.p1",6,6,12,"2021/01/26","dbgap"
"6010","phs002457.v1.pht011517.v1.p1",1,24,25,"2021/08/30","dbgap"
"6011","phs000603.v1.pht007544.v1.p1",5,10,15,"2018/03/06","dbgap"
"6012","phs001673.v1.pht008512.v1.p1",914,1144,2058,"2019/04/25","dbgap"
"6013","phs000979.v3.pht005196.v3.p2",607,363,970,"2019/09/16","dbgap"
"6014","phs000666.v1.pht003573.v1.p1",10,17,27,"01/13/2014","dbgap"
"6015","phs001505.v1.pht007318.v1.p1",268,140,408,"2018/09/06","dbgap"
"6017","phs001387.v3.pht008970.v2.p1",1158,1195,2353,"2021/06/10","dbgap"
"6018","phs001358.v1.pht006336.v1.p1",1092,1230,2322,"05/02/2017","dbgap"
"6019","phs000883.v1.pht004596.v1.p1",1331,723,2054,"01/15/2016","dbgap"
"6021","phs000649.v2.pht003759.v2.p2",517,523,1040,"2021/01/08","dbgap"
"6022","phs000209.v13.pht003121.v3.p3",2677,2924,5601,"11/05/2014","dbgap"
"6023","phs001670.v1.pht008879.v1.p1",23,25,48,"2019/03/27","dbgap"
"6026","phs001065.v1.pht005430.v1.p1",296,313,609,"05/24/2016","dbgap"
"6027","phs001053.v1.pht007231.v1.p1",159,227,386,"2017/12/13","dbgap"
"6028","phs001464.v1.pht006971.v1.p1",9,5,14,"2017/10/03","dbgap"
"6029","phs000209.v13.pht003479.v1.p3",3056,3356,6412,"11/05/2014","dbgap"
"6031","phs001741.v1.pht009164.v1.p1",573,332,905,"2020/01/07","dbgap"
"6032","phs001858.v1.pht009374.v1.p1",7956,9127,17083,"2019/10/25","dbgap"
"6034","phs000285.v3.pht001701.v2.p2",947,1065,2012,"08/20/2013","dbgap"
"6035","phs000285.v3.pht001800.v2.p2",860,964,1824,"08/20/2013","dbgap"
"6036","phs000285.v3.pht001666.v2.p2",908,1015,1923,"08/20/2013","dbgap"
"6037","phs001538.v1.pht008098.v1.p1",215,297,512,"2018/06/01","dbgap"
"6038","phs000287.v7.pht001474.v1.p1",2375,3156,5531,"2020/01/23","dbgap"
"6039","phs001366.v1.pht006575.v1.p1",3,9,12,"2017/12/04","dbgap"
"6040","phs001065.v1.pht005410.v1.p1",296,313,609,"05/24/2016","dbgap"
"6042","phs000712.v1.pht003712.v1.p1",340,249,589,"09/25/2015","dbgap"
"6043","phs000584.v1.pht010799.v1.p1",869,1239,2108,"2021/01/27","dbgap"
"6044","phs001501.v1.pht007228.v1.p1",698,378,1076,"2020/08/24","dbgap"
"6045","phs001795.v1.pht008952.v1.p1",27,35,62,"2019/06/24","dbgap"
"6046","phs001495.v2.pht007195.v1.p1",1,4,5,"2019/01/30","dbgap"
"6048","phs000007.v32.pht000305.v8.p13",1895,2161,4056,"2020/12/21","dbgap"
"6049","phs000007.v32.pht010747.v1.p13",40,66,106,"2020/12/21","dbgap"
"6050","phs000280.v7.pht004234.v2.p1",4769,5785,10554,"2020/06/18","dbgap"
"6051","phs000595.v1.pht006636.v1.p1",286,329,615,"07/05/2017","dbgap"
"6052","phs001704.v1.pht008461.v1.p1",16,7,23,"2018/10/16","dbgap"
"6053","phs000280.v7.pht004195.v2.p1",4883,6019,10902,"2020/06/18","dbgap"
"6054","phs001489.v2.pht008585.v2.p2",6057,6807,12864,"2021/03/18","dbgap"
"6057","phs002334.v1.pht010960.v1.p1",11,18,29,"2021/02/12","dbgap"
"6058","phs000697.v1.pht007698.v1.p1",24,5,29,"2018/03/26","dbgap"
"6059","phs001675.v1.pht010222.v1.p1",151,168,319,"2021/02/10","dbgap"
"6060","phs002436.v1.pht011376.v1.p1",7,6,13,"2021/07/07","dbgap"
"6062","phs000666.v1.pht003575.v1.p1",10,17,27,"01/13/2014","dbgap"
"6063","phs000209.v13.pht001985.v1.p3",593,873,1466,"11/05/2014","dbgap"
"6064","phs001332.v2.pht007444.v2.p1",158,188,346,"2019/11/08","dbgap"
"6065","phs000285.v3.pht001761.v2.p2",868,972,1840,"08/20/2013","dbgap"
"6066","phs001266.v2.pht007220.v1.p1",773,593,1366,"2020/03/09","dbgap"
"6067","phs000096.v4.pht001425.v2.p1",9,41,50,"11/16/2011","dbgap"
"6068","phs000603.v1.pht007548.v1.p1",5,10,15,"2018/03/06","dbgap"
"6069","phs000588.v1.pht009301.v1.p1",42,151,193,"2019/07/26","dbgap"
"6070","phs000588.v1.pht009286.v1.p1",1,2,3,"2019/07/26","dbgap"
"6073","phs000007.v32.pht006008.v1.p13",7,33,40,"2020/12/21","dbgap"
"6074","phs001419.v1.pht007194.v1.p1",126,132,258,"2017/12/04","dbgap"
"6075","phs000007.v32.pht000828.v7.p13",1263,1590,2853,"2020/12/21","dbgap"
"6077","phs001600.v2.pht011021.v2.p2",653,618,1271,"2021/07/15","dbgap"
"6078","phs001641.v1.pht010040.v1.p1",556,1269,1825,"2020/03/24","dbgap"
"6079","phs000837.v1.pht004441.v1.p1",3,3,6,"01/26/2015","dbgap"
"6080","phs000219.v1.pht001092.v1.p1",176,272,448,"01/19/2010","dbgap"
"6081","phs001956.v1.pht009786.v1.p1",8,7,15,"2020/01/10","dbgap"
"6082","phs000280.v7.pht009477.v2.p1",1224,1399,2623,"2020/06/18","dbgap"
"6083","phs001758.v1.pht008609.v1.p1",2,8,10,"2018/12/31","dbgap"
"6084","phs001316.v1.pht008007.v1.p1",2,1,3,"2018/05/31","dbgap"
"6085","phs001178.v1.pht008547.v1.p1",149,150,299,"2018/11/19","dbgap"
"6088","phs000286.v6.pht008780.v1.p2",896,1484,2380,"2019/03/11","dbgap"
"6089","phs000185.v7.pht003719.v2.p1",54,85,139,"2020/04/29","dbgap"
"6090","phs000287.v7.pht001448.v7.p1",2341,3139,5480,"2020/01/23","dbgap"
"6091","phs001753.v1.pht009019.v1.p1",74,104,178,"2019/05/01","dbgap"
"6092","phs000901.v1.pht004672.v1.p1",44,13,57,"06/01/2015","dbgap"
"6093","phs002252.v1.pht010668.v1.p1",9,4,13,"2021/01/06","dbgap"
"6095","phs000286.v6.pht001973.v2.p2",1288,2152,3440,"2019/03/11","dbgap"
"6097","phs000710.v1.pht003989.v1.p1",1,2,3,"04/29/2015","dbgap"
"6098","phs001696.v1.pht008432.v1.p1",6,4,10,"2018/10/02","dbgap"
"6099","phs001661.v3.pht010561.v1.p1",2791,2673,5464,"2021/08/17","dbgap"
"6102","phs000598.v2.pht003323.v2.p2",42,9,51,"10/28/2013","dbgap"
"6104","phs001375.v2.pht006521.v2.p1",408,628,1036,"2021/03/22","dbgap"
"6107","phs000140.v1.pht000911.v1.p1",817,1186,2003,"11/24/2010","dbgap"
"6108","phs000285.v3.pht001627.v2.p2",895,1018,1913,"08/20/2013","dbgap"
"6110","phs000219.v1.pht001048.v1.p1",632,989,1621,"01/19/2010","dbgap"
"6112","phs001976.v2.pht009903.v2.p1",4,8,12,"2020/03/31","dbgap"
"6113","phs001778.v1.pht009832.v1.p1",5,6,11,"2020/07/16","dbgap"
"6114","phs000966.v2.pht011075.v1.p2",40,59,99,"2021/08/27","dbgap"
"6115","phs000603.v1.pht007549.v1.p1",3,9,12,"2018/03/06","dbgap"
"6116","phs000847.v2.pht004635.v2.p1",631,904,1535,"12/02/2016","dbgap"
"6117","phs001299.v2.pht007622.v1.p1",1720,1788,3508,"2020/03/09","dbgap"
"6118","phs002121.v1.pht011548.v1.p1",63,57,120,"2021/09/14","dbgap"
"6119","phs000007.v32.pht000603.v2.p13",621,920,1541,"2020/12/21","dbgap"
"6120","phs000990.v1.pht004997.v1.p1",1078,616,1694,"02/29/2016","dbgap"
"6121","phs000280.v7.pht004141.v2.p1",4883,6019,10902,"2020/06/18","dbgap"
"6123","phs001575.v2.pht009607.v1.p1",16,26,42,"2019/11/12","dbgap"
"6124","phs001744.v1.pht008571.v1.p1",2317,942,3259,"2020/08/24","dbgap"
"6125","phs000280.v7.pht004090.v2.p1",6120,7409,13529,"2020/06/18","dbgap"
"6128","phs001259.v1.pht006089.v1.p1",726,1423,2149,"2019/04/23","dbgap"
"6129","phs000007.v32.pht000302.v2.p13",800,1144,1944,"2020/12/21","dbgap"
"6130","phs001812.v1.pht009106.v1.p1",64,51,115,"2021/02/22","dbgap"
"6131","phs000389.v1.pht002377.v1.p1",911,893,1804,"09/19/2011","dbgap"
"6132","phs001397.v1.pht006953.v1.p1",352,469,821,"2017/10/05","dbgap"
"6133","phs000437.v1.pht003687.v1.p1",4,8,12,"04/09/2014","dbgap"
"6134","phs001189.v4.pht005978.v2.p1",293,70,363,"2021/06/01","dbgap"
"6135","phs001700.v1.pht008503.v1.p1",39,85,124,"2020/11/24","dbgap"
"6138","phs001917.v1.pht009551.v1.p1",454,370,824,"2019/10/22","dbgap"
"6139","phs000201.v2.pht000886.v1.p1",49,37,86,"04/09/2014","dbgap"
"6140","phs000390.v1.pht002326.v1.p1",408,1209,1617,"04/20/2012","dbgap"
"6141","phs001803.v1.pht008940.v1.p1",223,696,919,"2019/04/04","dbgap"
"6142","phs000187.v1.pht000816.v1.p1",1807,1294,3101,"04/23/2010","dbgap"
"6143","phs000888.v1.pht005586.v1.p1",4903,6239,11142,"08/12/2016","dbgap"
"6144","phs001347.v2.pht006795.v2.p1",48,35,83,"2017/12/29","dbgap"
"6145","phs000280.v7.pht004051.v2.p1",6737,8064,14801,"2020/06/18","dbgap"
"6146","phs001318.v1.pht008020.v1.p1",24,13,37,"2018/05/31","dbgap"
"6147","phs002015.v1.pht010390.v1.p1",1732,2298,4030,"2020/09/18","dbgap"
"6148","phs001430.v2.pht008053.v2.p1",13,12,25,"2020/02/06","dbgap"
"6149","phs002059.v1.pht010421.v1.p1",1094,960,2054,"2020/12/18","dbgap"
"6150","phs002310.v1.pht011205.v1.p1",1345,576,1921,"2021/05/05","dbgap"
"6152","phs000816.v2.pht004340.v2.p1",199,225,424,"04/17/2017","dbgap"
"6153","phs001743.v1.pht008924.v1.p1",23,3,26,"2019/03/28","dbgap"
"6154","phs000337.v1.pht005337.v1.p1",56,38,94,"03/15/2016","dbgap"
"6155","phs000128.v3.pht000563.v2.p3",2943,3500,6443,"04/29/2016","dbgap"
"6156","phs001488.v1.pht007385.v1.p1",260,293,553,"2018/02/08","dbgap"
"6157","phs001027.v4.pht005214.v3.p1",94,61,155,"2021/06/23","dbgap"
"6159","phs001712.v1.pht008677.v1.p1",61,91,152,"2019/01/31","dbgap"
"6160","phs000007.v32.pht000164.v8.p13",1517,1746,3263,"2020/12/21","dbgap"
"6161","phs000939.v2.pht004789.v2.p1",13,7,20,"2017/08/31","dbgap"
"6162","phs001775.v1.pht008810.v1.p1",24,16,40,"2019/03/01","dbgap"
"6163","phs000095.v4.pht001212.v4.p2",2814,2605,5419,"2021/09/13","dbgap"
"6164","phs000490.v1.pht002968.v1.p1",700,300,1000,"2018/05/07","dbgap"
"6165","phs001089.v4.pht005483.v4.p1",729,674,1403,"2021/09/23","dbgap"
"6166","phs001228.v1.pht008133.v1.p1",571,541,1112,"2018/06/07","dbgap"
"6167","phs000339.v2.pht002137.v1.p1",46,88,134,"02/22/2013","dbgap"
"6168","phs000354.v1.pht003348.v1.p1",1,11,12,"06/25/2013","dbgap"
"6169","phs001759.v1.pht008708.v1.p1",1,6,7,"2019/03/08","dbgap"
"6171","phs001272.v1.pht007304.v1.p1",550,481,1031,"2018/11/16","dbgap"
"6172","phs002481.v1.pht011371.v1.p1",82,63,145,"2021/07/13","dbgap"
"6173","phs000343.v3.pht002719.v1.p1",86,30,116,"03/12/2013","dbgap"
"6174","phs000286.v6.pht001922.v2.p2",279,564,843,"2019/03/11","dbgap"
"6175","phs001345.v3.pht008604.v1.p1",382,882,1264,"2021/06/09","dbgap"
"6177","phs000625.v1.pht003851.v1.p1",3361,2762,6123,"06/13/2014","dbgap"
"6178","phs001929.v1.pht010015.v1.p1",325,275,600,"2020/03/26","dbgap"
"6179","phs000181.v1.pht000894.v1.p1",3282,3555,6837,"12/11/2009","dbgap"
"6180","phs000007.v32.pht000196.v6.p13",925,1071,1996,"2020/12/21","dbgap"
"6181","phs000456.v1.pht002642.v1.p1",1358,1151,2509,"05/02/2012","dbgap"
"6182","phs000007.v32.pht005167.v1.p13",90,134,224,"2020/12/21","dbgap"
"6183","phs000917.v1.pht004741.v1.p1",5982,1309,7291,"01/05/2016","dbgap"
"6184","phs001897.v1.pht009541.v1.p1",20,18,38,"2019/12/03","dbgap"
"6185","phs000925.v1.pht006203.v1.p1",4864,7881,12745,"03/22/2017","dbgap"
"6186","phs000888.v1.pht004676.v1.p1",25246,29783,55029,"08/12/2016","dbgap"
"6187","phs001784.v1.pht009001.v1.p1",30,11,41,"2019/06/24","dbgap"
"6188","phs000380.v1.pht002459.v1.p1",199,783,982,"01/13/2012","dbgap"
"6189","phs000285.v3.pht001642.v2.p2",442,472,914,"08/20/2013","dbgap"
"6190","phs001501.v1.pht007226.v1.p1",698,378,1076,"2020/08/24","dbgap"
"6191","phs002235.v1.pht010955.v1.p1",19,18,37,"2021/03/25","dbgap"
"6193","phs000285.v3.pht001678.v2.p2",906,1012,1918,"08/20/2013","dbgap"
"6194","phs002346.v1.pht011576.v1.p1",134,26,160,"2021/09/24","dbgap"
"6195","phs000563.v1.pht003085.v1.p1",1,3,4,"06/28/2013","dbgap"
"6196","phs000337.v1.pht005338.v1.p1",56,38,94,"03/15/2016","dbgap"
"6197","phs001278.v1.pht006270.v1.p1",65,72,137,"06/16/2017","dbgap"
"6198","phs000701.v1.pht005505.v1.p1",48,43,91,"06/01/2017","dbgap"
"6199","phs001318.v1.pht008034.v1.p1",16,11,27,"2018/05/31","dbgap"
"6200","phs000944.v1.pht004844.v1.p1",2051,2879,4930,"02/05/2016","dbgap"
"6202","phs001339.v1.pht006788.v1.p1",712,748,1460,"2020/06/02","dbgap"
"6204","phs001647.v1.pht008202.v1.p1",271,112,383,"2018/08/19","dbgap"
"6205","phs000170.v2.pht000981.v1.p1",5191,5803,10994,"02/27/2015","dbgap"
"6206","phs001488.v1.pht007389.v1.p1",259,293,552,"2018/02/08","dbgap"
"6208","phs001311.v1.pht007923.v1.p1",32,26,58,"2018/05/15","dbgap"
"6209","phs001959.v1.pht009790.v1.p1",2,3,5,"2020/03/05","dbgap"
"6210","phs000629.v1.pht003388.v1.p1",585,968,1553,"04/24/2015","dbgap"
"6211","phs000285.v3.pht001556.v2.p2",941,1061,2002,"08/20/2013","dbgap"
"6212","phs000674.v1.pht003637.v1.p1",33235,47680,80915,"01/27/2014","dbgap"
"6213","phs000209.v13.pht003659.v1.p3",3060,3369,6429,"11/05/2014","dbgap"
"6214","phs000128.v3.pht000435.v2.p3",2943,3500,6443,"04/29/2016","dbgap"
"6215","phs000007.v32.pht000169.v7.p13",1335,1690,3025,"2020/12/21","dbgap"
"6216","phs001522.v1.pht007730.v1.p1",654,637,1291,"2018/04/05","dbgap"
"6217","phs001124.v1.pht009255.v1.p1",47,228,275,"2019/07/22","dbgap"
"6218","phs000185.v7.pht008407.v1.p1",58,86,144,"2020/04/29","dbgap"
"6219","phs000832.v1.pht004424.v1.p1",199,182,381,"03/31/2015","dbgap"
"6221","phs000577.v1.pht007273.v1.p1",173,340,513,"2017/12/20","dbgap"
"6222","phs000018.v2.pht004354.v1.p1",1435,1611,3046,"12/16/2014","dbgap"
"6223","phs001730.v2.pht010131.v1.p1",24,17,41,"2021/08/26","dbgap"
"6225","phs001257.v2.pht006000.v2.p1",20,12,32,"03/24/2017","dbgap"
"6226","phs001503.v1.pht007313.v1.p1",12,870,882,"2018/01/04","dbgap"
"6227","phs000264.v2.pht001420.v2.p1",114,69,183,"03/04/2011","dbgap"
"6228","phs000606.v1.pht007572.v1.p1",745,275,1020,"2018/03/09","dbgap"
"6229","phs000573.v1.pht003215.v1.p1",49,33,82,"03/20/2013","dbgap"
"6230","phs001747.v1.pht008644.v1.p1",85,257,342,"2019/03/25","dbgap"
"6231","phs002292.v1.pht011105.v1.p1",11,12,23,"2021/04/09","dbgap"
"6232","phs001045.v1.pht009259.v1.p1",169,154,323,"2019/07/25","dbgap"
"6233","phs000848.v1.pht004408.v1.p1",1,2,3,"12/10/2014","dbgap"
"6234","phs001934.v1.pht009774.v1.p1",81,91,172,"2020/01/31","dbgap"
"6236","phs001592.v1.pht007976.v1.p1",51,7,58,"2018/05/16","dbgap"
"6237","phs000018.v2.pht004356.v1.p1",835,972,1807,"12/16/2014","dbgap"
"6238","phs000209.v13.pht001117.v3.p3",2826,3044,5870,"11/05/2014","dbgap"
"6239","phs001750.v1.pht008589.v1.p1",21,18,39,"2018/12/11","dbgap"
"6240","phs000209.v13.pht002301.v1.p3",624,917,1541,"11/05/2014","dbgap"
"6242","phs000524.v1.pht002917.v1.p1",1986,1612,3598,"12/27/2012","dbgap"
"6244","phs000571.v3.pht003190.v3.p2",1653,1220,2873,"12/01/2015","dbgap"
"6245","phs000280.v7.pht004228.v2.p1",885,943,1828,"2020/06/18","dbgap"
"6246","phs001130.v1.pht008415.v1.p1",290,305,595,"2018/09/26","dbgap"
"6247","phs002034.v1.pht010254.v1.p1",23,16,39,"2020/05/27","dbgap"
"6248","phs002499.v1.pht011447.v1.p1",6,3,9,"2021/08/05","dbgap"
"6249","phs001995.v1.pht009992.v1.p1",298,380,678,"2020/07/17","dbgap"
"6250","phs001879.v1.pht009457.v1.p1",92,77,169,"2019/09/19","dbgap"
"6251","phs001575.v2.pht008208.v2.p1",9,8,17,"2019/11/12","dbgap"
"6253","phs001721.v1.pht009717.v1.p1",2234,2574,4808,"2020/02/04","dbgap"
"6254","phs000286.v6.pht001948.v2.p2",680,1224,1904,"2019/03/11","dbgap"
"6255","phs000888.v1.pht005588.v1.p1",8827,12228,21055,"08/12/2016","dbgap"
"6256","phs001992.v1.pht010284.v1.p1",462,270,732,"2020/07/23","dbgap"
"6257","phs001372.v1.pht006534.v1.p1",3,2,5,"2017/10/10","dbgap"
"6259","phs001090.v1.pht009054.v1.p1",1134,2045,3179,"2019/05/21","dbgap"
"6260","phs000357.v2.pht002329.v2.p1",85,748,833,"2018/09/19","dbgap"
"6261","phs002632.v1.pht011607.v1.p1",242,607,849,"2021/10/19","dbgap"
"6262","phs002238.v1.pht011521.v1.p1",121,81,202,"2021/10/04","dbgap"
"6263","phs001013.v3.pht005312.v2.p2",606,408,1014,"2017/11/13","dbgap"
"6264","phs001329.v2.pht007176.v2.p1",1,4,5,"2019/05/07","dbgap"
"6265","phs000280.v7.pht004044.v5.p1",2452,1996,4448,"2020/06/18","dbgap"
"6266","phs000956.v5.pht005002.v1.p1",568,555,1123,"2021/05/07","dbgap"
"6267","phs001073.v2.pht005956.v2.p1",18,47,65,"2020/12/18","dbgap"
"6268","phs000344.v1.pht002168.v1.p1",301,595,896,"06/27/2011","dbgap"
"6269","phs002394.v1.pht011135.v1.p1",24,29,53,"2021/04/19","dbgap"
"6270","phs001048.v2.pht005658.v2.p1",171,136,307,"2019/04/10","dbgap"
"6271","phs000017.v3.pht000695.v1.p1",131,284,415,"Wed Nov 26 07:50:31 2008","dbgap"
"6272","phs000285.v3.pht001565.v2.p2",947,1064,2011,"08/20/2013","dbgap"
"6273","phs001306.v1.pht006187.v1.p1",5394,6280,11674,"06/01/2017","dbgap"
"6274","phs001330.v2.pht007530.v2.p1",25,15,40,"2019/11/08","dbgap"
"6275","phs000086.v3.pht000249.v1.p1",761,678,1439,"11/04/2014","dbgap"
"6276","phs001772.v2.pht008635.v2.p1",41,41,82,"2021/07/09","dbgap"
"6277","phs001238.v2.pht006044.v1.p1",258,572,830,"2018/06/14","dbgap"
"6280","phs000007.v32.pht000747.v7.p13",1352,1647,2999,"2020/12/21","dbgap"
"6281","phs000128.v3.pht000400.v2.p3",2943,3500,6443,"04/29/2016","dbgap"
"6283","phs001347.v2.pht006797.v2.p1",48,35,83,"2017/12/29","dbgap"
"6284","phs001252.v1.pht006380.v1.p1",1691,1055,2746,"05/16/2017","dbgap"
"6286","phs000128.v3.pht000449.v2.p3",2943,3500,6443,"04/29/2016","dbgap"
"6287","phs000397.v3.pht002409.v3.p3",2209,2704,4913,"2020/08/17","dbgap"
"6289","phs000969.v1.pht004932.v1.p1",2,2,4,"10/05/2015","dbgap"
"6290","phs000572.v8.pht003454.v5.p4",2088,2069,4157,"2019/11/19","dbgap"
"6291","phs001498.v1.pht007325.v1.p1",120,106,226,"2018/03/20","dbgap"
"6293","phs000016.v2.pht000050.v2.p2",795,123,918,"11/27/2009","dbgap"
"6294","phs000380.v1.pht002458.v1.p1",199,783,982,"01/13/2012","dbgap"
"6295","phs002025.v1.pht010236.v1.p1",2281,1718,3999,"2020/07/20","dbgap"
"6296","phs000086.v3.pht000268.v1.p1",750,675,1425,"11/04/2014","dbgap"
"6297","phs001007.v1.pht005068.v1.p1",19,4,23,"11/30/2015","dbgap"
"6298","phs001469.v1.pht007169.v1.p1",12,5,17,"2018/02/27","dbgap"
"6300","phs000092.v1.pht000637.v1.p1",104,158,262,"Wed Nov 19 17:41:30 2008","dbgap"
"6301","phs000285.v3.pht001619.v2.p2",3,5,8,"08/20/2013","dbgap"
"6302","phs000816.v2.pht004343.v2.p1",199,225,424,"04/17/2017","dbgap"
"6305","phs001202.v1.pht005773.v1.p1",7438,2672,10110,"07/10/2017","dbgap"
"6306","phs000160.v1.pht000735.v1.p1",925,1473,2398,"Fri Feb 20 11:36:16 2009","dbgap"
"6307","phs000288.v2.pht002519.v2.p2",1381,1188,2569,"2017/11/06","dbgap"
"6308","phs000007.v32.pht005140.v3.p13",1193,1512,2705,"2020/12/21","dbgap"
"6309","phs000433.v1.pht002433.v1.p1",2233,3635,5868,"04/04/2012","dbgap"
"6310","phs002405.v1.pht011235.v1.p1",7,9,16,"2021/08/13","dbgap"
"6311","phs001625.v1.pht008185.v1.p1",112,140,252,"2018/06/30","dbgap"
"6312","phs001880.v1.pht009561.v1.p1",194,235,429,"2019/10/28","dbgap"
"6313","phs000279.v2.pht001437.v2.p1",409,327,736,"01/11/2016","dbgap"
"6315","phs000280.v7.pht004110.v2.p1",2632,3073,5705,"2020/06/18","dbgap"
"6316","phs001013.v3.pht005311.v2.p2",709,495,1204,"2017/11/13","dbgap"
"6317","phs000577.v1.pht007283.v1.p1",6,8,14,"2017/12/20","dbgap"
"6319","phs000424.v8.pht002741.v8.p2",653,327,980,"2019/05/30","dbgap"
"6321","phs000280.v7.pht006470.v1.p1",1047,1257,2304,"2020/06/18","dbgap"
"6322","phs000280.v7.pht004209.v2.p1",3,2267,2270,"2020/06/18","dbgap"
"6325","phs000128.v3.pht000500.v2.p3",2943,3500,6443,"04/29/2016","dbgap"
"6327","phs000440.v1.pht002494.v1.p1",416,565,981,"03/15/2012","dbgap"
"6328","phs000336.v1.pht002220.v1.p1",9338,2179,11517,"04/21/2011","dbgap"
"6329","phs000417.v2.pht002400.v2.p1",177,93,270,"02/02/2012","dbgap"
"6331","phs001644.v2.pht009945.v2.p2",5029,6994,12023,"2021/08/08","dbgap"
"6332","phs001746.v1.pht008567.v1.p1",5,5,10,"2018/11/21","dbgap"
"6333","phs001559.v1.pht007662.v1.p1",155,28,183,"2018/03/20","dbgap"
"6334","phs000139.v1.pht000621.v1.p1",1247,1755,3002,"Thu Nov 20 13:22:56 2008","dbgap"
"6335","phs001222.v1.pht005908.v1.p1",476,938,1414,"2019/05/30","dbgap"
"6337","phs001899.v2.pht009572.v2.p1",883,997,1880,"2020/11/02","dbgap"
"6338","phs001329.v2.pht007175.v2.p1",1,4,5,"2019/05/07","dbgap"
"6339","phs001775.v1.pht008809.v1.p1",24,16,40,"2019/03/01","dbgap"
"6341","phs001488.v1.pht007414.v1.p1",260,293,553,"2018/02/08","dbgap"
"6342","phs000209.v13.pht001108.v4.p3",4644,5135,9779,"11/05/2014","dbgap"
"6344","phs002069.v1.pht010472.v1.p1",154,184,338,"2020/08/20","dbgap"
"6345","phs001367.v1.pht008245.v1.p1",5515,6015,11530,"2018/07/25","dbgap"
"6346","phs000542.v1.pht003017.v1.p1",2,2,4,"10/24/2012","dbgap"
"6348","phs000280.v7.pht004160.v2.p1",5365,6516,11881,"2020/06/18","dbgap"
"6349","phs000730.v1.pht005058.v1.p1",31,55,86,"11/13/2015","dbgap"
"6350","phs000424.v8.pht002743.v8.p2",653,327,980,"2019/05/30","dbgap"
"6351","phs001549.v1.pht008253.v1.p1",81,70,151,"2018/08/18","dbgap"
"6352","phs000577.v1.pht007289.v1.p1",35,54,89,"2017/12/20","dbgap"
"6353","phs001834.v1.pht009420.v1.p1",12,18,30,"2020/01/10","dbgap"
"6354","phs000639.v1.pht004781.v1.p1",465,302,767,"11/02/2015","dbgap"
"6355","phs001221.v1.pht007158.v1.p1",1138,461,1599,"2020/02/19","dbgap"
"6356","phs002003.v1.pht010107.v1.p1",19,19,38,"2020/04/06","dbgap"
"6357","phs000285.v3.pht001654.v2.p2",908,1013,1921,"08/20/2013","dbgap"
"6358","phs002545.v1.pht011487.v1.p1",19,7,26,"2021/09/14","dbgap"
"6359","phs001561.v1.pht010995.v1.p1",70,65,135,"2021/03/31","dbgap"
"6360","phs001064.v1.pht006835.v1.p1",3,3,6,"2018/02/27","dbgap"
"6361","phs001662.v2.pht010062.v1.p1",843,758,1601,"2021/08/19","dbgap"
"6362","phs001504.v2.pht007910.v2.p1",489,487,976,"2021/03/05","dbgap"
"6364","phs001216.v1.pht005787.v1.p1",241,206,447,"09/29/2016","dbgap"
"6365","phs001329.v2.pht007179.v2.p1",1,4,5,"2019/05/07","dbgap"
"6366","phs000701.v1.pht005522.v1.p1",48,43,91,"06/01/2017","dbgap"
"6367","phs001392.v1.pht006903.v1.p1",3,1,4,"2017/09/22","dbgap"
"6368","phs001872.v1.pht009366.v1.p1",290,309,599,"2019/07/31","dbgap"
"6369","phs001306.v1.pht006189.v1.p1",5394,6280,11674,"06/01/2017","dbgap"
"6370","phs002052.v1.pht010321.v1.p1",20,20,40,"2020/08/05","dbgap"
"6371","phs000452.v3.pht002592.v3.p1",144,86,230,"2020/02/27","dbgap"
"6372","phs001925.v1.pht010570.v1.p1",2,4,6,"2020/10/27","dbgap"
"6373","phs001804.v1.pht008966.v1.p1",2280,721,3001,"2019/04/23","dbgap"
"6374","phs000537.v1.pht003023.v1.p1",2,2,4,"10/24/2012","dbgap"
"6375","phs001430.v2.pht008068.v2.p1",13,10,23,"2020/02/06","dbgap"
"6376","phs001208.v2.pht008656.v1.p1",2523,2892,5415,"2019/08/10","dbgap"
"6377","phs000958.v1.pht004958.v1.p1",48,52,100,"08/31/2015","dbgap"
"6378","phs000280.v7.pht004061.v5.p1",1517,1529,3046,"2020/06/18","dbgap"
"6379","phs000588.v1.pht009305.v1.p1",42,150,192,"2019/07/26","dbgap"
"6381","phs000852.v1.pht006693.v1.p1",419,365,784,"07/26/2017","dbgap"
"6382","phs001753.v1.pht009018.v1.p1",91,132,223,"2019/05/01","dbgap"
"6383","phs001767.v1.pht008661.v1.p1",143,55,198,"2019/01/29","dbgap"
"6384","phs001660.v1.pht008414.v1.p1",59,44,103,"2018/10/05","dbgap"
"6386","phs000007.v32.pht003095.v4.p13",1091,898,1989,"2020/12/21","dbgap"
"6387","phs001322.v2.pht006330.v2.p1",8,4,12,"2018/04/30","dbgap"
"6389","phs000007.v32.pht006016.v4.p13",2384,2805,5189,"2020/12/21","dbgap"
"6390","phs000128.v3.pht000518.v2.p3",2943,3500,6443,"04/29/2016","dbgap"
"6391","phs001430.v2.pht008067.v2.p1",12,10,22,"2020/02/06","dbgap"
"6392","phs000744.v4.pht003978.v4.p2",1030,851,1881,"08/01/2016","dbgap"
"6393","phs001165.v1.pht007986.v1.p1",452,440,892,"2018/05/22","dbgap"
"6394","phs000617.v1.pht005477.v1.p1",162,128,290,"05/19/2016","dbgap"
"6395","phs000774.v2.pht004703.v1.p1",5553,6174,11727,"2017/12/29","dbgap"
"6397","phs001318.v1.pht008021.v1.p1",13,9,22,"2018/05/31","dbgap"
"6398","phs000128.v3.pht000574.v2.p3",2943,3500,6443,"04/29/2016","dbgap"
"6399","phs001590.v2.pht007891.v2.p1",9873,12975,22848,"2021/04/08","dbgap"
"6400","phs000707.v2.pht003716.v2.p1",10,8,18,"03/29/2017","dbgap"
"6401","phs000719.v1.pht003737.v1.p1",14,88,102,"04/15/2014","dbgap"
"6402","phs000434.v1.pht002605.v1.p1",4,4,8,"09/10/2012","dbgap"
"6403","phs000007.v32.pht002569.v6.p13",1529,1708,3237,"2020/12/21","dbgap"
"6405","phs001980.v1.pht010076.v1.p1",4,1,5,"2020/12/22","dbgap"
"6406","phs000285.v3.pht001786.v2.p2",867,969,1836,"08/20/2013","dbgap"
"6407","phs000576.v1.pht006141.v1.p1",116,128,244,"05/24/2017","dbgap"
"6408","phs000128.v3.pht000426.v2.p3",2943,3500,6443,"04/29/2016","dbgap"
"6409","phs000576.v1.pht006152.v1.p1",116,128,244,"05/24/2017","dbgap"
"6410","phs000125.v1.pht000320.v1.p1",1041,904,1945,"Thu Oct  2 11:09:51 2008","dbgap"
"6411","phs000615.v1.pht003308.v1.p1",5655,5429,11084,"08/14/2014","dbgap"
"6412","phs000886.v1.pht004646.v1.p1",30,44,74,"05/26/2016","dbgap"
"6413","phs000285.v3.pht001561.v2.p2",947,1065,2012,"08/20/2013","dbgap"
"6414","phs000209.v13.pht001209.v2.p3",3028,3312,6340,"11/05/2014","dbgap"
"6417","phs000777.v1.pht003973.v1.p1",4,6,10,"08/20/2014","dbgap"
"6418","phs001726.v2.pht009837.v1.p1",1137,1146,2283,"2021/09/24","dbgap"
"6419","phs002069.v1.pht010470.v1.p1",154,184,338,"2020/08/20","dbgap"
"6420","phs000086.v3.pht000325.v1.p1",596,530,1126,"11/04/2014","dbgap"
"6421","phs000286.v6.pht008742.v1.p2",939,1563,2502,"2019/03/11","dbgap"
"6422","phs002436.v1.pht011377.v1.p1",7,6,13,"2021/07/07","dbgap"
"6423","phs000280.v7.pht004125.v2.p1",4883,6018,10901,"2020/06/18","dbgap"
"6424","phs000102.v1.pht000189.v1.p1",129,137,266,"Mon Jun 16 14:31:57 2008","dbgap"
"6426","phs000280.v7.pht004194.v2.p1",5444,6661,12105,"2020/06/18","dbgap"
"6427","phs000577.v1.pht007281.v1.p1",169,322,491,"2017/12/20","dbgap"
"6428","phs001797.v1.pht008889.v1.p1",5,2,7,"2019/03/28","dbgap"
"6430","phs000612.v1.pht003528.v1.p1",25,35,60,"05/23/2014","dbgap"
"6431","phs000984.v1.pht005767.v1.p1",1,3,4,"09/21/2016","dbgap"
"6432","phs001712.v1.pht008673.v1.p1",59,73,132,"2019/01/31","dbgap"
"6434","phs001363.v1.pht006517.v1.p1",63,44,107,"2017/08/18","dbgap"
"6435","phs000280.v7.pht004098.v2.p1",6724,8035,14759,"2020/06/18","dbgap"
"6437","phs000778.v1.pht003967.v1.p1",1,4,5,"07/28/2014","dbgap"
"6438","phs001211.v4.pht005755.v4.p3",6142,7501,13643,"2021/09/22","dbgap"
"6442","phs001479.v1.pht008102.v1.p1",1,1,2,"2018/06/07","dbgap"
"6443","phs000007.v32.pht000029.v3.p13",124,287,411,"2020/12/21","dbgap"
"6444","phs000285.v3.pht001836.v2.p2",876,990,1866,"08/20/2013","dbgap"
"6445","phs000103.v1.pht001888.v1.p1",3197,3080,6277,"09/27/2010","dbgap"
"6446","phs000774.v2.pht004702.v2.p1",5653,6272,11925,"2017/12/29","dbgap"
"6448","phs000007.v32.pht010730.v1.p13",570,837,1407,"2020/12/21","dbgap"
"6449","phs001347.v2.pht006794.v2.p1",150,120,270,"2017/12/29","dbgap"
"6450","phs000280.v7.pht004049.v5.p1",3652,3266,6918,"2020/06/18","dbgap"
"6451","phs001238.v2.pht006039.v1.p1",573,1281,1854,"2018/06/14","dbgap"
"6452","phs001585.v1.pht008831.v1.p1",255,179,434,"2019/03/18","dbgap"
"6453","phs001955.v1.pht009792.v1.p1",6666,6737,13403,"2020/07/06","dbgap"
"6454","phs000984.v1.pht005008.v1.p1",97,107,204,"09/21/2016","dbgap"
"6455","phs000739.v1.pht003826.v1.p1",5,2,7,"05/02/2014","dbgap"
"6456","phs000871.v1.pht004571.v1.p1",16,17,33,"05/08/2017","dbgap"
"6457","phs000130.v1.pht000652.v1.p1",973,990,1963,"Mon Oct 27 17:24:54 2008","dbgap"
"6458","phs000280.v7.pht004032.v2.p1",6784,8156,14940,"2020/06/18","dbgap"
"6459","phs000578.v1.pht007020.v1.p1",46,42,88,"2017/10/11","dbgap"
"6460","phs002015.v1.pht010378.v1.p1",1816,2387,4203,"2020/09/18","dbgap"
"6461","phs000959.v1.pht009702.v1.p1",1343,194,1537,"2019/12/16","dbgap"
"6462","phs000876.v2.pht005185.v2.p1",1147,815,1962,"2020/03/04","dbgap"
"6463","phs001410.v1.pht008422.v1.p1",106,194,300,"2018/09/26","dbgap"
"6465","phs000285.v3.pht001764.v2.p2",68,101,169,"08/20/2013","dbgap"
"6466","phs001232.v4.pht006080.v4.p2",2014,2108,4122,"2021/08/23","dbgap"
"6467","phs001281.v2.pht006124.v2.p1",15,25,40,"2019/02/21","dbgap"
"6468","phs000209.v13.pht001206.v2.p3",1687,1701,3388,"11/05/2014","dbgap"
"6469","phs001617.v1.pht010620.v1.p1",105,89,194,"2021/01/12","dbgap"
"6470","phs001292.v2.pht007851.v2.p1",238,538,776,"2019/06/03","dbgap"
"6471","phs001728.v2.pht010123.v1.p1",34,16,50,"2021/08/25","dbgap"
"6472","phs001286.v1.pht007887.v1.p1",10464,2691,13155,"2019/03/27","dbgap"
"6473","phs000418.v2.pht002615.v1.p1",7,1,8,"04/10/2014","dbgap"
"6474","phs001182.v2.pht005721.v2.p1",8,13,21,"2020/09/18","dbgap"
"6476","phs001797.v1.pht008890.v1.p1",5,2,7,"2019/03/28","dbgap"
"6477","phs001993.v1.pht010087.v1.p1",17,22,39,"2020/09/04","dbgap"
"6478","phs000248.v1.pht001199.v1.p1",2058,1369,3427,"02/10/2014","dbgap"
"6479","phs000286.v6.pht008760.v1.p2",895,1482,2377,"2019/03/11","dbgap"
"6480","phs001901.v1.pht009501.v1.p1",901,567,1468,"2019/10/02","dbgap"
"6482","phs001318.v1.pht008025.v1.p1",28,13,41,"2018/05/31","dbgap"
"6483","phs001471.v1.pht009802.v1.p1",189,475,664,"2020/01/10","dbgap"
"6484","phs000086.v3.pht000263.v1.p1",748,670,1418,"11/04/2014","dbgap"
"6485","phs000962.v1.pht006964.v1.p1",293,228,521,"2017/10/02","dbgap"
"6486","phs000211.v1.pht000912.v1.p1",167,233,400,"09/16/2009","dbgap"
"6488","phs002487.v1.pht011541.v1.p1",42,16,58,"2021/09/13","dbgap"
"6489","phs001641.v1.pht010027.v1.p1",741,1643,2384,"2020/03/24","dbgap"
"6491","phs001442.v3.pht008326.v3.p2",12416,12161,24577,"2021/08/13","dbgap"
"6492","phs000430.v1.pht003053.v1.p1",696,270,966,"06/20/2013","dbgap"
"6493","phs000490.v1.pht002961.v1.p1",3928,3502,7430,"2018/05/07","dbgap"
"6494","phs001326.v1.pht007799.v1.p1",171,56,227,"2018/04/16","dbgap"
"6495","phs001993.v1.pht010086.v1.p1",30,39,69,"2020/09/04","dbgap"
"6497","phs001840.v1.pht009149.v1.p1",4,2,6,"2019/06/13","dbgap"
"6498","phs001282.v2.pht006099.v2.p1",29,8,37,"2020/01/21","dbgap"
"6499","phs002290.v1.pht010822.v1.p1",82,36,118,"2020/12/30","dbgap"
"6501","phs000211.v1.pht000913.v1.p1",167,233,400,"09/16/2009","dbgap"
"6503","phs000594.v1.pht006507.v1.p1",6,3,9,"06/12/2017","dbgap"
"6504","phs000884.v1.pht004599.v1.p1",146,94,240,"03/17/2015","dbgap"
"6505","phs001455.v1.pht007757.v1.p1",1905,3890,5795,"2018/04/04","dbgap"
"6506","phs001561.v1.pht010999.v1.p1",70,65,135,"2021/03/31","dbgap"
"6507","phs000353.v1.pht002254.v1.p1",75,59,134,"08/08/2011","dbgap"
"6508","phs001712.v1.pht008678.v1.p1",2,18,20,"2019/01/31","dbgap"
"6509","phs002480.v1.pht011458.v1.p1",3,1,4,"2021/08/11","dbgap"
"6510","phs000128.v3.pht000491.v2.p3",2943,3500,6443,"04/29/2016","dbgap"
"6511","phs000275.v1.pht002970.v1.p1",235,689,924,"09/28/2012","dbgap"
"6512","phs000351.v1.pht002206.v1.p1",3506,1229,4735,"05/13/2011","dbgap"
"6513","phs001592.v1.pht007977.v1.p1",51,7,58,"2018/05/16","dbgap"
"6514","phs000361.v1.pht002223.v1.p1",3829,1794,5623,"05/04/2011","dbgap"
"6515","phs001065.v1.pht005414.v1.p1",296,313,609,"05/24/2016","dbgap"
"6516","phs000434.v1.pht002607.v1.p1",4,4,8,"09/10/2012","dbgap"
"6518","phs000007.v32.pht007777.v2.p13",2294,2785,5079,"2020/12/21","dbgap"
"6519","phs000086.v3.pht000243.v1.p1",761,680,1441,"11/04/2014","dbgap"
"6520","phs000500.v1.pht003116.v1.p1",4,2,6,"12/31/2012","dbgap"
"6521","phs001400.v1.pht006824.v1.p1",2,2,4,"2017/11/09","dbgap"
"6522","phs001300.v1.pht006722.v1.p1",276,156,432,"2018/01/18","dbgap"
"6523","phs000984.v1.pht005703.v1.p1",95,105,200,"09/21/2016","dbgap"
"6524","phs001194.v3.pht005831.v2.p2",503,463,966,"2020/07/24","dbgap"
"6525","phs001067.v1.pht005284.v1.p1",2,1,3,"02/02/2016","dbgap"
"6526","phs000745.v1.pht003850.v1.p1",10,10,20,"05/19/2014","dbgap"
"6527","phs001661.v3.pht010559.v1.p1",2791,2673,5464,"2021/08/17","dbgap"
"6529","phs000492.v3.pht002707.v3.p2",53,55,108,"2018/10/19","dbgap"
"6530","phs000266.v4.pht001266.v4.p1",71,43,114,"09/09/2013","dbgap"
"6531","phs001206.v1.pht007342.v1.p1",6,6,12,"2018/02/27","dbgap"
"6532","phs000606.v1.pht007576.v1.p1",745,276,1021,"2018/03/09","dbgap"
"6533","phs000382.v3.pht002322.v3.p1",51,55,106,"2018/01/18","dbgap"
"6534","phs000287.v7.pht001488.v1.p1",2375,3156,5531,"2020/01/23","dbgap"
"6536","phs001410.v1.pht008423.v1.p1",106,194,300,"2018/09/26","dbgap"
"6537","phs000285.v3.pht001748.v1.p2",5,13,18,"08/20/2013","dbgap"
"6538","phs000280.v7.pht006465.v1.p1",1111,1401,2512,"2020/06/18","dbgap"
"6539","phs001216.v1.pht005786.v1.p1",241,206,447,"09/29/2016","dbgap"
"6540","phs000879.v1.pht005032.v1.p1",15,15,30,"10/14/2015","dbgap"
"6541","phs001289.v1.pht007795.v1.p1",16,11,27,"2018/04/16","dbgap"
"6542","phs000209.v13.pht003606.v1.p3",2771,2985,5756,"11/05/2014","dbgap"
"6543","phs002037.v1.pht010268.v1.p1",126,112,238,"2020/06/10","dbgap"
"6544","phs001706.v1.pht008455.v1.p1",17,15,32,"2018/10/11","dbgap"
"6545","phs000864.v1.pht004491.v1.p1",3979,19,3998,"05/08/2015","dbgap"
"6546","phs000280.v7.pht006454.v1.p1",2333,3157,5490,"2020/06/18","dbgap"
"6547","phs001055.v1.pht005913.v1.p1",413,404,817,"2017/08/16","dbgap"
"6548","phs000590.v1.pht008263.v1.p1",1,1,2,"2018/08/03","dbgap"
"6549","phs001248.v1.pht006092.v1.p1",42,52,94,"03/06/2017","dbgap"
"6550","phs001934.v1.pht009775.v1.p1",55,66,121,"2020/01/31","dbgap"
"6551","phs001331.v2.pht006929.v2.p1",543,362,905,"2019/08/30","dbgap"
"6552","phs001750.v1.pht008586.v1.p1",21,18,39,"2018/12/11","dbgap"
"6553","phs001053.v1.pht007229.v1.p1",202,270,472,"2017/12/13","dbgap"
"6554","phs000128.v3.pht000422.v2.p3",2943,3500,6443,"04/29/2016","dbgap"
"6561","phs000287.v7.pht001457.v1.p1",2375,3156,5531,"2020/01/23","dbgap"
"6562","phs000285.v3.pht001603.v2.p2",80,83,163,"08/20/2013","dbgap"
"6563","phs000885.v1.pht004604.v1.p1",42,8,50,"03/19/2015","dbgap"
"6564","phs000516.v2.pht002830.v2.p1",34,25,59,"03/10/2015","dbgap"
"6565","phs000540.v1.pht003045.v1.p1",5,3,8,"11/08/2012","dbgap"
"6566","phs001025.v1.pht005085.v1.p1",292,1987,2279,"11/06/2015","dbgap"
"6568","phs000955.v1.pht005452.v1.p1",1744,2385,4129,"06/09/2016","dbgap"
"6569","phs000007.v32.pht000171.v8.p13",1518,1752,3270,"2020/12/21","dbgap"
"6570","phs000592.v1.pht006594.v1.p1",36,26,62,"07/12/2017","dbgap"
"6572","phs001425.v1.pht006755.v1.p1",22,12,34,"2017/08/09","dbgap"
"6573","phs000128.v3.pht000481.v2.p3",2943,3500,6443,"04/29/2016","dbgap"
"6575","phs000827.v3.pht004472.v3.p1",241,351,592,"11/14/2016","dbgap"
"6578","phs001649.v1.pht008516.v1.p1",299,170,469,"2019/02/19","dbgap"
"6579","phs001644.v2.pht009944.v2.p2",5031,7019,12050,"2021/08/08","dbgap"
"6580","phs000500.v1.pht003115.v1.p1",4,2,6,"12/31/2012","dbgap"
"6581","phs000287.v7.pht001494.v1.p1",2375,3156,5531,"2020/01/23","dbgap"
"6583","phs000285.v3.pht001599.v2.p2",911,1033,1944,"08/20/2013","dbgap"
"6584","phs000894.v1.pht004658.v1.p1",320,235,555,"05/12/2015","dbgap"
"6585","phs000220.v2.pht002386.v2.p2",9846,11506,21352,"2018/06/11","dbgap"
"6586","phs000128.v3.pht000596.v2.p3",2943,3500,6443,"04/29/2016","dbgap"
"6587","phs001327.v2.pht011180.v1.p1",13724,11941,25665,"2021/05/07","dbgap"
"6588","phs000128.v3.pht000412.v2.p3",2943,3500,6443,"04/29/2016","dbgap"
"6589","phs000545.v1.pht003762.v1.p1",482,282,764,"06/10/2015","dbgap"
"6590","phs000093.v2.pht000120.v2.p2",4086,1570,5656,"03/18/2010","dbgap"
"6591","phs001711.v1.pht008528.v1.p1",5,3,8,"2021/02/11","dbgap"
"6592","phs000817.v1.pht004415.v1.p1",2,6,8,"01/05/2015","dbgap"
"6594","phs000016.v2.pht000054.v2.p2",789,122,911,"11/27/2009","dbgap"
"6595","phs000987.v1.pht004971.v1.p1",101,83,184,"04/05/2017","dbgap"
"6596","phs000239.v2.pht001222.v1.p1",2,4,6,"07/21/2010","dbgap"
"6597","phs002022.v1.pht010184.v1.p1",8,15,23,"2020/07/10","dbgap"
"6598","phs000390.v1.pht002325.v1.p1",408,1209,1617,"04/20/2012","dbgap"
"6599","phs001549.v1.pht008251.v1.p1",81,70,151,"2018/08/18","dbgap"
"6601","phs000007.v32.pht002078.v7.p13",1351,1539,2890,"2020/12/21","dbgap"
"6602","phs001435.v2.pht009876.v1.p1",79,41,120,"2021/06/23","dbgap"
"6603","phs000285.v3.pht001591.v2.p2",947,1064,2011,"08/20/2013","dbgap"
"6604","phs000086.v3.pht000624.v1.p1",714,648,1362,"11/04/2014","dbgap"
"6605","phs000957.v1.pht004853.v1.p1",3625,5582,9207,"07/31/2015","dbgap"
"6607","phs002487.v1.pht011542.v1.p1",42,16,58,"2021/09/13","dbgap"
"6608","phs000128.v3.pht000405.v2.p3",2943,3500,6443,"04/29/2016","dbgap"
"6609","phs000922.v2.pht004924.v2.p1",252,83,335,"2021/05/24","dbgap"
"6610","phs000663.v3.pht003553.v3.p3",669,880,1549,"2021/08/31","dbgap"
"6611","phs000285.v3.pht001723.v2.p2",879,977,1856,"08/20/2013","dbgap"
"6612","phs000576.v1.pht006149.v1.p1",116,127,243,"05/24/2017","dbgap"
"6613","phs000286.v6.pht008735.v1.p2",1266,2104,3370,"2019/03/11","dbgap"
"6614","phs001911.v1.pht009520.v1.p1",6,11,17,"2019/10/08","dbgap"
"6615","phs000372.v1.pht002856.v1.p1",2595,3470,6065,"02/13/2014","dbgap"
"6616","phs000700.v2.pht003648.v2.p1",2,1,3,"2019/11/15","dbgap"
"6618","phs000888.v1.pht005568.v1.p1",2383,3426,5809,"08/12/2016","dbgap"
"6619","phs002408.v1.pht011162.v1.p1",4,3,7,"2021/04/28","dbgap"
"6620","phs000507.v2.pht002928.v2.p2",433,769,1202,"2018/11/05","dbgap"
"6622","phs000280.v7.pht004069.v2.p1",524,480,1004,"2020/06/18","dbgap"
"6623","phs000622.v1.pht003955.v1.p1",1584,1973,3557,"07/25/2014","dbgap"
"6624","phs000869.v1.pht004610.v1.p1",5547,1376,6923,"03/19/2015","dbgap"
"6625","phs001392.v1.pht006882.v1.p1",20,10,30,"2017/09/22","dbgap"
"6626","phs001430.v2.pht008069.v2.p1",13,9,22,"2020/02/06","dbgap"
"6627","phs000404.v1.pht002369.v1.p1",822,1150,1972,"12/13/2011","dbgap"
"6629","phs000128.v3.pht000445.v2.p3",2943,3500,6443,"04/29/2016","dbgap"
"6631","phs000086.v3.pht000327.v1.p1",542,584,1126,"11/04/2014","dbgap"
"6633","phs001818.v3.pht009316.v2.p1",7,8,15,"2021/03/11","dbgap"
"6634","phs001238.v2.pht006040.v1.p1",573,1281,1854,"2018/06/14","dbgap"
"6635","phs000539.v1.pht003020.v1.p1",3,5,8,"11/29/2012","dbgap"
"6636","phs001472.v2.pht007116.v1.p1",1574,891,2465,"2021/07/07","dbgap"
"6637","phs000237.v1.pht002161.v1.p1",1482,1961,3443,"04/18/2011","dbgap"
"6638","phs000496.v1.pht003168.v1.p1",1056,2097,3153,"03/28/2014","dbgap"
"6639","phs001880.v1.pht009563.v1.p1",194,235,429,"2019/10/28","dbgap"
"6641","phs000707.v2.pht003717.v2.p1",10,8,18,"03/29/2017","dbgap"
"6642","phs000343.v3.pht002726.v1.p1",1379,785,2164,"03/12/2013","dbgap"
"6643","phs000285.v3.pht001671.v2.p2",909,1016,1925,"08/20/2013","dbgap"
"6644","phs002000.v1.pht010120.v1.p1",36,34,70,"2020/06/11","dbgap"
"6645","phs000521.v2.pht007042.v2.p1",70,57,127,"2020/03/13","dbgap"
"6646","phs000007.v32.pht000904.v7.p13",1125,933,2058,"2020/12/21","dbgap"
"6647","phs000286.v6.pht001921.v2.p2",1183,1938,3121,"2019/03/11","dbgap"
"6648","phs000265.v3.pht001272.v3.p1",37,32,69,"10/17/2011","dbgap"
"6649","phs001331.v2.pht006932.v2.p1",205,132,337,"2019/08/30","dbgap"
"6651","phs001378.v1.pht006690.v1.p1",4,2,6,"2019/05/02","dbgap"
"6652","phs001565.v1.pht007898.v1.p1",39,32,71,"2018/05/10","dbgap"
"6656","phs000297.v1.pht002393.v1.p1",2289,2992,5281,"07/27/2012","dbgap"
"6657","phs001458.v1.pht007779.v1.p1",5868,5910,11778,"2018/04/12","dbgap"
"6658","phs001209.v1.pht006803.v1.p1",4,9,13,"2017/08/22","dbgap"
"6659","phs000361.v1.pht002221.v1.p1",3829,1794,5623,"05/04/2011","dbgap"
"6663","phs002317.v1.pht011166.v1.p1",232,183,415,"2021/05/04","dbgap"
"6665","phs000250.v1.pht002188.v1.p1",196,155,351,"07/06/2011","dbgap"
"6666","phs002440.v1.pht011282.v1.p1",1,1,2,"2021/06/07","dbgap"
"6667","phs000584.v1.pht010798.v1.p1",869,1239,2108,"2021/01/27","dbgap"
"6668","phs001212.v1.pht006565.v1.p1",26,27,53,"2017/10/13","dbgap"
"6669","phs000249.v2.pht001878.v2.p1",253,128,381,"04/16/2014","dbgap"
"6670","phs001505.v1.pht007319.v1.p1",268,140,408,"2018/09/06","dbgap"
"6671","phs000007.v32.pht000389.v12.p13",1562,1082,2644,"2020/12/21","dbgap"
"6672","phs001972.v1.pht009844.v1.p1",1273,1411,2684,"2020/06/30","dbgap"
"6673","phs000280.v7.pht009464.v2.p1",2615,2759,5374,"2020/06/18","dbgap"
"6675","phs001331.v2.pht006934.v2.p1",453,296,749,"2019/08/30","dbgap"
"6677","phs001498.v1.pht007322.v1.p1",346,332,678,"2018/03/20","dbgap"
"6678","phs000405.v1.pht002610.v1.p1",6,7,13,"11/15/2012","dbgap"
"6679","phs002188.v1.pht011033.v1.p1",5,5,10,"2021/03/22","dbgap"
"6680","phs001488.v1.pht007378.v1.p1",260,293,553,"2018/02/08","dbgap"
"6681","phs001488.v1.pht007380.v1.p1",192,203,395,"2018/02/08","dbgap"
"6682","phs001943.v1.pht009715.v1.p1",14,20,34,"2019/12/17","dbgap"
"6683","phs000368.v1.pht002292.v1.p1",40,4189,4229,"10/07/2011","dbgap"
"6684","phs001541.v1.pht008307.v1.p1",448,10907,11355,"2019/11/25","dbgap"
"6685","phs000280.v7.pht006413.v1.p1",2188,2911,5099,"2020/06/18","dbgap"
"6686","phs000007.v32.pht000026.v3.p13",236,477,713,"2020/12/21","dbgap"
"6687","phs000460.v1.pht003585.v1.p1",553,1129,1682,"11/22/2013","dbgap"
"6688","phs000007.v32.pht000113.v8.p13",945,1006,1951,"2020/12/21","dbgap"
"6689","phs001854.v1.pht009254.v1.p1",3,3,6,"2019/10/07","dbgap"
"6692","phs001158.v2.pht005592.v2.p1",11,10,21,"2019/02/05","dbgap"
"6694","phs000335.v3.pht002113.v2.p2",2796,1645,4441,"07/25/2014","dbgap"
"6695","phs000086.v3.pht000358.v1.p1",59,63,122,"11/04/2014","dbgap"
"6696","phs001836.v1.pht009218.v1.p1",1,3,4,"2019/06/24","dbgap"
"6697","phs000007.v32.pht009761.v1.p13",209,285,494,"2020/12/21","dbgap"
"6699","phs001662.v2.pht010065.v1.p1",843,758,1601,"2021/08/19","dbgap"
"6700","phs001333.v2.pht006531.v2.p1",9,10,19,"2019/08/29","dbgap"
"6702","phs000228.v4.pht001187.v3.p1",122,244,366,"03/21/2017","dbgap"
"6703","phs001194.v3.pht005813.v2.p2",5072,4605,9677,"2020/07/24","dbgap"
"6704","phs001620.v1.pht008180.v1.p1",673,1338,2011,"2018/06/30","dbgap"
"6705","phs001979.v1.pht010000.v1.p1",5,2,7,"2020/03/19","dbgap"
"6706","phs002040.v1.pht010260.v1.p1",2,1,3,"2020/06/02","dbgap"
"6707","phs000286.v6.pht008731.v1.p2",942,1573,2515,"2019/03/11","dbgap"
"6710","phs000285.v3.pht001664.v2.p2",573,604,1177,"08/20/2013","dbgap"
"6711","phs001776.v1.pht009210.v1.p1",51,40,91,"2019/06/19","dbgap"
"6712","phs001430.v2.pht008054.v2.p1",13,10,23,"2020/02/06","dbgap"
"6713","phs000209.v13.pht002196.v1.p3",188,282,470,"11/05/2014","dbgap"
"6714","phs001326.v1.pht007827.v1.p1",24,1,25,"2018/04/16","dbgap"
"6715","phs000718.v1.pht003841.v1.p1",1080,1150,2230,"06/09/2015","dbgap"
"6716","phs000772.v1.pht003994.v1.p1",2,1,3,"08/21/2014","dbgap"
"6717","phs001908.v2.pht009532.v2.p1",5,7,12,"2021/04/27","dbgap"
"6719","phs000103.v1.pht001889.v1.p1",1028,2858,3886,"09/27/2010","dbgap"
"6720","phs000509.v1.pht004315.v1.p1",55,23,78,"02/18/2015","dbgap"
"6722","phs000007.v32.pht000209.v8.p13",1353,1669,3022,"2020/12/21","dbgap"
"6723","phs000007.v32.pht001227.v6.p13",881,830,1711,"2020/12/21","dbgap"
"6724","phs001734.v1.pht008823.v1.p1",363,244,607,"2019/03/25","dbgap"
"6725","phs000280.v7.pht006476.v1.p1",1026,1233,2259,"2020/06/18","dbgap"
"6726","phs000128.v3.pht000514.v2.p3",2943,3500,6443,"04/29/2016","dbgap"
"6727","phs001792.v1.pht008930.v1.p1",92,372,464,"2019/04/15","dbgap"
"6728","phs001318.v1.pht008039.v1.p1",24,13,37,"2018/05/31","dbgap"
"6729","phs001065.v1.pht005413.v1.p1",296,313,609,"05/24/2016","dbgap"
"6730","phs002015.v1.pht010396.v1.p1",1816,2387,4203,"2020/09/18","dbgap"
"6731","phs000237.v1.pht002162.v1.p1",1515,2027,3542,"04/18/2011","dbgap"
"6732","phs001367.v1.pht008246.v1.p1",1560,1582,3142,"2018/07/25","dbgap"
"6733","phs001096.v1.pht005608.v1.p1",519,568,1087,"08/09/2016","dbgap"
"6734","phs000574.v1.pht005874.v1.p1",31,859,890,"03/06/2017","dbgap"
"6736","phs000982.v1.pht004984.v1.p1",1358,1489,2847,"09/14/2015","dbgap"
"6740","phs000257.v3.pht001248.v3.p1",32,37,69,"2018/09/19","dbgap"
"6741","phs000007.v32.pht000165.v7.p13",1498,1713,3211,"2020/12/21","dbgap"
"6742","phs000575.v2.pht005899.v2.p1",177,213,390,"2020/02/14","dbgap"
"6743","phs000219.v1.pht001050.v1.p1",359,496,855,"01/19/2010","dbgap"
"6744","phs000874.v1.pht004655.v1.p1",498,452,950,"04/13/2015","dbgap"
"6745","phs001348.v2.pht006236.v2.p1",24,21,45,"2017/09/25","dbgap"
"6748","phs000277.v2.pht003389.v2.p1",3616,2870,6486,"2020/04/02","dbgap"
"6750","phs000639.v1.pht004779.v1.p1",464,323,787,"11/02/2015","dbgap"
"6751","phs000280.v7.pht004198.v2.p1",6119,7410,13529,"2020/06/18","dbgap"
"6752","phs001020.v2.pht005782.v2.p1",784,467,1251,"2019/10/18","dbgap"
"6754","phs001332.v2.pht007455.v2.p1",158,188,346,"2019/11/08","dbgap"
"6755","phs000586.v1.pht004833.v1.p1",285,768,1053,"08/18/2015","dbgap"
"6756","phs002040.v1.pht010261.v1.p1",2,1,3,"2020/06/02","dbgap"
"6757","phs000588.v1.pht009280.v1.p1",42,151,193,"2019/07/26","dbgap"
"6760","phs001810.v1.pht009068.v1.p1",831,716,1547,"2019/07/01","dbgap"
"6761","phs000285.v3.pht001854.v2.p2",779,836,1615,"08/20/2013","dbgap"
"6762","phs000740.v1.pht003816.v1.p1",24,6,30,"04/22/2014","dbgap"
"6763","phs000572.v8.pht003393.v5.p4",223,355,578,"2019/11/19","dbgap"
"6764","phs000086.v3.pht000223.v1.p1",591,566,1157,"11/04/2014","dbgap"
"6766","phs000286.v6.pht008734.v1.p2",228,381,609,"2019/03/11","dbgap"
"6768","phs000719.v1.pht003738.v1.p1",14,88,102,"04/15/2014","dbgap"
"6769","phs001312.v1.pht007202.v1.p1",2045,3143,5188,"2017/12/07","dbgap"
"6770","phs000223.v1.pht002621.v1.p1",1420,2323,3743,"03/14/2012","dbgap"
"6772","phs000582.v1.pht003244.v1.p1",7,5,12,"05/16/2013","dbgap"
"6773","phs001518.v1.pht007334.v1.p1",1764,815,2579,"2020/01/07","dbgap"
"6774","phs000819.v1.pht004378.v1.p1",6,14,20,"2018/01/18","dbgap"
"6775","phs000280.v7.pht004207.v2.p1",6616,7960,14576,"2020/06/18","dbgap"
"6777","phs000219.v1.pht001072.v1.p1",664,1054,1718,"01/19/2010","dbgap"
"6778","phs000285.v3.pht001703.v2.p2",867,952,1819,"08/20/2013","dbgap"
"6779","phs001241.v1.pht005923.v1.p1",7,8,15,"2017/11/14","dbgap"
"6780","phs001753.v1.pht009017.v1.p1",91,132,223,"2019/05/01","dbgap"
"6781","phs001376.v1.pht006555.v1.p1",4,5,9,"06/15/2017","dbgap"
"6782","phs000603.v1.pht007545.v1.p1",3,9,12,"2018/03/06","dbgap"
"6784","phs000171.v1.pht000765.v1.p1",636,1284,1920,"12/11/2009","dbgap"
"6785","phs000086.v3.pht000265.v1.p1",744,665,1409,"11/04/2014","dbgap"
"6786","phs000759.v1.pht003914.v1.p1",8,10,18,"06/20/2014","dbgap"
"6788","phs000007.v32.pht010734.v1.p13",1423,1734,3157,"2020/12/21","dbgap"
"6789","phs000285.v3.pht001736.v2.p2",875,954,1829,"08/20/2013","dbgap"
"6791","phs001296.v2.pht006356.v2.p1",11,30,41,"2019/05/31","dbgap"
"6793","phs000093.v2.pht000119.v1.p2",3064,873,3937,"10/09/2009","dbgap"
"6794","phs000710.v1.pht003988.v1.p1",1,2,3,"04/29/2015","dbgap"
"6795","phs002341.v1.pht011060.v1.p1",36,36,72,"2021/03/24","dbgap"
"6796","phs000954.v4.pht006299.v2.p2",580,710,1290,"2021/05/11","dbgap"
"6797","phs001512.v1.pht007667.v1.p1",7,10,17,"2018/03/21","dbgap"
"6799","phs000103.v1.pht000190.v1.p1",1093,975,2068,"09/27/2010","dbgap"
"6800","phs000902.v1.pht004670.v1.p1",607,177,784,"01/20/2016","dbgap"
"6802","phs000209.v13.pht001120.v10.p3",3060,3369,6429,"11/05/2014","dbgap"
"6804","phs000182.v2.pht000796.v1.p1",1375,2028,3403,"08/06/2010","dbgap"
"6806","phs000862.v1.pht007834.v1.p1",1,4,5,"2018/04/16","dbgap"
"6807","phs000262.v3.pht001279.v3.p2",31,11,42,"2017/09/05","dbgap"
"6808","phs000623.v1.pht003337.v1.p1",47,59,106,"08/16/2013","dbgap"
"6809","phs002481.v1.pht011374.v1.p1",82,63,145,"2021/07/13","dbgap"
"6810","phs001238.v2.pht006032.v1.p1",168,443,611,"2018/06/14","dbgap"
"6811","phs000637.v1.pht003534.v1.p1",650,617,1267,"10/21/2013","dbgap"
"6812","phs000285.v3.pht001601.v2.p2",909,1032,1941,"08/20/2013","dbgap"
"6813","phs000814.v1.pht004581.v1.p1",3187,405,3592,"01/07/2016","dbgap"
"6814","phs000285.v3.pht001834.v2.p2",876,990,1866,"08/20/2013","dbgap"
"6816","phs002002.v1.pht010190.v1.p1",6,2,8,"2020/04/27","dbgap"
"6817","phs001327.v2.pht011181.v1.p1",13724,11941,25665,"2021/05/07","dbgap"
"6818","phs001053.v1.pht007230.v1.p1",92,124,216,"2017/12/13","dbgap"
"6819","phs000280.v7.pht004086.v2.p1",1783,1668,3451,"2020/06/18","dbgap"
"6820","phs000007.v32.pht003633.v4.p13",236,288,524,"2020/12/21","dbgap"
"6821","phs000869.v1.pht004609.v1.p1",5550,1379,6929,"03/19/2015","dbgap"
"6823","phs000521.v2.pht007040.v2.p1",67,55,122,"2020/03/13","dbgap"
"6824","phs000908.v1.pht004709.v1.p1",96,104,200,"01/19/2016","dbgap"
"6825","phs000287.v7.pht001461.v1.p1",2375,3156,5531,"2020/01/23","dbgap"
"6826","phs000969.v1.pht004930.v1.p1",2,2,4,"10/05/2015","dbgap"
"6828","phs001288.v1.pht006765.v1.p1",45,29,74,"2017/10/19","dbgap"
"6829","phs000576.v1.pht006150.v1.p1",104,119,223,"05/24/2017","dbgap"
"6831","phs000272.v1.pht001445.v1.p1",1413,1080,2493,"09/20/2010","dbgap"
"6833","phs001027.v4.pht005216.v3.p1",94,61,155,"2021/06/23","dbgap"
"6837","phs000128.v3.pht000462.v2.p3",2943,3500,6443,"04/29/2016","dbgap"
"6838","phs000742.v1.pht008115.v1.p1",1046,1377,2423,"2018/07/23","dbgap"
"6839","phs000298.v4.pht002583.v3.p3",7742,4936,12678,"2018/06/22","dbgap"
"6840","phs000343.v3.pht003157.v1.p1",1379,785,2164,"03/12/2013","dbgap"
"6842","phs001603.v2.pht009970.v1.p1",55,105,160,"2021/07/16","dbgap"
"6843","phs000863.v1.pht004743.v1.p1",348,282,630,"06/03/2015","dbgap"
"6845","phs000089.v3.pht000801.v2.p2",896,845,1741,"04/01/2010","dbgap"
"6846","phs000168.v2.pht000707.v2.p2",1939,3281,5220,"08/27/2012","dbgap"
"6847","phs001437.v1.pht006806.v1.p1",157,83,240,"2019/09/11","dbgap"
"6848","phs000388.v1.pht002351.v1.p1",1354,1513,2867,"08/23/2011","dbgap"
"6849","phs001430.v2.pht008060.v2.p1",13,9,22,"2020/02/06","dbgap"
"6850","phs000590.v1.pht008279.v1.p1",32,36,68,"2018/08/03","dbgap"
"6851","phs000086.v3.pht000330.v1.p1",354,314,668,"11/04/2014","dbgap"
"6852","phs001194.v3.pht005812.v3.p2",7255,6460,13715,"2020/07/24","dbgap"
"6853","phs001488.v1.pht007419.v1.p1",260,293,553,"2018/02/08","dbgap"
"6854","phs002331.v1.pht011101.v1.p1",1965,698,2663,"2021/05/21","dbgap"
"6855","phs001645.v1.pht008210.v1.p1",16,9,25,"2018/07/18","dbgap"
"6857","phs000594.v1.pht006508.v1.p1",5,3,8,"06/12/2017","dbgap"
"6859","phs000575.v2.pht005885.v2.p1",177,212,389,"2020/02/14","dbgap"
"6861","phs001096.v1.pht005607.v1.p1",519,568,1087,"08/09/2016","dbgap"
"6862","phs001332.v2.pht007443.v2.p1",158,188,346,"2019/11/08","dbgap"
"6863","phs000280.v7.pht004031.v2.p1",6236,7752,13988,"2020/06/18","dbgap"
"6865","phs001377.v1.pht006944.v1.p1",330,50,380,"2017/09/22","dbgap"
"6866","phs000285.v3.pht001651.v2.p2",892,998,1890,"08/20/2013","dbgap"
"6869","phs000547.v1.pht003006.v1.p1",20,18,38,"10/18/2012","dbgap"
"6870","phs000219.v1.pht001090.v1.p1",174,275,449,"01/19/2010","dbgap"
"6872","phs000280.v7.pht006477.v1.p1",1073,1310,2383,"2020/06/18","dbgap"
"6873","phs001895.v2.pht009442.v2.p1",184,102,286,"2020/01/02","dbgap"
"6874","phs001238.v2.pht006043.v1.p1",573,1281,1854,"2018/06/14","dbgap"
"6876","phs001474.v1.pht007151.v1.p1",9,9,18,"2017/11/30","dbgap"
"6877","phs001757.v1.pht008670.v1.p1",148,184,332,"2019/03/11","dbgap"
"6878","phs000699.v1.pht004384.v1.p1",29,29,58,"12/12/2014","dbgap"
"6879","phs000285.v3.pht001675.v2.p2",907,1010,1917,"08/20/2013","dbgap"
"6880","phs002364.v1.pht011042.v1.p1",2,1,3,"2021/03/17","dbgap"
"6881","phs000007.v32.pht006027.v3.p13",2424,2578,5002,"2020/12/21","dbgap"
"6882","phs000795.v1.pht004013.v1.p1",7,10,17,"09/11/2014","dbgap"
"6884","phs000007.v32.pht006014.v2.p13",620,799,1419,"2020/12/21","dbgap"
"6885","phs000086.v3.pht000229.v1.p1",758,679,1437,"11/04/2014","dbgap"
"6886","phs000280.v7.pht004046.v5.p1",6110,6968,13078,"2020/06/18","dbgap"
"6887","phs002006.v2.pht010163.v2.p1",13,13,26,"2020/09/02","dbgap"
"6889","phs000343.v3.pht003160.v1.p1",1358,777,2135,"03/12/2013","dbgap"
"6890","phs001460.v1.pht006913.v1.p1",12,4,16,"2017/09/22","dbgap"
"6891","phs000016.v2.pht000053.v2.p2",797,123,920,"11/27/2009","dbgap"
"6893","phs000840.v1.pht005642.v1.p1",1157,1191,2348,"07/21/2016","dbgap"
"6894","phs000086.v3.pht000264.v1.p1",761,680,1441,"11/04/2014","dbgap"
"6895","phs000285.v3.pht001725.v2.p2",859,913,1772,"08/20/2013","dbgap"
"6897","phs001460.v1.pht006912.v1.p1",12,4,16,"2017/09/22","dbgap"
"6898","phs000952.v1.pht005317.v1.p1",2120,1764,3884,"03/10/2016","dbgap"
"6899","phs000888.v1.pht005565.v1.p1",2588,3605,6193,"08/12/2016","dbgap"
"6900","phs000280.v7.pht006475.v1.p1",1031,1247,2278,"2020/06/18","dbgap"
"6901","phs001624.v2.pht008232.v2.p2",1507,1159,2666,"2021/07/29","dbgap"
"6903","phs000286.v6.pht008725.v1.p2",1286,2154,3440,"2019/03/11","dbgap"
"6905","phs000761.v1.pht004497.v1.p1",1298,1737,3035,"03/26/2015","dbgap"
"6906","phs001328.v1.pht006319.v1.p1",51,36,87,"05/17/2017","dbgap"
"6907","phs000209.v13.pht002102.v2.p3",1168,1186,2354,"11/05/2014","dbgap"
"6908","phs000001.v3.pht000001.v2.p1",1638,2124,3762,"02/24/2012","dbgap"
"6909","phs001323.v2.pht010117.v2.p1",377,284,661,"2020/04/30","dbgap"
"6910","phs000219.v1.pht001080.v1.p1",639,1029,1668,"01/19/2010","dbgap"
"6911","phs000335.v3.pht002116.v1.p2",16,7,23,"07/25/2014","dbgap"
"6912","phs000285.v3.pht001696.v2.p2",873,970,1843,"08/20/2013","dbgap"
"6913","phs001641.v1.pht010029.v1.p1",741,1643,2384,"2020/03/24","dbgap"
"6914","phs000280.v7.pht009474.v1.p1",2273,3341,5614,"2020/06/18","dbgap"
"6915","phs000007.v32.pht000158.v2.p13",244,424,668,"2020/12/21","dbgap"
"6916","phs000128.v3.pht000427.v2.p3",2943,3500,6443,"04/29/2016","dbgap"
"6917","phs000285.v3.pht001637.v2.p2",908,1032,1940,"08/20/2013","dbgap"
"6918","phs000873.v1.pht004556.v1.p1",5,7,12,"03/13/2015","dbgap"
"6919","phs001592.v1.pht007978.v1.p1",51,7,58,"2018/05/16","dbgap"
"6920","phs000280.v7.pht006478.v1.p1",15,32,47,"2020/06/18","dbgap"
"6921","phs000815.v2.pht008164.v1.p1",130,174,304,"2020/02/03","dbgap"
"6922","phs000285.v3.pht001801.v2.p2",117,121,238,"08/20/2013","dbgap"
"6923","phs001235.v1.pht008447.v1.p1",2,3,5,"2019/03/21","dbgap"
"6924","phs000813.v1.pht004303.v1.p1",1180,1797,2977,"10/21/2015","dbgap"
"6925","phs001037.v1.pht005916.v1.p1",10165,10037,20202,"11/09/2016","dbgap"
"6926","phs001730.v2.pht010130.v1.p1",24,17,41,"2021/08/26","dbgap"
"6927","phs001516.v1.pht007494.v1.p1",9564,12137,21701,"2018/03/15","dbgap"
"6928","phs001135.v2.pht005985.v1.p1",685,294,979,"2020/03/09","dbgap"
"6930","phs002049.v1.pht010298.v1.p1",64,53,117,"2020/06/30","dbgap"
"6931","phs000474.v3.pht002693.v3.p2",285,261,546,"04/25/2016","dbgap"
"6933","phs001322.v2.pht006331.v2.p1",8,4,12,"2018/04/30","dbgap"
"6934","phs001248.v1.pht006094.v1.p1",42,52,94,"03/06/2017","dbgap"
"6935","phs000007.v32.pht006006.v4.p13",209,285,494,"2020/12/21","dbgap"
"6936","phs000888.v1.pht005583.v1.p1",65,24,89,"08/12/2016","dbgap"
"6939","phs002407.v1.pht011358.v1.p1",31,31,62,"2021/09/20","dbgap"
"6940","phs000286.v6.pht008733.v1.p2",1270,2100,3370,"2019/03/11","dbgap"
"6942","phs000681.v2.pht003872.v2.p1",859,1676,2535,"2019/05/03","dbgap"
"6944","phs000007.v32.pht002432.v4.p13",1580,1791,3371,"2020/12/21","dbgap"
"6946","phs000287.v7.pht001471.v1.p1",2375,3156,5531,"2020/01/23","dbgap"
"6947","phs001316.v1.pht008005.v1.p1",2,1,3,"2018/05/31","dbgap"
"6948","phs000603.v1.pht007553.v1.p1",3,8,11,"2018/03/06","dbgap"
"6949","phs002015.v1.pht010371.v1.p1",465,421,886,"2020/09/18","dbgap"
"6950","phs001382.v1.pht006973.v1.p1",113,354,467,"2017/10/03","dbgap"
"6951","phs000285.v3.pht001635.v2.p2",909,1030,1939,"08/20/2013","dbgap"
"6953","phs001406.v1.pht007750.v1.p1",6,7,13,"2019/10/11","dbgap"
"6955","phs000142.v1.pht000638.v1.p1",556,2372,2928,"07/21/2009","dbgap"
"6956","phs001929.v1.pht010014.v1.p1",325,275,600,"2020/03/26","dbgap"
"6957","phs000821.v1.pht004338.v1.p1",641,725,1366,"11/07/2014","dbgap"
"6958","phs000007.v32.pht003316.v9.p13",7046,8098,15144,"2020/12/21","dbgap"
"6960","phs002487.v1.pht011543.v1.p1",42,16,58,"2021/09/13","dbgap"
"6962","phs000422.v1.pht003223.v1.p1",67,124,191,"05/14/2013","dbgap"
"6963","phs000896.v1.pht005126.v1.p1",5,7,12,"11/16/2015","dbgap"
"6964","phs001841.v1.pht009908.v1.p1",327,225,552,"2020/06/02","dbgap"
"6965","phs002311.v1.pht010933.v1.p1",40,66,106,"2021/03/30","dbgap"
"6966","phs001430.v2.pht008070.v2.p1",13,10,23,"2020/02/06","dbgap"
"6969","phs000944.v1.pht004847.v1.p1",2050,2878,4928,"02/05/2016","dbgap"
"6971","phs002035.v1.pht010413.v1.p1",25,34,59,"2020/07/21","dbgap"
"6972","phs000952.v1.pht005318.v1.p1",2077,1720,3797,"03/10/2016","dbgap"
"6975","phs001246.v1.pht006083.v1.p1",9,15,24,"01/23/2017","dbgap"
"6977","phs001163.v1.pht011099.v1.p1",72,58,130,"2021/04/06","dbgap"
"6978","phs000222.v6.pht007354.v1.p2",488,855,1343,"2019/08/01","dbgap"
"6979","phs000964.v5.pht004839.v3.p1",1239,2084,3323,"2021/05/12","dbgap"
"6980","phs001327.v2.pht006561.v2.p1",2986,3192,6178,"2021/05/07","dbgap"
"6981","phs001949.v1.pht009704.v1.p1",13495,15325,28820,"2019/12/26","dbgap"
"6982","phs000260.v4.pht001256.v4.p2",92,18,110,"11/30/2015","dbgap"
"6983","phs001238.v2.pht006656.v1.p1",701,879,1580,"2018/06/14","dbgap"
"6984","phs000128.v3.pht000569.v2.p3",2943,3500,6443,"04/29/2016","dbgap"
"6985","phs000562.v1.pht003105.v1.p1",32,12,44,"12/26/2012","dbgap"
"6986","phs000594.v1.pht006501.v1.p1",5,3,8,"06/12/2017","dbgap"
"6987","phs001464.v1.pht006972.v1.p1",9,5,14,"2017/10/03","dbgap"
"6988","phs000007.v32.pht003459.v3.p13",1250,1299,2549,"2020/12/21","dbgap"
"6989","phs001357.v1.pht006700.v1.p1",41,33,74,"07/26/2017","dbgap"
"6992","phs001233.v1.pht005944.v1.p1",3,3,6,"11/21/2016","dbgap"
"6994","phs000797.v1.pht004268.v1.p1",4,1,5,"09/29/2014","dbgap"
"6995","phs001645.v1.pht008211.v1.p1",16,9,25,"2018/07/18","dbgap"
"6997","phs000718.v1.pht003840.v1.p1",1072,1138,2210,"06/09/2015","dbgap"
"6998","phs000086.v3.pht000351.v1.p1",14,29,43,"11/04/2014","dbgap"
"6999","phs000540.v1.pht003043.v1.p1",5,3,8,"11/08/2012","dbgap"
"7000","phs001981.v1.pht010699.v1.p1",32,16,48,"2020/12/16","dbgap"
"7001","phs000007.v32.pht000197.v8.p13",1193,1433,2626,"2020/12/21","dbgap"
"7002","phs001311.v1.pht007927.v1.p1",35,26,61,"2018/05/15","dbgap"
"7003","phs001719.v1.pht008918.v1.p1",49,53,102,"2019/05/07","dbgap"
"7004","phs000007.v32.pht000096.v8.p13",1515,1750,3265,"2020/12/21","dbgap"
"7005","phs001609.v1.pht008140.v1.p1",89,875,964,"2019/01/10","dbgap"
"7006","phs000200.v9.pht000982.v6.p3",57,56849,56906,"11/08/2013","dbgap"
"7007","phs001397.v1.pht006952.v1.p1",848,1229,2077,"2017/10/05","dbgap"
"7008","phs001315.v1.pht006193.v1.p1",4482,4243,8725,"2018/05/18","dbgap"
"7009","phs001123.v2.pht006060.v2.p1",5879,8482,14361,"2019/09/16","dbgap"
"7011","phs000504.v2.pht002823.v2.p2",55,37,92,"11/27/2013","dbgap"
"7012","phs001197.v1.pht007564.v1.p1",110,83,193,"2018/04/27","dbgap"
"7013","phs000371.v2.pht002987.v2.p1",1245,1591,2836,"10/25/2016","dbgap"
"7014","phs000140.v1.pht000654.v1.p1",840,1208,2048,"11/24/2010","dbgap"
"7015","phs000884.v1.pht004601.v1.p1",146,94,240,"03/17/2015","dbgap"
"7016","phs001438.v1.pht006818.v1.p1",1,2,3,"2017/12/19","dbgap"
"7017","phs001182.v2.pht005722.v2.p1",8,13,21,"2020/09/18","dbgap"
"7018","phs000564.v2.pht003059.v2.p1",142,137,279,"07/09/2015","dbgap"
"7020","phs000565.v1.pht003077.v1.p1",121,71,192,"12/06/2012","dbgap"
"7021","phs000577.v1.pht007266.v1.p1",11,24,35,"2017/12/20","dbgap"
"7023","phs000017.v3.pht000697.v1.p1",237,243,480,"Wed Nov 26 07:50:34 2008","dbgap"
"7024","phs001471.v1.pht009801.v1.p1",141,369,510,"2020/01/10","dbgap"
"7025","phs000007.v32.pht006007.v1.p13",17,74,91,"2020/12/21","dbgap"
"7026","phs000021.v3.pht000069.v1.p2",668,774,1442,"10/25/2010","dbgap"
"7027","phs001857.v1.pht010765.v1.p1",676,1352,2028,"2020/12/09","dbgap"
"7028","phs000007.v32.pht002426.v5.p13",174,2309,2483,"2020/12/21","dbgap"
"7029","phs000590.v1.pht008281.v1.p1",29,36,65,"2018/08/03","dbgap"
"7030","phs000247.v5.pht001283.v4.p3",1351,1374,2725,"07/27/2017","dbgap"
"7031","phs001021.v1.pht005267.v1.p1",136,274,410,"02/01/2016","dbgap"
"7032","phs000348.v2.pht002229.v2.p1",26,12,38,"12/19/2014","dbgap"
"7033","phs002234.v1.pht010513.v1.p1",3,1,4,"2020/09/15","dbgap"
"7034","phs002448.v1.pht011299.v1.p1",1,6,7,"2021/06/09","dbgap"
"7035","phs000007.v32.pht002236.v5.p13",1069,1362,2431,"2020/12/21","dbgap"
"7036","phs000512.v1.pht002862.v1.p1",59,38,97,"10/15/2012","dbgap"
"7037","phs001850.v1.pht009237.v1.p1",37,296,333,"2019/07/03","dbgap"
"7039","phs000007.v32.pht000009.v2.p13",2294,2785,5079,"2020/12/21","dbgap"
"7042","phs002291.v1.pht010800.v1.p1",4,1,5,"2021/01/21","dbgap"
"7043","phs000285.v3.pht001726.v2.p2",26,53,79,"08/20/2013","dbgap"
"7045","phs000656.v1.pht003480.v1.p1",15,13,28,"08/26/2013","dbgap"
"7047","phs000007.v32.pht005142.v1.p13",35,106,141,"2020/12/21","dbgap"
"7048","phs001176.v3.pht005798.v3.p1",17,12,29,"2019/10/23","dbgap"
"7049","phs001123.v2.pht006059.v2.p1",7393,9471,16864,"2019/09/16","dbgap"
"7051","phs000128.v3.pht000597.v2.p3",2943,3500,6443,"04/29/2016","dbgap"
"7052","phs001430.v2.pht008062.v2.p1",11,10,21,"2020/02/06","dbgap"
"7053","phs001576.v2.pht008214.v2.p2",35,17,52,"2019/09/27","dbgap"
"7054","phs000007.v32.pht000300.v9.p13",1825,1955,3780,"2020/12/21","dbgap"
"7055","phs000171.v1.pht000775.v1.p1",328,668,996,"12/11/2009","dbgap"
"7056","phs000169.v1.pht000729.v1.p1",1367,1435,2802,"12/03/2009","dbgap"
"7057","phs000873.v1.pht004558.v1.p1",2,6,8,"03/13/2015","dbgap"
"7058","phs000547.v1.pht003005.v1.p1",18,18,36,"10/18/2012","dbgap"
"7059","phs000285.v3.pht001688.v2.p2",85,109,194,"08/20/2013","dbgap"
"7060","phs001143.v4.pht005904.v2.p1",454,549,1003,"2021/06/01","dbgap"
"7061","phs000268.v1.pht002164.v1.p1",85,96,181,"02/24/2011","dbgap"
"7062","phs001331.v2.pht006921.v2.p1",196,131,327,"2019/08/30","dbgap"
"7063","phs001505.v1.pht007321.v1.p1",268,140,408,"2018/09/06","dbgap"
"7066","phs001474.v1.pht007152.v1.p1",9,9,18,"2017/11/30","dbgap"
"7067","phs000007.v32.pht010731.v1.p13",141,168,309,"2020/12/21","dbgap"
"7069","phs001319.v1.pht006209.v1.p1",4456,3110,7566,"03/29/2017","dbgap"
"7070","phs001011.v2.pht005531.v1.p1",935,633,1568,"2020/07/21","dbgap"
"7071","phs001260.v1.pht006053.v1.p1",24,19,43,"01/05/2017","dbgap"
"7072","phs000817.v1.pht004416.v1.p1",2,6,8,"01/05/2015","dbgap"
"7073","phs001703.v3.pht008450.v1.p1",54,37,91,"2019/11/27","dbgap"
"7074","phs002276.v1.pht011554.v1.p1",12,3,15,"2021/10/06","dbgap"
"7075","phs000422.v1.pht003224.v1.p1",67,124,191,"05/14/2013","dbgap"
"7076","phs002024.v1.pht010234.v1.p1",271,228,499,"2020/05/13","dbgap"
"7077","phs000699.v1.pht004385.v1.p1",29,29,58,"12/12/2014","dbgap"
"7078","phs000219.v1.pht001096.v1.p1",122,178,300,"01/19/2010","dbgap"
"7079","phs001936.v1.pht009647.v1.p1",2,7,9,"2020/01/21","dbgap"
"7081","phs000797.v1.pht004270.v1.p1",4,1,5,"09/29/2014","dbgap"
"7083","phs001949.v1.pht009707.v1.p1",13495,15325,28820,"2019/12/26","dbgap"
"7084","phs000690.v1.pht003621.v1.p1",15,45,60,"12/16/2013","dbgap"
"7085","phs001617.v1.pht010621.v1.p1",65,57,122,"2021/01/12","dbgap"
"7086","phs002292.v1.pht011107.v1.p1",11,12,23,"2021/04/09","dbgap"
"7087","phs001281.v2.pht006132.v2.p1",8,9,17,"2019/02/21","dbgap"
"7088","phs002037.v1.pht010265.v1.p1",126,112,238,"2020/06/10","dbgap"
"7089","phs001288.v1.pht006764.v1.p1",10,7,17,"2017/10/19","dbgap"
"7090","phs001519.v1.pht008436.v1.p1",4,6,10,"2018/10/02","dbgap"
"7091","phs000971.v3.pht004916.v2.p1",646,831,1477,"2021/06/07","dbgap"
"7092","phs001605.v2.pht010079.v2.p1",109,183,292,"2021/07/22","dbgap"
"7093","phs000280.v7.pht004088.v2.p1",1728,1653,3381,"2020/06/18","dbgap"
"7094","phs000007.v32.pht000195.v8.p13",1531,1766,3297,"2020/12/21","dbgap"
"7095","phs000657.v1.pht003493.v1.p1",6,3,9,"08/30/2013","dbgap"
"7096","phs001217.v3.pht007762.v1.p1",1745,1607,3352,"2021/06/08","dbgap"
"7097","phs001332.v2.pht007450.v2.p1",158,188,346,"2019/11/08","dbgap"
"7098","phs001654.v1.pht008442.v1.p1",68,14,82,"2018/10/31","dbgap"
"7100","phs000142.v1.pht000888.v1.p1",1279,3094,4373,"07/21/2009","dbgap"
"7101","phs001082.v1.pht005379.v1.p1",5,4,9,"02/09/2017","dbgap"
"7102","phs001215.v4.pht008629.v2.p2",2524,2426,4950,"2021/06/08","dbgap"
"7103","phs000871.v1.pht004568.v1.p1",16,17,33,"05/08/2017","dbgap"
"7104","phs001087.v3.pht005760.v3.p1",74,30,104,"2020/09/18","dbgap"
"7105","phs001323.v2.pht010116.v2.p1",377,284,661,"2020/04/30","dbgap"
"7107","phs000687.v1.pht003692.v1.p1",905,921,1826,"06/13/2014","dbgap"
"7108","phs001507.v1.pht008697.v1.p1",8,8,16,"2020/02/04","dbgap"
"7109","phs000222.v6.pht003450.v2.p2",413,696,1109,"2019/08/01","dbgap"
"7110","phs002015.v1.pht010373.v1.p1",660,850,1510,"2020/09/18","dbgap"
"7111","phs000219.v1.pht001078.v1.p1",664,1054,1718,"01/19/2010","dbgap"
"7112","phs001502.v1.pht007259.v1.p1",49,46,95,"2018/09/07","dbgap"
"7113","phs000343.v3.pht002716.v1.p1",1379,785,2164,"03/12/2013","dbgap"
"7114","phs001392.v1.pht006907.v1.p1",20,10,30,"2017/09/22","dbgap"
"7115","phs000007.v32.pht000684.v7.p13",1665,1952,3617,"2020/12/21","dbgap"
"7116","phs000701.v1.pht005515.v1.p1",46,40,86,"06/01/2017","dbgap"
"7117","phs000128.v3.pht000458.v2.p3",2943,3500,6443,"04/29/2016","dbgap"
"7118","phs001001.v1.pht005654.v1.p1",448,117,565,"2018/02/28","dbgap"
"7119","phs000283.v1.pht001538.v1.p1",3022,3335,6357,"07/26/2010","dbgap"
"7120","phs000285.v3.pht001647.v2.p2",718,982,1700,"08/20/2013","dbgap"
"7121","phs000280.v7.pht004053.v5.p1",4051,4003,8054,"2020/06/18","dbgap"
"7122","phs000286.v6.pht008745.v1.p2",890,1475,2365,"2019/03/11","dbgap"
"7124","phs001278.v1.pht006279.v1.p1",78,97,175,"06/16/2017","dbgap"
"7125","phs000086.v3.pht000237.v1.p1",761,680,1441,"11/04/2014","dbgap"
"7126","phs000086.v3.pht000324.v1.p1",730,666,1396,"11/04/2014","dbgap"
"7127","phs000286.v6.pht008778.v1.p2",937,1569,2506,"2019/03/11","dbgap"
"7128","phs000280.v7.pht004055.v2.p1",6120,7410,13530,"2020/06/18","dbgap"
"7129","phs000219.v1.pht001065.v1.p1",664,1054,1718,"01/19/2010","dbgap"
"7130","phs001662.v2.pht010053.v2.p1",842,757,1599,"2021/08/19","dbgap"
"7132","phs000128.v3.pht000498.v2.p3",2943,3500,6443,"04/29/2016","dbgap"
"7133","phs002015.v1.pht010380.v1.p1",1816,2387,4203,"2020/09/18","dbgap"
"7134","phs000007.v32.pht010742.v1.p13",99,154,253,"2020/12/21","dbgap"
"7135","phs000007.v32.pht000109.v8.p13",1369,1586,2955,"2020/12/21","dbgap"
"7136","phs000007.v32.pht000680.v7.p13",1565,1775,3340,"2020/12/21","dbgap"
"7137","phs000280.v7.pht006463.v1.p1",2232,2905,5137,"2020/06/18","dbgap"
"7138","phs000374.v1.pht002359.v1.p1",4,3,7,"08/31/2011","dbgap"
"7139","phs001688.v1.pht008590.v1.p1",23,12,35,"2018/12/06","dbgap"
"7140","phs000519.v1.pht003249.v1.p1",1916,1996,3912,"09/26/2013","dbgap"
"7141","phs000559.v1.pht003616.v1.p1",7858,6558,14416,"12/16/2013","dbgap"
"7142","phs001754.v4.pht009110.v3.p2",3664,6253,9917,"2021/02/26","dbgap"
"7143","phs000128.v3.pht000430.v2.p3",2943,3500,6443,"04/29/2016","dbgap"
"7144","phs002039.v1.pht010273.v1.p1",5,13,18,"2020/06/10","dbgap"
"7146","phs000590.v1.pht008287.v1.p1",32,36,68,"2018/08/03","dbgap"
"7148","phs000128.v3.pht000534.v2.p3",2943,3500,6443,"04/29/2016","dbgap"
"7149","phs001547.v2.pht009988.v1.p1",75,15,90,"2021/07/15","dbgap"
"7151","phs000588.v1.pht009308.v1.p1",42,151,193,"2019/07/26","dbgap"
"7152","phs001372.v1.pht006532.v1.p1",3,2,5,"2017/10/10","dbgap"
"7153","phs000007.v32.pht000313.v8.p13",1888,2156,4044,"2020/12/21","dbgap"
"7155","phs001154.v1.pht008373.v1.p1",7278,3340,10618,"2018/09/17","dbgap"
"7156","phs002446.v1.pht011402.v1.p1",3,9,12,"2021/07/21","dbgap"
"7157","phs001178.v1.pht008548.v1.p1",149,150,299,"2018/11/19","dbgap"
"7158","phs000748.v7.pht003888.v7.p4",606,400,1006,"2019/02/05","dbgap"
"7159","phs001559.v1.pht007661.v1.p1",156,30,186,"2018/03/20","dbgap"
"7161","phs000007.v32.pht002897.v6.p13",1428,1738,3166,"2020/12/21","dbgap"
"7162","phs001694.v1.pht008494.v1.p1",6,2,8,"2018/10/24","dbgap"
"7163","phs001257.v2.pht005999.v1.p1",10,6,16,"03/24/2017","dbgap"
"7164","phs001286.v1.pht007889.v1.p1",10464,2691,13155,"2019/03/27","dbgap"
"7165","phs000128.v3.pht000480.v2.p3",2943,3500,6443,"04/29/2016","dbgap"
"7166","phs000810.v1.pht004713.v1.p1",5466,7780,13246,"12/02/2015","dbgap"
"7167","phs001288.v1.pht006774.v1.p1",49,37,86,"2017/10/19","dbgap"
"7168","phs001316.v1.pht008008.v1.p1",2,1,3,"2018/05/31","dbgap"
"7170","phs001418.v1.pht007235.v1.p1",13,20,33,"2018/11/15","dbgap"
"7171","phs001252.v1.pht006370.v1.p1",1685,1053,2738,"05/16/2017","dbgap"
"7172","phs001796.v1.pht008835.v1.p1",18,28,46,"2019/03/18","dbgap"
"7174","phs001327.v2.pht011196.v1.p1",13724,11941,25665,"2021/05/07","dbgap"
"7175","phs000086.v3.pht000329.v1.p1",662,625,1287,"11/04/2014","dbgap"
"7176","phs000543.v1.pht002936.v1.p1",7,8,15,"10/31/2014","dbgap"
"7177","phs000979.v3.pht005195.v2.p2",607,363,970,"2019/09/16","dbgap"
"7178","phs001402.v3.pht008239.v1.p1",216,122,338,"2021/06/16","dbgap"
"7179","phs000280.v7.pht004092.v2.p1",6120,7410,13530,"2020/06/18","dbgap"
"7180","phs000016.v2.pht001037.v1.p2",1725,1044,2769,"11/27/2009","dbgap"
"7181","phs001527.v1.pht007519.v1.p1",213,6,219,"2018/04/04","dbgap"
"7182","phs000285.v3.pht001580.v2.p2",947,1065,2012,"08/20/2013","dbgap"
"7183","phs001176.v3.pht005796.v3.p1",17,12,29,"2019/10/23","dbgap"
"7186","phs001115.v1.pht005481.v1.p1",2,1,3,"05/19/2016","dbgap"
"7188","phs002328.v1.pht010853.v1.p1",178,90,268,"2021/03/05","dbgap"
"7189","phs000990.v1.pht004999.v1.p1",1078,616,1694,"02/29/2016","dbgap"
"7190","phs001606.v2.pht010089.v1.p1",134,190,324,"2021/07/19","dbgap"
"7192","phs000128.v3.pht000555.v2.p3",2943,3500,6443,"04/29/2016","dbgap"
"7193","phs000831.v1.pht004904.v1.p1",84,73,157,"08/13/2015","dbgap"
"7194","phs000757.v1.pht003922.v1.p1",33,21,54,"06/30/2014","dbgap"
"7196","phs000641.v1.pht003476.v1.p1",10,5,15,"08/21/2013","dbgap"
"7197","phs001065.v1.pht005394.v1.p1",296,313,609,"05/24/2016","dbgap"
"7198","phs000413.v2.pht003037.v1.p1",7,8,15,"11/16/2012","dbgap"
"7199","phs000007.v32.pht000396.v4.p13",343,345,688,"2020/12/21","dbgap"
"7200","phs000017.v3.pht000292.v1.p1",559,522,1081,"Wed Nov 26 07:45:16 2008","dbgap"
"7201","phs000285.v3.pht001694.v2.p2",451,486,937,"08/20/2013","dbgap"
"7202","phs000128.v3.pht000548.v2.p3",2943,3500,6443,"04/29/2016","dbgap"
"7203","phs001211.v4.pht005757.v3.p3",6142,7501,13643,"2021/09/22","dbgap"
"7205","phs001219.v1.pht007859.v1.p1",236,239,475,"2018/04/23","dbgap"
"7206","phs000209.v13.pht004319.v1.p3",1334,1466,2800,"11/05/2014","dbgap"
"7208","phs000007.v32.pht010751.v1.p13",41,49,90,"2020/12/21","dbgap"
"7210","phs000285.v3.pht001872.v1.p2",5,13,18,"08/20/2013","dbgap"
"7211","phs001110.v3.pht006511.v3.p1",811,721,1532,"2020/09/08","dbgap"
"7212","phs000285.v3.pht001849.v2.p2",877,985,1862,"08/20/2013","dbgap"
"7213","phs001860.v1.pht009453.v1.p1",86,120,206,"2020/05/15","dbgap"
"7214","phs001778.v1.pht009833.v1.p1",5,6,11,"2020/07/16","dbgap"
"7215","phs000276.v2.pht002005.v1.p1",2592,2810,5402,"01/22/2014","dbgap"
"7216","phs001442.v3.pht008327.v3.p2",12416,12161,24577,"2021/08/13","dbgap"
"7217","phs000944.v1.pht004846.v1.p1",2050,2878,4928,"02/05/2016","dbgap"
"7218","phs000171.v1.pht000752.v1.p1",636,1284,1920,"12/11/2009","dbgap"
"7219","phs001496.v1.pht007340.v1.p1",114,1,115,"2018/02/15","dbgap"
"7220","phs000946.v5.pht004972.v3.p1",23,57,80,"2021/05/07","dbgap"
"7221","phs000574.v1.pht005857.v1.p1",31,857,888,"03/06/2017","dbgap"
"7222","phs000017.v3.pht000696.v1.p1",301,298,599,"Wed Nov 26 07:50:33 2008","dbgap"
"7223","phs000286.v6.pht008791.v1.p2",1244,2058,3302,"2019/03/11","dbgap"
"7224","phs001745.v1.pht008601.v1.p1",597,506,1103,"2019/02/06","dbgap"
"7225","phs000285.v3.pht001778.v2.p2",868,972,1840,"08/20/2013","dbgap"
"7226","phs001599.v1.pht011436.v1.p1",459,484,943,"2021/07/29","dbgap"
"7227","phs001812.v1.pht009104.v1.p1",74,59,133,"2021/02/22","dbgap"
"7230","phs001726.v2.pht009836.v2.p1",1140,1151,2291,"2021/09/24","dbgap"
"7232","phs000128.v3.pht000441.v2.p3",2943,3500,6443,"04/29/2016","dbgap"
"7234","phs000866.v1.pht004620.v1.p1",45,42,87,"03/23/2015","dbgap"
"7235","phs002015.v1.pht010383.v1.p1",47,36,83,"2020/09/18","dbgap"
"7236","phs001839.v1.pht009358.v1.p1",1,2,3,"2019/08/01","dbgap"
"7237","phs000742.v1.pht008119.v1.p1",1310,1601,2911,"2018/07/23","dbgap"
"7238","phs000247.v5.pht001285.v5.p3",88,89,177,"07/27/2017","dbgap"
"7239","phs000388.v1.pht002352.v1.p1",1354,1513,2867,"08/23/2011","dbgap"
"7241","phs001332.v2.pht007459.v2.p1",158,188,346,"2019/11/08","dbgap"
"7242","phs001407.v1.pht006666.v1.p1",1,10,11,"2017/08/25","dbgap"
"7243","phs000209.v13.pht003088.v1.p3",94,91,185,"11/05/2014","dbgap"
"7245","phs000280.v7.pht006429.v1.p1",897,1051,1948,"2020/06/18","dbgap"
"7247","phs001384.v1.pht006742.v1.p1",20,11,31,"2017/08/02","dbgap"
"7248","phs000917.v1.pht004738.v1.p1",5982,1309,7291,"01/05/2016","dbgap"
"7249","phs000287.v7.pht001453.v1.p1",542,259,801,"2020/01/23","dbgap"
"7250","phs001209.v1.pht006802.v1.p1",9,11,20,"2017/08/22","dbgap"
"7251","phs001732.v2.pht010141.v1.p1",43,46,89,"2021/08/26","dbgap"
"7252","phs002304.v1.pht010851.v1.p1",377,244,621,"2021/04/07","dbgap"
"7253","phs000086.v3.pht000354.v1.p1",47,41,88,"11/04/2014","dbgap"
"7254","phs000314.v1.pht002068.v1.p1",1243,968,2211,"07/17/2012","dbgap"
"7256","phs001252.v1.pht006384.v1.p1",1341,941,2282,"05/16/2017","dbgap"
"7258","phs000286.v6.pht001966.v2.p2",1293,2162,3455,"2019/03/11","dbgap"
"7259","phs000791.v2.pht004594.v2.p1",21,23,44,"2020/01/10","dbgap"
"7260","phs000568.v1.pht003111.v1.p1",8,9,17,"01/02/2013","dbgap"
"7262","phs000007.v32.pht003099.v7.p13",7046,8098,15144,"2020/12/21","dbgap"
"7263","phs000007.v32.pht009754.v2.p13",2030,2325,4355,"2020/12/21","dbgap"
"7264","phs001488.v1.pht007420.v1.p1",260,293,553,"2018/02/08","dbgap"
"7265","phs000370.v2.pht002382.v2.p1",69,23,92,"04/14/2014","dbgap"
"7266","phs000007.v32.pht006005.v1.p13",47,54,101,"2020/12/21","dbgap"
"7268","phs001581.v1.pht008384.v1.p1",17,5,22,"2018/09/19","dbgap"
"7269","phs000425.v1.pht002502.v1.p1",1645,1302,2947,"03/06/2012","dbgap"
"7271","phs001394.v1.pht006949.v1.p1",260,387,647,"2017/09/22","dbgap"
"7272","phs000507.v2.pht002927.v2.p2",5,4,9,"2018/11/05","dbgap"
"7273","phs000347.v1.pht003123.v1.p1",19,10,29,"07/09/2013","dbgap"
"7274","phs001623.v2.pht008361.v2.p1",30,11,41,"2019/10/31","dbgap"
"7275","phs000285.v3.pht001577.v2.p2",947,1065,2012,"08/20/2013","dbgap"
"7276","phs001065.v1.pht005420.v1.p1",296,313,609,"05/24/2016","dbgap"
"7277","phs001316.v1.pht008010.v1.p1",2,1,3,"2018/05/31","dbgap"
"7279","phs001380.v1.pht009227.v1.p1",266,172,438,"2019/10/11","dbgap"
"7280","phs000209.v13.pht002297.v2.p3",3057,3366,6423,"11/05/2014","dbgap"
"7281","phs000007.v32.pht010746.v1.p13",1136,1385,2521,"2020/12/21","dbgap"
"7282","phs001041.v1.pht005391.v1.p1",39,25,64,"06/09/2016","dbgap"
"7283","phs000128.v3.pht000499.v2.p3",2943,3500,6443,"04/29/2016","dbgap"
"7285","phs000153.v9.pht000834.v8.p8",8963,9289,18252,"07/16/2015","dbgap"
"7286","phs002614.v1.pht011591.v1.p1",5,7,12,"2021/09/30","dbgap"
"7287","phs000713.v1.pht004274.v1.p1",328,380,708,"10/16/2014","dbgap"
"7288","phs001392.v1.pht006894.v1.p1",11,4,15,"2017/09/22","dbgap"
"7289","phs000852.v1.pht006695.v1.p1",419,365,784,"07/26/2017","dbgap"
"7290","phs000285.v3.pht001583.v2.p2",947,1065,2012,"08/20/2013","dbgap"
"7291","phs001780.v1.pht008713.v1.p1",379,316,695,"2019/02/11","dbgap"
"7293","phs001792.v1.pht008932.v1.p1",92,372,464,"2019/04/15","dbgap"
"7294","phs000588.v1.pht009290.v1.p1",42,151,193,"2019/07/26","dbgap"
"7295","phs001419.v1.pht007098.v1.p1",490,502,992,"2017/12/04","dbgap"
"7296","phs002222.v1.pht010527.v1.p1",3,8,11,"2020/09/17","dbgap"
"7297","phs000286.v6.pht008779.v1.p2",1009,1780,2789,"2019/03/11","dbgap"
"7298","phs000353.v1.pht002251.v1.p1",838,2440,3278,"08/08/2011","dbgap"
"7299","phs001802.v1.pht008959.v1.p1",3,2,5,"2019/04/09","dbgap"
"7300","phs001101.v1.pht005368.v1.p1",599,482,1081,"05/09/2016","dbgap"
"7301","phs001759.v1.pht008710.v1.p1",1,6,7,"2019/03/08","dbgap"
"7302","phs000240.v1.pht002280.v1.p1",463,600,1063,"08/03/2011","dbgap"
"7303","phs001217.v3.pht007764.v1.p1",1001,892,1893,"2021/06/08","dbgap"
"7304","phs000234.v2.pht001152.v2.p2",1615,2141,3756,"2018/05/29","dbgap"
"7305","phs000864.v1.pht004494.v1.p1",3976,16,3992,"05/08/2015","dbgap"
"7306","phs001808.v1.pht008973.v1.p1",4,10,14,"2019/04/19","dbgap"
"7307","phs001702.v1.pht008426.v1.p1",13,147,160,"2018/10/02","dbgap"
"7308","phs000179.v6.pht002237.v3.p2",5531,4852,10383,"2018/04/23","dbgap"
"7309","phs002341.v1.pht011059.v1.p1",36,36,72,"2021/03/24","dbgap"
"7310","phs000209.v13.pht002099.v2.p3",1278,1469,2747,"11/05/2014","dbgap"
"7313","phs000732.v1.pht003800.v1.p1",12,8,20,"04/14/2014","dbgap"
"7315","phs000722.v2.pht003899.v2.p2",266,410,676,"05/01/2017","dbgap"
"7316","phs000224.v3.pht004624.v2.p2",967,1890,2857,"2019/10/08","dbgap"
"7317","phs001065.v1.pht005400.v1.p1",295,306,601,"05/24/2016","dbgap"
"7318","phs000576.v1.pht006157.v1.p1",116,128,244,"05/24/2017","dbgap"
"7319","phs000516.v2.pht002831.v2.p1",34,25,59,"03/10/2015","dbgap"
"7320","phs001097.v1.pht005614.v1.p1",1072,1154,2226,"07/05/2016","dbgap"
"7321","phs001451.v3.pht007133.v3.p1",6,6,12,"2021/01/26","dbgap"
"7322","phs001654.v1.pht008443.v1.p1",68,14,82,"2018/10/31","dbgap"
"7323","phs002364.v1.pht011040.v1.p1",2,1,3,"2021/03/17","dbgap"
"7326","phs000353.v1.pht002252.v1.p1",11,9,20,"08/08/2011","dbgap"
"7327","phs001259.v1.pht006087.v1.p1",726,1423,2149,"2019/04/23","dbgap"
"7328","phs000285.v3.pht001645.v2.p2",947,1065,2012,"08/20/2013","dbgap"
"7329","phs001605.v2.pht010080.v2.p1",109,183,292,"2021/07/22","dbgap"
"7330","phs000343.v3.pht003158.v1.p1",82,56,138,"03/12/2013","dbgap"
"7331","phs001712.v1.pht008674.v1.p1",50,69,119,"2019/01/31","dbgap"
"7332","phs001305.v1.pht007101.v1.p1",1,2,3,"2017/11/01","dbgap"
"7334","phs000927.v1.pht004754.v1.p1",71,131,202,"04/05/2017","dbgap"
"7337","phs001882.v1.pht010492.v1.p1",68,49999,50067,"2021/07/20","dbgap"
"7338","phs000128.v3.pht000591.v2.p3",2943,3500,6443,"04/29/2016","dbgap"
"7340","phs000203.v1.pht000882.v1.p1",2095,1290,3385,"10/12/2010","dbgap"
"7341","phs000592.v1.pht006595.v1.p1",87,52,139,"07/12/2017","dbgap"
"7342","phs001624.v2.pht008230.v2.p2",1507,1159,2666,"2021/07/29","dbgap"
"7343","phs001728.v2.pht010124.v1.p1",34,16,50,"2021/08/25","dbgap"
"7344","phs001394.v1.pht006946.v1.p1",607,563,1170,"2017/09/22","dbgap"
"7345","phs001052.v2.pht005469.v2.p1",57,26,83,"2020/11/24","dbgap"
"7346","phs002405.v1.pht011238.v1.p1",7,9,16,"2021/08/13","dbgap"
"7348","phs000128.v3.pht000450.v2.p3",2943,3500,6443,"04/29/2016","dbgap"
"7350","phs000368.v1.pht002295.v1.p1",1,4098,4099,"10/07/2011","dbgap"
"7351","phs000578.v1.pht007015.v1.p1",49,43,92,"2017/10/11","dbgap"
"7353","phs000750.v1.pht003933.v1.p1",127,144,271,"09/03/2014","dbgap"
"7355","phs001869.v1.pht009396.v1.p1",526,475,1001,"2019/08/18","dbgap"
"7356","phs000449.v2.pht002855.v1.p1",73,52,125,"07/31/2012","dbgap"
"7357","phs001327.v2.pht006560.v2.p1",2986,3192,6178,"2021/05/07","dbgap"
"7358","phs000280.v7.pht004073.v2.p1",4874,6004,10878,"2020/06/18","dbgap"
"7359","phs001245.v1.pht005929.v1.p1",4,3,7,"2018/01/29","dbgap"
"7360","phs001963.v1.pht009826.v1.p1",3885,2953,6838,"2020/11/24","dbgap"
"7361","phs000285.v3.pht001845.v2.p2",874,980,1854,"08/20/2013","dbgap"
"7362","phs001616.v2.pht008540.v2.p2",18,14,32,"2020/10/27","dbgap"
"7363","phs000460.v1.pht002548.v1.p1",553,1129,1682,"11/22/2013","dbgap"
"7364","phs000438.v1.pht003318.v1.p1",341,380,721,"04/18/2014","dbgap"
"7365","phs000219.v1.pht001099.v1.p1",200,311,511,"01/19/2010","dbgap"
"7367","phs000007.v32.pht000611.v6.p13",1255,1620,2875,"2020/12/21","dbgap"
"7368","phs000866.v1.pht004621.v1.p1",45,42,87,"03/23/2015","dbgap"
"7370","phs000287.v7.pht001465.v1.p1",2375,3156,5531,"2020/01/23","dbgap"
"7371","phs002000.v1.pht010121.v1.p1",36,34,70,"2020/06/11","dbgap"
"7372","phs000969.v1.pht004929.v1.p1",2,2,4,"10/05/2015","dbgap"
"7373","phs002407.v1.pht011357.v1.p1",31,31,62,"2021/09/20","dbgap"
"7374","phs001864.v1.pht009265.v1.p1",13,9,22,"2019/07/25","dbgap"
"7375","phs001488.v1.pht007402.v1.p1",260,293,553,"2018/02/08","dbgap"
"7376","phs000280.v7.pht004093.v2.p1",5444,6661,12105,"2020/06/18","dbgap"
"7377","phs000219.v1.pht001081.v1.p1",664,1054,1718,"01/19/2010","dbgap"
"7378","phs001673.v1.pht008513.v1.p1",914,1144,2058,"2019/04/25","dbgap"
"7379","phs000949.v1.pht005224.v1.p1",1344,1871,3215,"02/08/2016","dbgap"
"7380","phs001065.v1.pht005417.v1.p1",296,313,609,"05/24/2016","dbgap"
"7381","phs000285.v3.pht001864.v2.p2",167,196,363,"08/20/2013","dbgap"
"7382","phs000007.v32.pht010756.v1.p13",7,33,40,"2020/12/21","dbgap"
"7383","phs001115.v1.pht005480.v1.p1",2,1,3,"05/19/2016","dbgap"
"7384","phs000007.v32.pht000175.v8.p13",1478,1716,3194,"2020/12/21","dbgap"
"7385","phs000293.v1.pht003365.v1.p1",755,1318,2073,"07/25/2013","dbgap"
"7386","phs000286.v6.pht008732.v1.p2",276,604,880,"2019/03/11","dbgap"
"7387","phs000125.v1.pht000620.v1.p1",1066,923,1989,"Thu Oct  2 11:13:19 2008","dbgap"
"7388","phs000921.v4.pht004882.v3.p1",981,1122,2103,"2019/11/20","dbgap"
"7389","phs001173.v1.pht005672.v1.p1",2521,812,3333,"2017/09/15","dbgap"
"7390","phs001914.v1.pht009891.v1.p1",31,16,47,"2020/02/25","dbgap"
"7391","phs000575.v2.pht005886.v2.p1",176,212,388,"2020/02/14","dbgap"
"7392","phs001310.v1.pht006871.v1.p1",29,25,54,"2017/09/18","dbgap"
"7393","phs002228.v1.pht010859.v1.p1",38,32,70,"2021/04/23","dbgap"
"7396","phs002464.v1.pht011336.v1.p1",9,1,10,"2021/07/21","dbgap"
"7397","phs001880.v1.pht009562.v1.p1",194,235,429,"2019/10/28","dbgap"
"7398","phs001305.v1.pht007110.v1.p1",5,7,12,"2017/11/01","dbgap"
"7399","phs000926.v1.pht004867.v1.p1",3,1,4,"08/04/2015","dbgap"
"7400","phs001332.v2.pht007454.v2.p1",158,188,346,"2019/11/08","dbgap"
"7403","phs001601.v2.pht010666.v2.p2",1271,939,2210,"2021/07/19","dbgap"
"7404","phs001194.v3.pht005814.v3.p2",6824,6074,12898,"2020/07/24","dbgap"
"7405","phs001415.v1.pht006687.v1.p1",15049,14491,29540,"2019/03/25","dbgap"
"7406","phs000287.v7.pht003700.v2.p1",341,500,841,"2020/01/23","dbgap"
"7407","phs001724.v1.pht008508.v1.p1",2,1,3,"2018/10/30","dbgap"
"7408","phs000618.v1.pht003303.v1.p1",2046,2304,4350,"10/24/2013","dbgap"
"7409","phs000166.v2.pht000705.v2.p1",310,411,721,"09/03/2009","dbgap"
"7410","phs000007.v32.pht003630.v5.p13",998,1258,2256,"2020/12/21","dbgap"
"7411","phs001906.v1.pht009663.v1.p1",7,9,16,"2019/12/11","dbgap"
"7412","phs000730.v1.pht005060.v1.p1",31,55,86,"11/13/2015","dbgap"
"7414","phs000285.v3.pht001859.v2.p2",414,499,913,"08/20/2013","dbgap"
"7415","phs001430.v2.pht008057.v2.p1",12,9,21,"2020/02/06","dbgap"
"7417","phs000285.v3.pht001569.v2.p2",947,1065,2012,"08/20/2013","dbgap"
"7419","phs000128.v3.pht000543.v2.p3",2943,3500,6443,"04/29/2016","dbgap"
"7420","phs001525.v1.pht007475.v1.p1",33,29,62,"2018/02/12","dbgap"
"7421","phs000452.v3.pht002591.v3.p1",144,86,230,"2020/02/27","dbgap"
"7423","phs000556.v1.pht003136.v1.p1",6,8,14,"07/09/2013","dbgap"
"7424","phs001430.v2.pht008077.v2.p1",13,10,23,"2020/02/06","dbgap"
"7425","phs001392.v1.pht006898.v1.p1",1,1,2,"2017/09/22","dbgap"
"7427","phs000007.v32.pht000295.v5.p13",934,1026,1960,"2020/12/21","dbgap"
"7428","phs000007.v32.pht004801.v2.p13",208,285,493,"2020/12/21","dbgap"
"7429","phs001990.v1.pht010019.v1.p1",87,192,279,"2020/03/19","dbgap"
"7430","phs001166.v1.pht005631.v1.p1",690,1336,2026,"07/08/2016","dbgap"
"7431","phs001327.v2.pht011190.v1.p1",2408,2643,5051,"2021/05/07","dbgap"
"7432","phs001662.v2.pht010073.v1.p1",843,758,1601,"2021/08/19","dbgap"
"7433","phs000959.v1.pht009703.v1.p1",1343,194,1537,"2019/12/16","dbgap"
"7434","phs000268.v1.pht002165.v1.p1",85,96,181,"02/24/2011","dbgap"
"7435","phs001871.v1.pht009362.v1.p1",137,211,348,"2019/08/01","dbgap"
"7436","phs000007.v32.pht004361.v5.p13",1730,1967,3697,"2020/12/21","dbgap"
"7437","phs002333.v1.pht010922.v1.p1",4,4,8,"2021/02/04","dbgap"
"7438","phs000280.v7.pht004056.v2.p1",855,1152,2007,"2020/06/18","dbgap"
"7439","phs000417.v2.pht002399.v2.p1",177,93,270,"02/02/2012","dbgap"
"7440","phs000140.v1.pht000631.v1.p1",441,592,1033,"11/24/2010","dbgap"
"7441","phs001332.v2.pht007456.v2.p1",153,171,324,"2019/11/08","dbgap"
"7442","phs000128.v3.pht000564.v2.p3",2943,3500,6443,"04/29/2016","dbgap"
"7443","phs001805.v1.pht008956.v1.p1",2,2,4,"2019/04/09","dbgap"
"7444","phs000007.v32.pht000104.v8.p13",1287,1445,2732,"2020/12/21","dbgap"
"7445","phs001194.v3.pht005826.v2.p2",3676,2871,6547,"2020/07/24","dbgap"
"7446","phs000442.v1.pht002487.v1.p1",53,38,91,"04/12/2012","dbgap"
"7447","phs000280.v7.pht006480.v1.p1",2375,3192,5567,"2020/06/18","dbgap"
"7448","phs000804.v1.pht005375.v1.p1",53,49,102,"09/06/2016","dbgap"
"7449","phs000571.v3.pht003357.v3.p2",3344,2916,6260,"12/01/2015","dbgap"
"7450","phs000219.v1.pht001070.v1.p1",664,1054,1718,"01/19/2010","dbgap"
"7451","phs000371.v2.pht002986.v1.p1",33,27,60,"10/25/2016","dbgap"
"7452","phs002255.v1.pht010673.v1.p1",1,3,4,"2020/11/20","dbgap"
"7453","phs001198.v1.pht007864.v1.p1",49,44,93,"2018/05/21","dbgap"
"7454","phs001419.v1.pht007093.v1.p1",36,48,84,"2017/12/04","dbgap"
"7455","phs002289.v1.pht010895.v1.p1",9,4,13,"2021/01/28","dbgap"
"7456","phs001581.v1.pht008382.v1.p1",17,5,22,"2018/09/19","dbgap"
"7458","phs000007.v32.pht002566.v4.p13",429,543,972,"2020/12/21","dbgap"
"7459","phs001696.v1.pht008429.v1.p1",6,4,10,"2018/10/02","dbgap"
"7462","phs000402.v1.pht002538.v1.p1",125,78,203,"02/29/2012","dbgap"
"7465","phs000219.v1.pht001074.v1.p1",664,1054,1718,"01/19/2010","dbgap"
"7466","phs001200.v1.pht005927.v1.p1",4,3,7,"11/16/2016","dbgap"
"7467","phs000758.v1.pht004000.v1.p1",10,11,21,"08/21/2014","dbgap"
"7468","phs000395.v1.pht002362.v1.p1",11,959,970,"07/18/2012","dbgap"
"7469","phs001804.v1.pht008963.v1.p1",2357,790,3147,"2019/04/23","dbgap"
"7470","phs001130.v1.pht008418.v1.p1",77,104,181,"2018/09/26","dbgap"
"7472","phs000541.v1.pht003049.v1.p1",2,5,7,"11/29/2012","dbgap"
"7473","phs000285.v3.pht001746.v2.p2",873,956,1829,"08/20/2013","dbgap"
"7474","phs001238.v2.pht006033.v1.p1",168,443,611,"2018/06/14","dbgap"
"7475","phs000476.v1.pht002668.v1.p1",10,10,20,"04/16/2012","dbgap"
"7476","phs001696.v1.pht008430.v1.p1",6,4,10,"2018/10/02","dbgap"
"7477","phs000287.v7.pht001484.v1.p1",2375,3156,5531,"2020/01/23","dbgap"
"7480","phs001108.v1.pht007719.v1.p1",10,34,44,"2018/03/30","dbgap"
"7481","phs000285.v3.pht001744.v2.p2",947,1065,2012,"08/20/2013","dbgap"
"7482","phs000007.v32.pht002892.v6.p13",1451,1741,3192,"2020/12/21","dbgap"
"7483","phs001644.v2.pht009947.v2.p2",5029,6994,12023,"2021/08/08","dbgap"
"7484","phs001292.v2.pht007847.v2.p1",238,538,776,"2019/06/03","dbgap"
"7485","phs001271.v1.pht006119.v1.p1",3208,2099,5307,"02/08/2017","dbgap"
"7487","phs000742.v1.pht008110.v1.p1",2323,2669,4992,"2018/07/23","dbgap"
"7488","phs001488.v1.pht007391.v1.p1",259,293,552,"2018/02/08","dbgap"
"7489","phs001837.v1.pht009314.v1.p1",78,46,124,"2019/08/26","dbgap"
"7490","phs001087.v3.pht005761.v3.p1",74,30,104,"2020/09/18","dbgap"
"7492","phs001575.v2.pht008207.v1.p1",15,26,41,"2019/11/12","dbgap"
"7494","phs000086.v3.pht000212.v1.p1",761,680,1441,"11/04/2014","dbgap"
"7495","phs000086.v3.pht000272.v1.p1",379,341,720,"11/04/2014","dbgap"
"7496","phs001011.v2.pht005530.v1.p1",103,98,201,"2020/07/21","dbgap"
"7497","phs000589.v1.pht009190.v1.p1",7,98,105,"2019/06/14","dbgap"
"7498","phs001543.v2.pht009911.v1.p1",265,84,349,"2021/07/08","dbgap"
"7500","phs001108.v1.pht007711.v1.p1",10,36,46,"2018/03/30","dbgap"
"7501","phs000767.v1.pht003930.v1.p1",37,12,49,"07/03/2014","dbgap"
"7502","phs000406.v1.pht002402.v1.p1",31,26,57,"10/25/2011","dbgap"
"7503","phs000397.v3.pht002407.v3.p3",5329,5445,10774,"2020/08/17","dbgap"
"7504","phs000360.v3.pht003254.v3.p1",7694,9391,17085,"08/05/2016","dbgap"
"7505","phs000413.v2.pht002734.v2.p1",7,8,15,"11/16/2012","dbgap"
"7506","phs001246.v1.pht006086.v1.p1",12,14,26,"01/23/2017","dbgap"
"7507","phs000209.v13.pht003119.v3.p3",2813,3040,5853,"11/05/2014","dbgap"
"7508","phs002002.v1.pht010189.v1.p1",6,2,8,"2020/04/27","dbgap"
"7510","phs001446.v2.pht009629.v1.p1",713,1144,1857,"2021/06/24","dbgap"
"7511","phs001364.v1.pht007467.v1.p1",523,619,1142,"2018/02/27","dbgap"
"7512","phs001728.v2.pht010125.v1.p1",34,16,50,"2021/08/25","dbgap"
"7514","phs001800.v2.pht008927.v2.p1",13,2,15,"2020/12/16","dbgap"
"7515","phs002298.v1.pht010758.v1.p1",359,36,395,"2020/12/09","dbgap"
"7517","phs000928.v1.pht004939.v1.p1",3,8,11,"01/13/2016","dbgap"
"7518","phs001158.v2.pht005595.v2.p1",11,10,21,"2019/02/05","dbgap"
"7519","phs000601.v1.pht003513.v1.p1",30,50,80,"09/10/2013","dbgap"
"7521","phs000209.v13.pht002194.v1.p3",2765,3010,5775,"11/05/2014","dbgap"
"7522","phs000888.v1.pht005574.v1.p1",3819,5147,8966,"08/12/2016","dbgap"
"7523","phs000007.v32.pht003094.v7.p13",1764,2007,3771,"2020/12/21","dbgap"
"7524","phs000888.v1.pht005591.v1.p1",3716,5759,9475,"08/12/2016","dbgap"
"7525","phs000128.v3.pht000527.v2.p3",2943,3500,6443,"04/29/2016","dbgap"
"7526","phs000007.v32.pht007769.v3.p13",2548,3005,5553,"2020/12/21","dbgap"
"7527","phs000007.v32.pht000692.v2.p13",96,206,302,"2020/12/21","dbgap"
"7532","phs001305.v1.pht007103.v1.p1",5,7,12,"2017/11/01","dbgap"
"7533","phs000779.v1.pht003964.v1.p1",1193,1209,2402,"07/25/2014","dbgap"
"7535","phs000907.v1.pht004695.v1.p1",1,4,5,"11/25/2016","dbgap"
"7537","phs000345.v1.pht002375.v1.p1",545,483,1028,"09/15/2011","dbgap"
"7538","phs000086.v3.pht000239.v1.p1",289,284,573,"11/04/2014","dbgap"
"7539","phs001218.v3.pht007766.v1.p1",737,1050,1787,"2021/06/08","dbgap"
"7540","phs000128.v3.pht000421.v2.p3",2943,3500,6443,"04/29/2016","dbgap"
"7541","phs002289.v1.pht010893.v1.p1",9,4,13,"2021/01/28","dbgap"
"7542","phs001332.v2.pht007451.v2.p1",156,187,343,"2019/11/08","dbgap"
"7543","phs000576.v1.pht006151.v1.p1",99,97,196,"05/24/2017","dbgap"
"7544","phs000285.v3.pht001779.v2.p2",865,969,1834,"08/20/2013","dbgap"
"7545","phs000976.v2.pht005687.v1.p1",1513,1704,3217,"2020/11/09","dbgap"
"7546","phs000280.v7.pht004106.v2.p1",4883,6019,10902,"2020/06/18","dbgap"
"7548","phs000963.v1.pht004857.v1.p1",3771,2119,5890,"05/11/2016","dbgap"
"7549","phs000128.v3.pht000474.v2.p3",2943,3500,6443,"04/29/2016","dbgap"
"7552","phs000479.v1.pht002666.v1.p1",2,1,3,"08/15/2012","dbgap"
"7553","phs002222.v1.pht010526.v1.p1",3,8,11,"2020/09/17","dbgap"
"7554","phs000701.v1.pht005514.v1.p1",35,40,75,"06/01/2017","dbgap"
"7556","phs001917.v1.pht009550.v1.p1",454,370,824,"2019/10/22","dbgap"
"7557","phs000219.v1.pht001103.v1.p1",199,309,508,"01/19/2010","dbgap"
"7558","phs000510.v1.pht010695.v1.p1",5,3629,3634,"2020/11/27","dbgap"
"7560","phs001552.v1.pht008394.v1.p1",1329,497,1826,"2018/09/21","dbgap"
"7561","phs000982.v1.pht004983.v1.p1",1358,1489,2847,"09/14/2015","dbgap"
"7562","phs001201.v2.pht008325.v1.p1",66,73,139,"2019/08/18","dbgap"
"7563","phs001430.v2.pht008080.v2.p1",11,9,20,"2020/02/06","dbgap"
"7564","phs001245.v1.pht005930.v1.p1",4,3,7,"2018/01/29","dbgap"
"7565","phs000382.v3.pht002323.v3.p1",51,55,106,"2018/01/18","dbgap"
"7566","phs000287.v7.pht003699.v2.p1",2375,3156,5531,"2020/01/23","dbgap"
"7568","phs001376.v1.pht006551.v1.p1",4,5,9,"06/15/2017","dbgap"
"7570","phs001281.v2.pht006133.v2.p1",4,7,11,"2019/02/21","dbgap"
"7571","phs000823.v1.pht005046.v1.p1",178,209,387,"05/11/2016","dbgap"
"7572","phs002024.v1.pht010232.v1.p1",271,228,499,"2020/05/13","dbgap"
"7573","phs000577.v1.pht007265.v1.p1",172,339,511,"2017/12/20","dbgap"
"7574","phs001932.v1.pht009655.v1.p1",722,678,1400,"2019/12/16","dbgap"
"7576","phs001417.v1.pht007365.v1.p1",136,409,545,"2018/01/26","dbgap"
"7577","phs000209.v13.pht001529.v2.p3",3449,3954,7403,"11/05/2014","dbgap"
"7579","phs000128.v3.pht000454.v2.p3",2943,3500,6443,"04/29/2016","dbgap"
"7580","phs001747.v1.pht008643.v1.p1",85,257,342,"2019/03/25","dbgap"
"7581","phs001172.v1.pht005842.v1.p2",1126,990,2116,"12/21/2016","dbgap"
"7582","phs000263.v1.pht001234.v1.p1",40,54,94,"06/14/2010","dbgap"
"7583","phs000285.v3.pht001634.v2.p2",908,1030,1938,"08/20/2013","dbgap"
"7585","phs000209.v13.pht001204.v2.p3",947,913,1860,"11/05/2014","dbgap"
"7586","phs001194.v3.pht005816.v2.p2",96,81,177,"2020/07/24","dbgap"
"7587","phs001604.v2.pht009983.v1.p1",29,27,56,"2021/07/16","dbgap"
"7588","phs000128.v3.pht000417.v2.p3",2943,3500,6443,"04/29/2016","dbgap"
"7589","phs000280.v7.pht006461.v1.p1",2249,2950,5199,"2020/06/18","dbgap"
"7590","phs000634.v1.pht003830.v1.p1",801,1519,2320,"06/25/2015","dbgap"
"7591","phs000590.v1.pht008278.v1.p1",2,4,6,"2018/08/03","dbgap"
"7592","phs001942.v1.pht010587.v1.p1",13,3,16,"2020/10/21","dbgap"
"7594","phs001328.v1.pht006310.v1.p1",54,37,91,"05/17/2017","dbgap"
"7595","phs001177.v2.pht005665.v2.p1",1475,1882,3357,"2019/11/27","dbgap"
"7596","phs001403.v1.pht006844.v1.p1",7,14,21,"2017/09/12","dbgap"
"7598","phs001230.v1.pht009242.v1.p1",1164,1116,2280,"2019/07/19","dbgap"
"7599","phs001706.v1.pht008456.v1.p1",17,15,32,"2018/10/11","dbgap"
"7600","phs002197.v1.pht010609.v1.p1",9,7,16,"2020/11/17","dbgap"
"7601","phs001997.v1.pht010216.v1.p1",113,111,224,"2020/05/07","dbgap"
"7602","phs000285.v3.pht001616.v2.p2",66,91,157,"08/20/2013","dbgap"
"7603","phs000128.v3.pht000446.v2.p3",2943,3500,6443,"04/29/2016","dbgap"
"7605","phs000408.v1.pht002438.v1.p1",174,788,962,"11/15/2011","dbgap"
"7606","phs000858.v1.pht004462.v1.p1",2,4,6,"09/01/2015","dbgap"
"7607","phs001724.v1.pht008504.v1.p1",2,1,3,"2018/10/30","dbgap"
"7608","phs001015.v1.pht005777.v1.p1",24,56,80,"09/30/2016","dbgap"
"7610","phs001196.v1.pht005700.v1.p1",2788,2408,5196,"2018/04/05","dbgap"
"7611","phs000444.v1.pht002702.v1.p1",484,829,1313,"04/19/2012","dbgap"
"7612","phs000892.v2.pht004632.v2.p2",5,41,46,"09/29/2015","dbgap"
"7613","phs001074.v1.pht005339.v1.p1",204,210,414,"03/15/2016","dbgap"
"7614","phs000280.v7.pht004213.v2.p1",5984,7219,13203,"2020/06/18","dbgap"
"7615","phs001936.v1.pht009649.v1.p1",2,7,9,"2020/01/21","dbgap"
"7616","phs000343.v3.pht002724.v1.p1",94,31,125,"03/12/2013","dbgap"
"7617","phs001052.v2.pht005467.v2.p1",57,26,83,"2020/11/24","dbgap"
"7618","phs000588.v1.pht009295.v1.p1",42,151,193,"2019/07/26","dbgap"
"7619","phs000504.v2.pht002820.v2.p2",55,37,92,"11/27/2013","dbgap"
"7620","phs000589.v1.pht009189.v1.p1",7,98,105,"2019/06/14","dbgap"
"7621","phs000209.v13.pht003608.v1.p3",2576,2817,5393,"11/05/2014","dbgap"
"7622","phs001178.v1.pht008550.v1.p1",149,150,299,"2018/11/19","dbgap"
"7623","phs000128.v3.pht000562.v2.p3",2943,3500,6443,"04/29/2016","dbgap"
"7624","phs000280.v7.pht004045.v5.p1",3375,3144,6519,"2020/06/18","dbgap"
"7625","phs000650.v1.pht003485.v1.p1",170,97,267,"08/27/2013","dbgap"
"7626","phs001215.v4.pht008630.v2.p2",1064,1480,2544,"2021/06/08","dbgap"
"7627","phs002464.v1.pht011333.v1.p1",8,4,12,"2021/07/21","dbgap"
"7628","phs001894.v1.pht009525.v1.p1",419,305,724,"2020/04/15","dbgap"
"7630","phs001538.v1.pht008092.v1.p1",215,300,515,"2018/06/01","dbgap"
"7632","phs000578.v1.pht007019.v1.p1",49,44,93,"2017/10/11","dbgap"
"7633","phs001327.v2.pht011192.v1.p1",3200,3222,6422,"2021/05/07","dbgap"
"7635","phs001480.v1.pht010830.v1.p1",80,194,274,"2021/01/13","dbgap"
"7636","phs001701.v1.pht009376.v1.p1",425,884,1309,"2019/08/06","dbgap"
"7637","phs001836.v1.pht009220.v1.p1",1,3,4,"2019/06/24","dbgap"
"7638","phs000007.v32.pht002141.v7.p13",2111,2427,4538,"2020/12/21","dbgap"
"7639","phs000095.v4.pht002546.v2.p2",74,53,127,"2021/09/13","dbgap"
"7640","phs001525.v1.pht007478.v1.p1",31,26,57,"2018/02/12","dbgap"
"7641","phs001332.v2.pht007449.v2.p1",157,187,344,"2019/11/08","dbgap"
"7642","phs000384.v1.pht002463.v1.p1",2,2,4,"06/01/2012","dbgap"
"7644","phs000007.v32.pht000392.v7.p13",1090,1194,2284,"2020/12/21","dbgap"
"7645","phs000285.v3.pht001795.v2.p2",46,63,109,"08/20/2013","dbgap"
"7646","phs001326.v1.pht007806.v1.p1",27,6,33,"2018/04/16","dbgap"
"7647","phs000603.v1.pht007546.v1.p1",3,9,12,"2018/03/06","dbgap"
"7649","phs000048.v1.pht000184.v1.p1",387,277,664,"Tue Mar  4 09:22:57 2008","dbgap"
"7650","phs001961.v1.pht011027.v1.p1",6,4,10,"2021/06/03","dbgap"
"7651","phs000571.v3.pht003192.v3.p2",1052,967,2019,"12/01/2015","dbgap"
"7652","phs000286.v6.pht001965.v2.p2",1293,2162,3455,"2019/03/11","dbgap"
"7653","phs001289.v1.pht007788.v1.p1",16,13,29,"2018/04/16","dbgap"
"7654","phs001471.v1.pht009803.v1.p1",142,343,485,"2020/01/10","dbgap"
"7655","phs002286.v1.pht010633.v1.p1",1,5,6,"2020/11/19","dbgap"
"7657","phs000698.v1.pht007673.v1.p1",18,32,50,"2018/03/23","dbgap"
"7658","phs001165.v1.pht007987.v1.p1",452,440,892,"2018/05/22","dbgap"
"7659","phs000171.v1.pht000773.v1.p1",330,670,1000,"12/11/2009","dbgap"
"7661","phs000285.v3.pht001808.v2.p2",880,990,1870,"08/20/2013","dbgap"
"7662","phs001856.v1.pht009598.v1.p1",4948,4976,9924,"2020/08/05","dbgap"
"7663","phs001062.v5.pht005262.v4.p2",793,206,999,"2021/05/21","dbgap"
"7664","phs000007.v32.pht000025.v4.p13",305,608,913,"2020/12/21","dbgap"
"7665","phs001311.v1.pht007926.v1.p1",32,26,58,"2018/05/15","dbgap"
"7666","phs000171.v1.pht000762.v1.p1",636,1283,1919,"12/11/2009","dbgap"
"7667","phs000918.v1.pht004747.v1.p1",6842,4560,11402,"06/10/2015","dbgap"
"7669","phs000782.v1.pht003991.v1.p1",15,1,16,"2017/10/04","dbgap"
"7670","phs002444.v1.pht011385.v1.p1",392,323,715,"2021/07/30","dbgap"
"7671","phs000001.v3.pht000378.v2.p1",1427,1659,3086,"02/24/2012","dbgap"
"7672","phs000007.v32.pht000110.v9.p13",1547,1604,3151,"2020/12/21","dbgap"
"7673","phs000385.v1.pht002339.v1.p1",53,47,100,"11/28/2011","dbgap"
"7674","phs000007.v32.pht000366.v7.p13",1574,1784,3358,"2020/12/21","dbgap"
"7675","phs000285.v3.pht001646.v2.p2",947,1065,2012,"08/20/2013","dbgap"
"7676","phs000678.v1.pht003562.v1.p1",1506,4447,5953,"05/13/2014","dbgap"
"7677","phs000007.v32.pht003310.v5.p13",1277,1517,2794,"2020/12/21","dbgap"
"7678","phs000021.v3.pht002001.v1.p2",2786,2278,5064,"10/25/2010","dbgap"
"7679","phs001424.v1.pht007001.v1.p1",7,5,12,"2017/10/10","dbgap"
"7680","phs002448.v1.pht011298.v1.p1",1,6,7,"2021/06/09","dbgap"
"7681","phs002255.v1.pht010675.v1.p1",209,180,389,"2020/11/20","dbgap"
"7682","phs001273.v3.pht006171.v2.p2",23125,13760,36885,"2019/10/10","dbgap"
"7683","phs000477.v1.pht002685.v1.p1",12,9,21,"04/16/2012","dbgap"
"7684","phs000239.v2.pht001221.v2.p1",2,4,6,"07/21/2010","dbgap"
"7685","phs001459.v1.pht007312.v1.p1",7,29,36,"2020/09/28","dbgap"
"7686","phs000343.v3.pht002718.v1.p1",1379,784,2163,"03/12/2013","dbgap"
"7688","phs002015.v1.pht010375.v1.p1",122,105,227,"2020/09/18","dbgap"
"7689","phs001381.v1.pht006568.v1.p1",352,315,667,"06/19/2017","dbgap"
"7690","phs001210.v1.pht005962.v1.p1",2501,2834,5335,"11/30/2016","dbgap"
"7691","phs002204.v1.pht010908.v1.p1",2,2,4,"2021/02/02","dbgap"
"7692","phs001502.v1.pht007261.v1.p1",49,46,95,"2018/09/07","dbgap"
"7693","phs001702.v1.pht008425.v1.p1",13,147,160,"2018/10/02","dbgap"
"7695","phs000280.v7.pht006487.v1.p1",1110,1400,2510,"2020/06/18","dbgap"
"7696","phs000571.v3.pht003176.v3.p2",1654,1222,2876,"12/01/2015","dbgap"
"7698","phs001545.v2.pht009964.v1.p1",316,152,468,"2021/07/13","dbgap"
"7699","phs000285.v3.pht001820.v2.p2",880,993,1873,"08/20/2013","dbgap"
"7700","phs001252.v1.pht006378.v1.p1",1684,1054,2738,"05/16/2017","dbgap"
"7701","phs000936.v1.pht004892.v1.p1",3623,2240,5863,"11/10/2015","dbgap"
"7702","phs000128.v3.pht000461.v2.p3",2943,3500,6443,"04/29/2016","dbgap"
"7703","phs000725.v2.pht003883.v2.p1",60,34,94,"01/30/2017","dbgap"
"7704","phs000376.v1.pht002309.v1.p1",23,21,44,"10/16/2014","dbgap"
"7705","phs002283.v1.pht010682.v1.p1",856,467,1323,"2020/11/30","dbgap"
"7706","phs002331.v1.pht011103.v1.p1",1840,599,2439,"2021/05/21","dbgap"
"7707","phs000086.v3.pht000336.v1.p1",731,666,1397,"11/04/2014","dbgap"
"7710","phs000007.v32.pht000208.v5.p13",603,635,1238,"2020/12/21","dbgap"
"7712","phs000209.v13.pht002513.v1.p3",1315,1499,2814,"11/05/2014","dbgap"
"7713","phs000007.v32.pht000673.v8.p13",1346,1413,2759,"2020/12/21","dbgap"
"7714","phs000574.v1.pht005858.v1.p1",41,940,981,"03/06/2017","dbgap"
"7715","phs000088.v1.pht000711.v1.p1",1427,1595,3022,"Tue Nov 18 09:14:35 2008","dbgap"
"7717","phs000997.v5.pht005087.v3.p2",118,55,173,"2021/05/20","dbgap"
"7718","phs000171.v1.pht000749.v1.p1",636,1284,1920,"12/11/2009","dbgap"
"7719","phs001877.v1.pht009484.v1.p1",24,7,31,"2019/09/19","dbgap"
"7720","phs000888.v1.pht004680.v1.p1",15663,20962,36625,"06/27/2016","dbgap"
"7721","phs000926.v1.pht004865.v1.p1",3,1,4,"08/04/2015","dbgap"
"7722","phs000260.v4.pht001259.v4.p2",92,18,110,"11/30/2015","dbgap"
"7723","phs000592.v1.pht006592.v1.p1",133,110,243,"07/12/2017","dbgap"
"7724","phs000742.v1.pht008118.v1.p1",12,14,26,"2018/07/23","dbgap"
"7725","phs000128.v3.pht000504.v2.p3",2943,3500,6443,"04/29/2016","dbgap"
"7726","phs000456.v1.pht002641.v1.p1",5,4,9,"05/02/2012","dbgap"
"7727","phs002545.v1.pht011484.v1.p1",19,7,26,"2021/09/14","dbgap"
"7728","phs001541.v1.pht008305.v1.p1",448,10907,11355,"2019/11/25","dbgap"
"7729","phs001527.v1.pht007520.v1.p1",213,6,219,"2018/04/04","dbgap"
"7730","phs001363.v1.pht006516.v1.p1",80,59,139,"2017/08/18","dbgap"
"7731","phs000436.v1.pht002835.v1.p1",745,457,1202,"11/19/2013","dbgap"
"7732","phs001256.v2.pht005993.v1.p1",50,18,68,"05/12/2017","dbgap"
"7733","phs000128.v3.pht000510.v2.p3",2943,3500,6443,"04/29/2016","dbgap"
"7734","phs000128.v3.pht000586.v2.p3",2943,3500,6443,"04/29/2016","dbgap"
"7735","phs001419.v1.pht007099.v1.p1",119,132,251,"2017/12/04","dbgap"
"7736","phs000280.v7.pht004091.v2.p1",6784,8156,14940,"2020/06/18","dbgap"
"7737","phs000285.v3.pht001765.v2.p2",163,299,462,"08/20/2013","dbgap"
"7738","phs000348.v2.pht002228.v2.p1",26,12,38,"12/19/2014","dbgap"
"7739","phs000742.v1.pht008114.v1.p1",695,725,1420,"2018/07/23","dbgap"
"7740","phs002234.v1.pht010516.v1.p1",3,1,4,"2020/09/15","dbgap"
"7741","phs002446.v1.pht011405.v1.p1",3,9,12,"2021/07/21","dbgap"
"7742","phs000745.v1.pht003847.v1.p1",10,10,20,"05/19/2014","dbgap"
"7743","phs001296.v2.pht006358.v2.p1",11,30,41,"2019/05/31","dbgap"
"7744","phs000286.v6.pht001958.v2.p2",1042,1823,2865,"2019/03/11","dbgap"
"7745","phs000888.v1.pht005585.v1.p1",3947,4491,8438,"08/12/2016","dbgap"
"7746","phs001319.v1.pht006208.v1.p1",4456,3110,7566,"03/29/2017","dbgap"
"7748","phs001845.v1.pht009406.v1.p1",5,3,8,"2019/08/27","dbgap"
"7749","phs000795.v1.pht004012.v1.p1",7,10,17,"09/11/2014","dbgap"
"7750","phs000742.v1.pht008121.v1.p1",538,640,1178,"2018/07/23","dbgap"
"7752","phs000577.v1.pht007271.v1.p1",89,136,225,"2017/12/20","dbgap"
"7753","phs000287.v7.pht001490.v1.p1",235,393,628,"2020/01/23","dbgap"
"7754","phs001318.v1.pht008033.v1.p1",22,10,32,"2018/05/31","dbgap"
"7756","phs000428.v2.pht002613.v2.p2",6516,9185,15701,"01/27/2017","dbgap"
"7758","phs000343.v3.pht002214.v1.p1",1379,785,2164,"03/12/2013","dbgap"
"7759","phs001491.v2.pht007251.v2.p1",164,188,352,"2020/03/09","dbgap"
"7760","phs000201.v2.pht000885.v1.p1",49,37,86,"04/09/2014","dbgap"
"7761","phs001297.v1.pht006199.v1.p1",47,50,97,"06/14/2017","dbgap"
"7762","phs001758.v1.pht008612.v1.p1",2,8,10,"2018/12/31","dbgap"
"7763","phs001488.v1.pht007407.v1.p1",260,293,553,"2018/02/08","dbgap"
"7764","phs001266.v2.pht007224.v1.p1",384,261,645,"2020/03/09","dbgap"
"7768","phs001518.v1.pht007333.v1.p1",1764,815,2579,"2020/01/07","dbgap"
"7769","phs000756.v1.pht007372.v1.p1",4392,4943,9335,"2018/12/27","dbgap"
"7770","phs000624.v1.pht009132.v1.p1",345,277,622,"2019/06/03","dbgap"
"7771","phs000007.v32.pht000676.v9.p13",1277,1876,3153,"2020/12/21","dbgap"
"7773","phs000863.v1.pht004742.v1.p1",348,282,630,"06/03/2015","dbgap"
"7775","phs001516.v1.pht007492.v1.p1",9564,12137,21701,"2018/03/15","dbgap"
"7777","phs001604.v2.pht009986.v1.p1",29,27,56,"2021/07/16","dbgap"
"7778","phs001542.v2.pht009645.v2.p1",462,528,990,"2021/10/04","dbgap"
"7780","phs000742.v1.pht008112.v1.p1",1963,2316,4279,"2018/07/23","dbgap"
"7781","phs001746.v1.pht008568.v1.p1",5,5,10,"2018/11/21","dbgap"
"7782","phs000837.v1.pht004439.v1.p1",3,3,6,"01/26/2015","dbgap"
"7783","phs001641.v1.pht010035.v1.p1",550,1248,1798,"2020/03/24","dbgap"
"7785","phs001811.v1.pht009061.v1.p1",33,69,102,"2019/05/13","dbgap"
"7786","phs000906.v1.pht007144.v1.p1",4648,4362,9010,"2017/12/04","dbgap"
"7787","phs000592.v1.pht006589.v1.p1",179,145,324,"07/12/2017","dbgap"
"7788","phs000673.v4.pht003661.v4.p1",731,557,1288,"2020/03/12","dbgap"
"7789","phs000477.v1.pht002686.v1.p1",12,9,21,"04/16/2012","dbgap"
"7790","phs000260.v4.pht001257.v4.p2",92,18,110,"11/30/2015","dbgap"
"7791","phs000574.v1.pht005860.v1.p1",41,939,980,"03/06/2017","dbgap"
"7792","phs000771.v2.pht003984.v2.p1",72,29,101,"2017/10/25","dbgap"
"7793","phs000990.v1.pht004998.v1.p1",1078,616,1694,"02/29/2016","dbgap"
"7794","phs000408.v1.pht002441.v1.p1",174,788,962,"11/15/2011","dbgap"
"7796","phs000280.v7.pht004079.v2.p1",810,1389,2199,"2020/06/18","dbgap"
"7797","phs002235.v1.pht010954.v1.p1",19,18,37,"2021/03/25","dbgap"
"7798","phs001723.v1.pht009725.v1.p1",2384,2409,4793,"2020/02/04","dbgap"
"7799","phs000016.v2.pht000055.v2.p2",1725,1044,2769,"11/27/2009","dbgap"
"7800","phs000285.v3.pht001659.v1.p2",3,5,8,"08/20/2013","dbgap"
"7801","phs001984.v1.pht010783.v1.p1",706,388,1094,"2020/12/14","dbgap"
"7802","phs001841.v1.pht009907.v1.p1",341,232,573,"2020/06/02","dbgap"
"7803","phs001115.v1.pht005482.v1.p1",2,1,3,"05/19/2016","dbgap"
"7804","phs000381.v1.pht002421.v1.p1",743,488,1231,"12/19/2011","dbgap"
"7805","phs001894.v1.pht009523.v1.p1",419,305,724,"2020/04/15","dbgap"
"7806","phs000222.v6.pht002876.v3.p2",535,950,1485,"2019/08/01","dbgap"
"7807","phs001253.v1.pht006165.v1.p1",486,77,563,"02/23/2017","dbgap"
"7808","phs001110.v3.pht006513.v3.p1",811,721,1532,"2020/09/08","dbgap"
"7809","phs001744.v1.pht008573.v1.p1",2299,926,3225,"2020/08/24","dbgap"
"7810","phs002045.v1.pht010307.v1.p1",9,6,15,"2020/06/30","dbgap"
"7811","phs000247.v5.pht003420.v1.p3",6,6,12,"07/27/2017","dbgap"
"7812","phs001392.v1.pht006908.v1.p1",18,8,26,"2017/09/22","dbgap"
"7813","phs001402.v3.pht008240.v1.p1",795,739,1534,"2021/06/16","dbgap"
"7815","phs000482.v1.pht002884.v1.p1",350,267,617,"12/07/2015","dbgap"
"7816","phs000681.v2.pht003870.v1.p1",859,1676,2535,"2019/05/03","dbgap"
"7817","phs000788.v2.pht004625.v2.p3",33200,47634,80834,"2018/02/01","dbgap"
"7818","phs001769.v1.pht008626.v1.p1",3,2,5,"2019/01/17","dbgap"
"7819","phs000285.v3.pht001756.v2.p2",421,447,868,"08/20/2013","dbgap"
"7820","phs001994.v1.pht010011.v1.p1",46,15,61,"2020/04/14","dbgap"
"7823","phs001397.v1.pht006951.v1.p1",848,1229,2077,"2017/10/05","dbgap"
"7824","phs000086.v3.pht000275.v1.p1",761,680,1441,"11/04/2014","dbgap"
"7825","phs001430.v2.pht008072.v2.p1",13,10,23,"2020/02/06","dbgap"
"7826","phs000128.v3.pht000593.v2.p3",2943,3500,6443,"04/29/2016","dbgap"
"7827","phs000433.v1.pht002437.v1.p1",1325,2872,4197,"04/04/2012","dbgap"
"7828","phs002506.v1.pht011539.v1.p1",4037,3056,7093,"2021/09/29","dbgap"
"7829","phs000285.v3.pht001863.v2.p2",160,193,353,"08/20/2013","dbgap"
"7830","phs000007.v32.pht007773.v2.p13",1094,1285,2379,"2020/12/21","dbgap"
"7831","phs000007.v32.pht002149.v6.p13",1325,1542,2867,"2020/12/21","dbgap"
"7832","phs001871.v1.pht009359.v1.p1",137,211,348,"2019/08/01","dbgap"
"7833","phs000128.v3.pht000506.v2.p3",2943,3500,6443,"04/29/2016","dbgap"
"7834","phs000745.v1.pht003849.v1.p1",10,10,20,"05/19/2014","dbgap"
"7835","phs000286.v6.pht008727.v1.p2",128,203,331,"2019/03/11","dbgap"
"7836","phs000578.v1.pht007002.v1.p1",49,45,94,"2017/10/11","dbgap"
"7837","phs000007.v32.pht006026.v4.p13",2119,2450,4569,"2020/12/21","dbgap"
"7838","phs001108.v1.pht007713.v1.p1",10,36,46,"2018/03/30","dbgap"
"7839","phs001869.v1.pht009395.v1.p1",526,475,1001,"2019/08/18","dbgap"
"7841","phs001662.v2.pht010052.v2.p1",843,758,1601,"2021/08/19","dbgap"
"7845","phs000285.v3.pht001558.v2.p2",941,1063,2004,"08/20/2013","dbgap"
"7846","phs000903.v1.pht004872.v1.p1",1150,1464,2614,"10/14/2015","dbgap"
"7847","phs000280.v7.pht004095.v2.p1",3798,4760,8558,"2020/06/18","dbgap"
"7848","phs000660.v1.pht003509.v1.p1",5,7,12,"06/04/2014","dbgap"
"7849","phs000274.v1.pht001276.v1.p1",756,1571,2327,"11/28/2011","dbgap"
"7850","phs000439.v1.pht002932.v1.p1",1262,626,1888,"06/20/2014","dbgap"
"7851","phs002212.v1.pht010984.v1.p1",16,2,18,"2021/02/22","dbgap"
"7852","phs001082.v1.pht005380.v1.p1",8,7,15,"02/09/2017","dbgap"
"7855","phs001833.v1.pht009153.v1.p1",134,165,299,"2019/06/14","dbgap"
"7856","phs001330.v2.pht007539.v2.p1",25,15,40,"2019/11/08","dbgap"
"7857","phs000460.v1.pht002547.v1.p1",553,1129,1682,"11/22/2013","dbgap"
"7858","phs000660.v1.pht003511.v1.p1",5,7,12,"06/04/2014","dbgap"
"7859","phs001632.v1.pht008532.v1.p1",648,760,1408,"2018/11/05","dbgap"
"7860","phs002480.v1.pht011396.v1.p1",1059,821,1880,"2021/08/11","dbgap"
"7861","phs000285.v3.pht001869.v2.p2",25,26,51,"08/20/2013","dbgap"
"7862","phs001241.v1.pht005921.v1.p1",7,8,15,"2017/11/14","dbgap"
"7863","phs001410.v1.pht008420.v1.p1",137,214,351,"2018/09/26","dbgap"
"7864","phs000280.v7.pht006430.v1.p1",215,300,515,"2020/06/18","dbgap"
"7865","phs001603.v2.pht009971.v1.p1",54,102,156,"2021/07/16","dbgap"
"7866","phs000655.v3.pht003488.v3.p1",383,324,707,"12/09/2016","dbgap"
"7867","phs000280.v7.pht004144.v2.p1",6120,7410,13530,"2020/06/18","dbgap"
"7868","phs001565.v1.pht007897.v1.p1",39,32,71,"2018/05/10","dbgap"
"7869","phs001027.v4.pht005215.v3.p1",94,61,155,"2021/06/23","dbgap"
"7871","phs000287.v7.pht001458.v1.p1",2375,3156,5531,"2020/01/23","dbgap"
"7873","phs000449.v2.pht002779.v2.p1",115,52,167,"07/31/2012","dbgap"
"7874","phs000285.v3.pht001792.v2.p2",866,968,1834,"08/20/2013","dbgap"
"7876","phs000353.v1.pht002249.v1.p1",2433,2477,4910,"08/08/2011","dbgap"
"7877","phs000401.v1.pht002475.v1.p1",153,54,207,"03/01/2012","dbgap"
"7879","phs001065.v1.pht005395.v1.p1",55,45,100,"05/24/2016","dbgap"
"7880","phs001311.v1.pht007929.v1.p1",34,26,60,"2018/05/15","dbgap"
"7882","phs001740.v1.pht008620.v1.p1",353,226,579,"2019/08/01","dbgap"
"7883","phs001980.v1.pht010075.v1.p1",4,1,5,"2020/12/22","dbgap"
"7884","phs001071.v1.pht005345.v1.p1",26,22,48,"2017/09/27","dbgap"
"7885","phs000456.v1.pht002643.v1.p1",692,623,1315,"05/02/2012","dbgap"
"7887","phs000280.v7.pht006444.v1.p1",2369,3152,5521,"2020/06/18","dbgap"
"7888","phs000492.v3.pht002710.v3.p2",52,55,107,"2018/10/19","dbgap"
"7890","phs001990.v1.pht010020.v1.p1",87,192,279,"2020/03/19","dbgap"
"7891","phs002437.v1.pht011429.v1.p1",8,9,17,"2021/07/29","dbgap"
"7892","phs000171.v1.pht000766.v1.p1",636,1284,1920,"12/11/2009","dbgap"
"7893","phs001151.v1.pht005538.v1.p1",2,3,5,"06/21/2016","dbgap"
"7894","phs001515.v2.pht009565.v2.p2",6398,2702,9100,"2021/09/09","dbgap"
"7896","phs000007.v32.pht000387.v4.p13",666,742,1408,"2020/12/21","dbgap"
"7897","phs001455.v1.pht007759.v1.p1",1905,3890,5795,"2018/04/04","dbgap"
"7898","phs000474.v3.pht002695.v3.p2",285,261,546,"04/25/2016","dbgap"
"7899","phs000007.v32.pht001042.v8.p13",1894,2159,4053,"2020/12/21","dbgap"
"7900","phs001940.v2.pht009697.v2.p1",19,17,36,"2020/01/31","dbgap"
"7901","phs001594.v1.pht008145.v1.p1",15,23,38,"2018/06/18","dbgap"
"7902","phs001676.v1.pht009436.v1.p1",5431,3770,9201,"2020/04/24","dbgap"
"7905","phs001617.v1.pht010619.v1.p1",65,57,122,"2021/01/12","dbgap"
"7906","phs000285.v3.pht001600.v2.p2",909,1029,1938,"08/20/2013","dbgap"
"7907","phs001992.v1.pht010283.v1.p1",462,270,732,"2020/07/23","dbgap"
"7910","phs001697.v1.pht010577.v1.p1",57,175,232,"2021/01/12","dbgap"
"7912","phs001430.v2.pht008074.v2.p1",13,10,23,"2020/02/06","dbgap"
"7913","phs000858.v1.pht004463.v1.p1",2,4,6,"09/01/2015","dbgap"
"7915","phs001507.v1.pht008696.v1.p1",8,8,16,"2020/02/04","dbgap"
"7916","phs000954.v4.pht006298.v2.p2",580,710,1290,"2021/05/11","dbgap"
"7917","phs001156.v2.pht007051.v1.p1",137,159,296,"2017/10/20","dbgap"
"7918","phs000209.v13.pht001114.v2.p3",1906,1952,3858,"11/05/2014","dbgap"
"7919","phs001741.v1.pht009163.v1.p1",573,332,905,"2020/01/07","dbgap"
"7920","phs000127.v2.pht000648.v1.p1",112,99,211,"09/03/2010","dbgap"
"7923","phs000497.v3.pht002713.v3.p2",252,164,416,"10/07/2016","dbgap"
"7925","phs001360.v1.pht006294.v1.p1",332,1172,1504,"2020/05/05","dbgap"
"7926","phs000636.v1.pht003425.v1.p1",32,44,76,"08/09/2013","dbgap"
"7927","phs002614.v1.pht011589.v1.p1",5,7,12,"2021/09/30","dbgap"
"7928","phs002254.v1.pht010539.v1.p1",70,64,134,"2020/09/28","dbgap"
"7929","phs002015.v1.pht010386.v1.p1",274,166,440,"2020/09/18","dbgap"
"7931","phs002067.v1.pht010408.v1.p1",38,27,65,"2020/10/21","dbgap"
"7933","phs001318.v1.pht008038.v1.p1",19,8,27,"2018/05/31","dbgap"
"7934","phs001542.v2.pht009642.v2.p1",469,535,1004,"2021/10/04","dbgap"
"7935","phs000964.v5.pht005766.v2.p1",1683,1981,3664,"2021/05/12","dbgap"
"7936","phs000545.v1.pht003764.v1.p1",482,282,764,"06/10/2015","dbgap"
"7937","phs001712.v1.pht008679.v1.p1",2,18,20,"2019/01/31","dbgap"
"7939","phs000888.v1.pht005579.v1.p1",381,120,501,"08/12/2016","dbgap"
"7940","phs000885.v1.pht004603.v1.p1",42,8,50,"03/19/2015","dbgap"
"7941","phs001654.v1.pht008441.v1.p1",68,14,82,"2018/10/31","dbgap"
"7943","phs001238.v2.pht006660.v1.p1",535,704,1239,"2018/06/14","dbgap"
"7944","phs000858.v1.pht004460.v1.p1",2,4,6,"09/01/2015","dbgap"
"7945","phs001711.v1.pht008527.v1.p1",5,3,8,"2021/02/11","dbgap"
"7946","phs000239.v2.pht001220.v1.p1",5,7,12,"07/21/2010","dbgap"
"7947","phs000001.v3.pht000376.v1.p1",1638,2124,3762,"02/24/2012","dbgap"
"7948","phs000280.v7.pht006460.v1.p1",65,101,166,"2020/06/18","dbgap"
"7949","phs002022.v1.pht010180.v1.p1",8,15,23,"2020/07/10","dbgap"
"7950","phs000809.v1.pht004345.v1.p1",6,2,8,"11/07/2014","dbgap"
"7951","phs000007.v32.pht000034.v9.p13",1741,1960,3701,"2020/12/21","dbgap"
"7952","phs000687.v1.pht003696.v1.p1",905,921,1826,"06/13/2014","dbgap"
"7953","phs001625.v1.pht008183.v1.p1",112,140,252,"2018/06/30","dbgap"
"7954","phs000007.v32.pht000745.v3.p13",344,345,689,"2020/12/21","dbgap"
"7955","phs001252.v1.pht006367.v1.p1",1367,792,2159,"05/16/2017","dbgap"
"7956","phs001403.v1.pht006841.v1.p1",7,14,21,"2017/09/12","dbgap"
"7957","phs001157.v1.pht005803.v1.p1",4380,4738,9118,"04/17/2017","dbgap"
"7958","phs000007.v32.pht005173.v1.p13",63,172,235,"2020/12/21","dbgap"
"7959","phs000421.v1.pht003235.v1.p1",925,1786,2711,"05/21/2013","dbgap"
"7960","phs001570.v2.pht007870.v2.p1",2,275,277,"2020/04/14","dbgap"
"7961","phs001662.v2.pht010054.v2.p1",842,757,1599,"2021/08/19","dbgap"
"7962","phs001584.v2.pht010215.v1.p2",48057,56813,104870,"2020/11/13","dbgap"
"7963","phs001218.v3.pht005957.v1.p1",1582,1628,3210,"2021/06/08","dbgap"
"7964","phs000007.v32.pht000108.v3.p13",39,70,109,"2020/12/21","dbgap"
"7965","phs001257.v2.pht005998.v2.p1",20,12,32,"03/24/2017","dbgap"
"7966","phs000740.v1.pht003817.v1.p1",24,6,30,"04/22/2014","dbgap"
"7967","phs000280.v7.pht004071.v2.p1",6105,7385,13490,"2020/06/18","dbgap"
"7968","phs000740.v1.pht003815.v1.p1",24,6,30,"04/22/2014","dbgap"
"7969","phs001626.v1.pht008476.v1.p1",47,47,94,"2018/10/29","dbgap"
"7970","phs000007.v32.pht000090.v2.p13",244,424,668,"2020/12/21","dbgap"
"7971","phs002289.v1.pht010892.v1.p1",9,4,13,"2021/01/28","dbgap"
"7972","phs001550.v2.pht007506.v1.p1",40,35,75,"2018/10/22","dbgap"
"7973","phs001194.v3.pht005817.v2.p2",1005,852,1857,"2020/07/24","dbgap"
"7974","phs000939.v2.pht004788.v2.p1",13,7,20,"2017/08/31","dbgap"
"7977","phs001471.v1.pht009805.v1.p1",125,334,459,"2020/01/10","dbgap"
"7979","phs000288.v2.pht002518.v2.p2",1381,1188,2569,"2017/11/06","dbgap"
"7981","phs000632.v1.pht003577.v1.p1",13,10,23,"02/07/2014","dbgap"
"7982","phs000942.v1.pht004836.v1.p1",26,232,258,"03/01/2016","dbgap"
"7984","phs001927.v1.pht011578.v1.p1",1224,1075,2299,"2021/09/24","dbgap"
"7985","phs000575.v2.pht005897.v2.p1",177,212,389,"2020/02/14","dbgap"
"7986","phs000727.v1.pht003865.v1.p1",116,95,211,"10/27/2014","dbgap"
"7987","phs000794.v1.pht004311.v1.p1",7,5,12,"12/18/2014","dbgap"
"7988","phs001594.v1.pht008146.v1.p1",15,23,38,"2018/06/18","dbgap"
"7989","phs000255.v1.pht001251.v1.p1",56,60,116,"06/09/2010","dbgap"
"7990","phs001238.v2.pht006038.v1.p1",201,551,752,"2018/06/14","dbgap"
"7991","phs000976.v2.pht005684.v2.p1",10693,9210,19903,"2020/11/09","dbgap"
"7992","phs000007.v32.pht000393.v8.p13",1582,1778,3360,"2020/12/21","dbgap"
"7993","phs000718.v1.pht003838.v1.p1",1243,1187,2430,"06/09/2015","dbgap"
"7994","phs001467.v2.pht009731.v2.p2",1699,3158,4857,"2021/08/10","dbgap"
"7995","phs000128.v3.pht000437.v2.p3",2943,3500,6443,"04/29/2016","dbgap"
"7996","phs000939.v2.pht004787.v2.p1",13,7,20,"2017/08/31","dbgap"
"7997","phs000285.v3.pht001700.v2.p2",947,1065,2012,"08/20/2013","dbgap"
"7998","phs001392.v1.pht006900.v1.p1",6,1,7,"2017/09/22","dbgap"
"7999","phs000007.v32.pht005150.v3.p13",1119,1358,2477,"2020/12/21","dbgap"
"8000","phs000287.v7.pht001489.v1.p1",2375,3156,5531,"2020/01/23","dbgap"
"8001","phs000280.v7.pht004205.v2.p1",4883,6019,10902,"2020/06/18","dbgap"
"8004","phs001879.v1.pht009458.v1.p1",92,77,169,"2019/09/19","dbgap"
"8005","phs000708.v1.pht003725.v1.p1",91,109,200,"07/14/2014","dbgap"
"8006","phs000578.v1.pht007016.v1.p1",49,44,93,"2017/10/11","dbgap"
"8007","phs000972.v5.pht005679.v1.p1",532,800,1332,"2021/05/20","dbgap"
"8008","phs001298.v1.pht008648.v1.p1",2298,2504,4802,"2019/01/29","dbgap"
"8010","phs000007.v32.pht002565.v5.p13",813,815,1628,"2020/12/21","dbgap"
"8011","phs000086.v3.pht000270.v1.p1",757,679,1436,"11/04/2014","dbgap"
"8013","phs001745.v1.pht008600.v1.p1",597,506,1103,"2019/02/06","dbgap"
"8014","phs001757.v1.pht008668.v1.p1",148,184,332,"2019/03/11","dbgap"
"8016","phs002310.v1.pht011204.v1.p1",1345,576,1921,"2021/05/05","dbgap"
"8017","phs000007.v32.pht000168.v3.p13",479,774,1253,"2020/12/21","dbgap"
"8018","phs001033.v1.pht005200.v1.p1",85,74,159,"09/02/2016","dbgap"
"8019","phs000280.v7.pht004161.v2.p1",6780,8155,14935,"2020/06/18","dbgap"
"8020","phs000286.v6.pht008730.v1.p2",1010,1785,2795,"2019/03/11","dbgap"
"8021","phs000219.v1.pht001067.v1.p1",664,1054,1718,"01/19/2010","dbgap"
"8022","phs000166.v2.pht000728.v1.p1",2474,2176,4650,"09/03/2009","dbgap"
"8023","phs000701.v1.pht005521.v1.p1",48,43,91,"06/01/2017","dbgap"
"8025","phs000238.v1.pht002007.v1.p1",2330,2786,5116,"11/15/2013","dbgap"
"8026","phs001163.v1.pht011096.v1.p1",181,167,348,"2021/04/06","dbgap"
"8027","phs001423.v3.pht006987.v3.p2",722,485,1207,"2021/05/13","dbgap"
"8029","phs000280.v7.pht006458.v1.p1",1058,1298,2356,"2020/06/18","dbgap"
"8031","phs000007.v32.pht000294.v2.p13",318,554,872,"2020/12/21","dbgap"
"8033","phs001721.v1.pht009718.v1.p1",2234,2574,4808,"2020/02/04","dbgap"
"8034","phs001419.v1.pht007082.v1.p1",490,502,992,"2017/12/04","dbgap"
"8035","phs000550.v1.pht003130.v1.p1",2,1,3,"01/18/2013","dbgap"
"8036","phs000276.v2.pht002004.v2.p1",2592,2810,5402,"01/22/2014","dbgap"
"8037","phs000086.v3.pht000355.v1.p1",11,6,17,"11/04/2014","dbgap"
"8038","phs001632.v1.pht008531.v1.p1",648,760,1408,"2018/11/05","dbgap"
"8039","phs002059.v1.pht010424.v1.p1",925,887,1812,"2020/12/18","dbgap"
"8041","phs001488.v1.pht007376.v1.p1",244,266,510,"2018/02/08","dbgap"
"8043","phs001326.v1.pht007830.v1.p1",22,3,25,"2018/04/16","dbgap"
"8044","phs001194.v3.pht005819.v2.p2",1289,990,2279,"2020/07/24","dbgap"
"8045","phs002291.v1.pht010801.v1.p1",4,1,5,"2021/01/21","dbgap"
"8046","phs001065.v1.pht005419.v1.p1",296,313,609,"05/24/2016","dbgap"
"8047","phs001554.v1.pht007607.v1.p1",1075,1817,2892,"2018/03/09","dbgap"
"8048","phs000128.v3.pht000484.v2.p3",2943,3500,6443,"04/29/2016","dbgap"
"8049","phs000314.v1.pht002070.v1.p1",899,857,1756,"07/17/2012","dbgap"
"8050","phs001840.v1.pht009148.v1.p1",4,2,6,"2019/06/13","dbgap"
"8052","phs000796.v1.pht005385.v1.p1",1092,2012,3104,"05/17/2016","dbgap"
"8053","phs000128.v3.pht000530.v2.p3",2943,3500,6443,"04/29/2016","dbgap"
"8054","phs000128.v3.pht000565.v2.p3",2943,3500,6443,"04/29/2016","dbgap"
"8055","phs001230.v1.pht009239.v1.p1",1164,1116,2280,"2019/07/19","dbgap"
"8056","phs001293.v3.pht008897.v1.p1",774,1326,2100,"2021/06/09","dbgap"
"8057","phs001415.v1.pht006684.v1.p1",15174,14566,29740,"2019/03/25","dbgap"
"8059","phs001163.v1.pht011098.v1.p1",72,58,130,"2021/04/06","dbgap"
"8060","phs000578.v1.pht007008.v1.p1",49,45,94,"2017/10/11","dbgap"
"8061","phs000445.v1.pht002507.v1.p1",17,3,20,"10/25/2012","dbgap"
"8062","phs001940.v2.pht009698.v1.p1",19,17,36,"2020/01/31","dbgap"
"8063","phs001318.v1.pht008027.v1.p1",24,13,37,"2018/05/31","dbgap"
"8064","phs000484.v1.pht002682.v1.p1",5,2,7,"06/01/2012","dbgap"
"8066","phs000712.v1.pht003711.v1.p1",303,220,523,"09/25/2015","dbgap"
"8067","phs001252.v1.pht006386.v1.p1",1691,1055,2746,"05/16/2017","dbgap"
"8068","phs000287.v7.pht001479.v1.p1",2375,3156,5531,"2020/01/23","dbgap"
"8069","phs001488.v1.pht007431.v1.p1",260,293,553,"2018/02/08","dbgap"
"8070","phs000590.v1.pht008261.v1.p1",3,2,5,"2018/08/03","dbgap"
"8071","phs000007.v32.pht000388.v7.p13",1124,930,2054,"2020/12/21","dbgap"
"8072","phs001330.v2.pht007534.v2.p1",24,11,35,"2019/11/08","dbgap"
"8073","phs000571.v3.pht003174.v3.p2",2681,2382,5063,"12/01/2015","dbgap"
"8074","phs000285.v3.pht001566.v2.p2",947,1064,2011,"08/20/2013","dbgap"
"8076","phs001794.v1.pht008904.v1.p1",6,6,12,"2019/03/28","dbgap"
"8077","phs000434.v1.pht002604.v1.p1",4,4,8,"09/10/2012","dbgap"
"8078","phs002254.v1.pht010542.v1.p1",70,64,134,"2020/09/28","dbgap"
"8079","phs001488.v1.pht007397.v1.p1",209,232,441,"2018/02/08","dbgap"
"8080","phs000914.v1.pht005253.v1.p1",1442,2059,3501,"04/20/2016","dbgap"
"8081","phs001123.v2.pht006062.v2.p1",5879,8482,14361,"2019/09/16","dbgap"
"8082","phs000280.v7.pht006418.v1.p1",1003,1248,2251,"2020/06/18","dbgap"
"8083","phs001676.v1.pht009438.v1.p1",5431,3770,9201,"2020/04/24","dbgap"
"8084","phs000551.v1.pht003062.v1.p1",387,207,594,"12/03/2013","dbgap"
"8085","phs001770.v1.pht008687.v1.p1",196,160,356,"2019/02/01","dbgap"
"8086","phs001101.v1.pht005365.v1.p1",599,482,1081,"05/09/2016","dbgap"
"8087","phs000833.v7.pht004358.v6.p1",29,15,44,"2017/11/01","dbgap"
"8088","phs001993.v1.pht010083.v1.p1",30,39,69,"2020/09/04","dbgap"
"8089","phs002121.v1.pht011551.v1.p1",63,57,120,"2021/09/14","dbgap"
"8090","phs001251.v1.pht005947.v1.p1",2,2,4,"11/21/2016","dbgap"
"8091","phs001677.v1.pht008380.v1.p1",182,911,1093,"2018/09/17","dbgap"
"8092","phs000280.v7.pht006411.v1.p1",2188,2911,5099,"2020/06/18","dbgap"
"8095","phs001253.v1.pht006166.v1.p1",486,77,563,"02/23/2017","dbgap"
"8097","phs000007.v32.pht000172.v2.p13",33,66,99,"2020/12/21","dbgap"
"8098","phs001542.v2.pht009644.v2.p1",469,535,1004,"2021/10/04","dbgap"
"8099","phs000007.v32.pht002155.v6.p13",2018,2340,4358,"2020/12/21","dbgap"
"8101","phs000371.v2.pht002985.v1.p1",1245,1591,2836,"10/25/2016","dbgap"
"8102","phs001316.v1.pht008011.v1.p1",2,1,3,"2018/05/31","dbgap"
"8103","phs000697.v1.pht007705.v1.p1",28,6,34,"2018/03/26","dbgap"
"8104","phs001189.v4.pht006138.v2.p1",3,1,4,"2021/06/01","dbgap"
"8105","phs000831.v1.pht004906.v1.p1",84,73,157,"08/13/2015","dbgap"
"8106","phs001897.v1.pht009542.v1.p1",20,18,38,"2019/12/03","dbgap"
"8108","phs000364.v2.pht002262.v2.p1",26,16,42,"09/24/2013","dbgap"
"8109","phs001392.v1.pht006909.v1.p1",18,10,28,"2017/09/22","dbgap"
"8110","phs000984.v1.pht005011.v1.p1",96,106,202,"09/21/2016","dbgap"
"8111","phs000234.v2.pht001153.v2.p2",1609,2137,3746,"2018/05/29","dbgap"
"8112","phs001641.v1.pht010039.v1.p1",504,1166,1670,"2020/03/24","dbgap"
"8113","phs001134.v1.pht011224.v1.p1",106,336,442,"2021/05/17","dbgap"
"8114","phs000286.v6.pht001982.v2.p2",876,1543,2419,"2019/03/11","dbgap"
"8117","phs000459.v1.pht002544.v1.p1",736,683,1419,"01/07/2016","dbgap"
"8118","phs000007.v32.pht000030.v9.p13",2424,2578,5002,"2020/12/21","dbgap"
"8119","phs001703.v3.pht008451.v2.p1",54,37,91,"2019/11/27","dbgap"
"8120","phs001525.v1.pht007479.v1.p1",25,22,47,"2018/02/12","dbgap"
"8122","phs001460.v1.pht006911.v1.p1",12,4,16,"2017/09/22","dbgap"
"8123","phs001038.v1.pht005209.v1.p1",9,11,20,"02/23/2016","dbgap"
"8124","phs000571.v3.pht003193.v3.p2",3344,2916,6260,"12/01/2015","dbgap"
"8126","phs001412.v3.pht006744.v2.p1",465,516,981,"2021/06/16","dbgap"
"8127","phs001479.v1.pht008100.v1.p1",1,1,2,"2018/06/07","dbgap"
"8128","phs000007.v32.pht002431.v5.p13",1069,1362,2431,"2020/12/21","dbgap"
"8129","phs000007.v32.pht000028.v3.p13",164,378,542,"2020/12/21","dbgap"
"8130","phs000171.v1.pht000759.v1.p1",324,665,989,"12/11/2009","dbgap"
"8131","phs000575.v2.pht005890.v2.p1",177,213,390,"2020/02/14","dbgap"
"8133","phs001467.v2.pht009732.v2.p2",1691,3128,4819,"2021/08/10","dbgap"
"8135","phs000417.v2.pht002396.v2.p1",177,93,270,"02/02/2012","dbgap"
"8136","phs000649.v2.pht003761.v2.p2",517,523,1040,"2021/01/08","dbgap"
"8137","phs001488.v1.pht007383.v1.p1",253,286,539,"2018/02/08","dbgap"
"8138","phs000219.v1.pht001097.v1.p1",428,734,1162,"01/19/2010","dbgap"
"8139","phs002319.v1.pht010924.v1.p1",716,813,1529,"2021/02/05","dbgap"
"8140","phs000285.v3.pht001571.v2.p2",148,270,418,"08/20/2013","dbgap"
"8141","phs001238.v2.pht006654.v1.p1",701,879,1580,"2018/06/14","dbgap"
"8142","phs000188.v1.pht000978.v1.p1",814,1539,2353,"10/05/2010","dbgap"
"8143","phs000007.v32.pht010724.v1.p13",1608,1882,3490,"2020/12/21","dbgap"
"8145","phs001662.v2.pht010070.v1.p1",843,758,1601,"2021/08/19","dbgap"
"8146","phs000768.v2.pht004480.v2.p1",31,22,53,"12/20/2016","dbgap"
"8147","phs000921.v4.pht004881.v4.p1",981,1123,2104,"2019/11/20","dbgap"
"8148","phs000855.v1.pht004551.v1.p1",8,7,15,"03/10/2015","dbgap"
"8149","phs000442.v1.pht002489.v1.p1",53,38,91,"04/12/2012","dbgap"
"8150","phs001327.v2.pht011188.v1.p1",13724,11941,25665,"2021/05/07","dbgap"
"8152","phs001373.v2.pht006704.v2.p2",18,15,33,"2019/10/16","dbgap"
"8153","phs000007.v32.pht000079.v8.p13",1519,1752,3271,"2020/12/21","dbgap"
"8155","phs000997.v5.pht005089.v4.p2",118,55,173,"2021/05/20","dbgap"
"8156","phs001564.v3.pht007990.v3.p1",49,41,90,"2020/02/13","dbgap"
"8157","phs002311.v1.pht010934.v1.p1",40,66,106,"2021/03/30","dbgap"
"8158","phs002405.v1.pht011237.v1.p1",7,9,16,"2021/08/13","dbgap"
"8160","phs001430.v2.pht008079.v2.p1",12,10,22,"2020/02/06","dbgap"
"8161","phs001058.v1.pht005238.v1.p1",306,197,503,"01/25/2016","dbgap"
"8162","phs001278.v1.pht006272.v1.p1",85,111,196,"06/16/2017","dbgap"
"8163","phs000007.v32.pht001045.v2.p13",469,753,1222,"2020/12/21","dbgap"
"8164","phs000007.v32.pht003315.v9.p13",7046,8098,15144,"2020/12/21","dbgap"
"8166","phs000987.v1.pht004969.v1.p1",101,83,184,"04/05/2017","dbgap"
"8167","phs001437.v1.pht006808.v1.p1",157,83,240,"2019/09/11","dbgap"
"8168","phs001479.v1.pht008103.v1.p1",1,1,2,"2018/06/07","dbgap"
"8169","phs000285.v3.pht001754.v2.p2",109,82,191,"08/20/2013","dbgap"
"8170","phs001134.v1.pht011226.v1.p1",105,335,440,"2021/05/17","dbgap"
"8172","phs001877.v1.pht009482.v1.p1",24,7,31,"2019/09/19","dbgap"
"8174","phs000440.v1.pht002492.v1.p1",693,660,1353,"03/15/2012","dbgap"
"8175","phs000496.v1.pht003167.v1.p1",1480,2486,3966,"03/28/2014","dbgap"
"8176","phs001037.v1.pht005919.v1.p1",3570,3442,7012,"11/09/2016","dbgap"
"8177","phs001517.v2.pht007481.v2.p2",514,480,994,"2020/04/30","dbgap"
"8178","phs000500.v1.pht003117.v1.p1",4,2,6,"12/31/2012","dbgap"
"8179","phs000425.v1.pht002503.v1.p1",1624,1285,2909,"03/06/2012","dbgap"
"8180","phs001270.v1.pht006249.v1.p1",5,9,14,"2017/10/04","dbgap"
"8181","phs000524.v1.pht002919.v1.p1",1986,1612,3598,"12/27/2012","dbgap"
"8182","phs001724.v1.pht008507.v1.p1",2,1,3,"2018/10/30","dbgap"
"8183","phs000007.v32.pht002567.v4.p13",429,543,972,"2020/12/21","dbgap"
"8184","phs001979.v1.pht010002.v1.p1",5,2,7,"2020/03/19","dbgap"
"8185","phs001428.v1.pht008387.v1.p1",16,1831,1847,"2018/09/20","dbgap"
"8186","phs001914.v1.pht009888.v1.p1",31,16,47,"2020/02/25","dbgap"
"8187","phs000209.v13.pht002195.v2.p3",3060,3369,6429,"11/05/2014","dbgap"
"8188","phs001507.v1.pht008699.v1.p1",8,8,16,"2020/02/04","dbgap"
"8189","phs000345.v1.pht002374.v1.p1",545,483,1028,"09/15/2011","dbgap"
"8190","phs000389.v1.pht002378.v1.p1",911,893,1804,"09/19/2011","dbgap"
"8191","phs000391.v1.pht002996.v1.p1",332,334,666,"11/16/2012","dbgap"
"8193","phs000958.v1.pht004959.v1.p1",48,52,100,"08/31/2015","dbgap"
"8194","phs000258.v2.pht001240.v2.p1",160,244,404,"04/14/2011","dbgap"
"8196","phs001331.v2.pht009415.v1.p1",114,92,206,"2019/08/30","dbgap"
"8197","phs001281.v2.pht006126.v2.p1",15,25,40,"2019/02/21","dbgap"
"8198","phs000373.v1.pht007128.v1.p1",5135,4,5139,"2017/11/30","dbgap"
"8199","phs000352.v1.pht002286.v1.p1",21,25,46,"10/28/2011","dbgap"
"8200","phs000280.v7.pht004054.v5.p1",705,519,1224,"2020/06/18","dbgap"
"8202","phs001539.v1.pht007521.v1.p1",44,57,101,"2018/02/27","dbgap"
"8204","phs000285.v3.pht001685.v2.p2",50,50,100,"08/20/2013","dbgap"
"8205","phs001109.v3.pht005445.v2.p2",1165,704,1869,"2020/02/28","dbgap"
"8207","phs000007.v32.pht005161.v3.p13",1360,1515,2875,"2020/12/21","dbgap"
"8208","phs000691.v2.pht003653.v2.p1",291,197,488,"03/11/2015","dbgap"
"8209","phs001396.v1.pht006737.v1.p1",749,821,1570,"2018/05/14","dbgap"
"8210","phs000674.v1.pht003636.v1.p1",33235,47680,80915,"01/27/2014","dbgap"
"8212","phs001251.v1.pht005948.v1.p1",2,2,4,"11/21/2016","dbgap"
"8213","phs000086.v3.pht000232.v1.p1",761,680,1441,"11/04/2014","dbgap"
"8214","phs002393.v1.pht011139.v1.p1",68,70,138,"2021/04/28","dbgap"
"8215","phs001135.v2.pht005982.v1.p1",690,297,987,"2020/03/09","dbgap"
"8216","phs001278.v1.pht006263.v1.p1",85,111,196,"06/16/2017","dbgap"
"8219","phs001375.v2.pht006523.v1.p1",408,628,1036,"2021/03/22","dbgap"
"8222","phs000858.v1.pht004461.v1.p1",2,4,6,"09/01/2015","dbgap"
"8223","phs000252.v2.pht001269.v1.p1",7,4,11,"03/07/2011","dbgap"
"8224","phs000280.v7.pht004159.v2.p1",459,571,1030,"2020/06/18","dbgap"
"8225","phs000450.v4.pht002526.v3.p1",171,153,324,"2020/10/29","dbgap"
"8226","phs000343.v3.pht003155.v1.p1",1379,785,2164,"03/12/2013","dbgap"
"8227","phs001252.v1.pht006381.v1.p1",1691,1055,2746,"05/16/2017","dbgap"
"8231","phs001084.v1.pht005326.v1.p1",8,10,18,"03/07/2016","dbgap"
"8232","phs001224.v1.pht005940.v1.p1",9,8,17,"11/18/2016","dbgap"
"8233","phs000007.v32.pht000395.v9.p13",1296,1467,2763,"2020/12/21","dbgap"
"8234","phs001676.v1.pht009437.v1.p1",5431,3770,9201,"2020/04/24","dbgap"
"8235","phs000759.v1.pht003913.v1.p1",8,10,18,"06/20/2014","dbgap"
"8236","phs001177.v2.pht005666.v2.p1",1475,1882,3357,"2019/11/27","dbgap"
"8238","phs001793.v1.pht008901.v1.p1",21,12,33,"2020/08/04","dbgap"
"8239","phs000540.v1.pht003044.v1.p1",5,3,8,"11/08/2012","dbgap"
"8241","phs000648.v1.pht004579.v1.p1",4525,3478,8003,"06/23/2015","dbgap"
"8242","phs000742.v1.pht008113.v1.p1",1342,1657,2999,"2018/07/23","dbgap"
"8243","phs000789.v1.pht004290.v1.p1",998,1410,2408,"10/21/2015","dbgap"
"8244","phs000936.v1.pht004890.v1.p1",3623,2240,5863,"11/10/2015","dbgap"
"8245","phs001366.v1.pht006578.v1.p1",3,9,12,"2017/12/04","dbgap"
"8246","phs001367.v1.pht008249.v1.p1",4737,5237,9974,"2018/07/25","dbgap"
"8247","phs001074.v1.pht005340.v1.p1",204,210,414,"03/15/2016","dbgap"
"8248","phs001310.v1.pht006868.v1.p1",31,25,56,"2017/09/18","dbgap"
"8249","phs000280.v7.pht006420.v1.p1",2348,3138,5486,"2020/06/18","dbgap"
"8250","phs000285.v3.pht001602.v2.p2",262,295,557,"08/20/2013","dbgap"
"8251","phs001929.v1.pht010016.v1.p1",325,275,600,"2020/03/26","dbgap"
"8252","phs000353.v1.pht002256.v1.p1",92,99,191,"08/08/2011","dbgap"
"8253","phs000007.v32.pht000823.v7.p13",1894,2159,4053,"2020/12/21","dbgap"
"8254","phs001230.v1.pht009241.v1.p1",1164,1116,2280,"2019/07/19","dbgap"
"8255","phs000792.v1.pht004250.v1.p1",15,3,18,"09/18/2014","dbgap"
"8256","phs000285.v3.pht001625.v2.p2",912,1037,1949,"08/20/2013","dbgap"
"8258","phs001380.v1.pht009233.v1.p1",266,172,438,"2019/10/11","dbgap"
"8259","phs000588.v1.pht009311.v1.p1",42,151,193,"2019/07/26","dbgap"
"8261","phs001853.v1.pht009813.v1.p1",11,4,15,"2020/02/19","dbgap"
"8262","phs000998.v2.pht005054.v2.p1",14,20,34,"2020/08/26","dbgap"
"8264","phs001779.v1.pht010208.v1.p1",34,119,153,"2020/06/25","dbgap"
"8265","phs000701.v1.pht005520.v1.p1",48,43,91,"06/01/2017","dbgap"
"8267","phs000588.v1.pht009296.v1.p1",27,112,139,"2019/07/26","dbgap"
"8268","phs000209.v13.pht001205.v1.p3",440,440,880,"11/05/2014","dbgap"
"8269","phs000993.v5.pht005014.v3.p2",464,245,709,"2021/05/20","dbgap"
"8270","phs000357.v2.pht002331.v2.p1",85,748,833,"2018/09/19","dbgap"
"8271","phs001406.v1.pht007754.v1.p1",1170,1785,2955,"2019/10/11","dbgap"
"8272","phs001602.v2.pht009978.v1.p1",5,2,7,"2021/07/16","dbgap"
"8273","phs000268.v1.pht002163.v1.p1",85,96,181,"02/24/2011","dbgap"
"8274","phs001021.v1.pht005266.v1.p1",136,274,410,"02/01/2016","dbgap"
"8275","phs000219.v1.pht001076.v1.p1",664,1054,1718,"01/19/2010","dbgap"
"8276","phs000293.v1.pht003363.v1.p1",1714,2163,3877,"07/25/2013","dbgap"
"8278","phs001805.v1.pht008957.v1.p1",2,2,4,"2019/04/09","dbgap"
"8279","phs000293.v1.pht003364.v1.p1",1714,2163,3877,"07/25/2013","dbgap"
"8280","phs000741.v2.pht003919.v2.p1",458,510,968,"11/14/2016","dbgap"
"8281","phs000902.v1.pht004671.v1.p1",607,177,784,"01/20/2016","dbgap"
"8282","phs001819.v2.pht009449.v1.p1",6,7,13,"2020/12/18","dbgap"
"8283","phs000521.v2.pht007035.v2.p1",2,1,3,"2020/03/13","dbgap"
"8284","phs000589.v1.pht009170.v1.p1",9,127,136,"2019/06/14","dbgap"
"8285","phs001238.v2.pht006028.v2.p1",2731,3446,6177,"2018/06/14","dbgap"
"8287","phs002545.v1.pht011486.v1.p1",19,7,26,"2021/09/14","dbgap"
"8289","phs001817.v1.pht009136.v1.p1",85,177,262,"2019/06/04","dbgap"
"8290","phs001065.v1.pht005399.v1.p1",238,248,486,"05/24/2016","dbgap"
"8291","phs000750.v1.pht003936.v1.p1",113,138,251,"09/03/2014","dbgap"
"8293","phs001561.v1.pht010998.v1.p1",70,65,135,"2021/03/31","dbgap"
"8294","phs002335.v1.pht010941.v1.p1",6,6,12,"2021/02/08","dbgap"
"8295","phs001154.v1.pht008374.v1.p1",7278,3340,10618,"2018/09/17","dbgap"
"8297","phs001331.v2.pht009414.v1.p1",434,286,720,"2019/08/30","dbgap"
"8298","phs000590.v1.pht008274.v1.p1",33,36,69,"2018/08/03","dbgap"
"8299","phs001894.v1.pht009522.v1.p1",419,305,724,"2020/04/15","dbgap"
"8300","phs001575.v2.pht009608.v1.p1",16,26,42,"2019/11/12","dbgap"
"8301","phs000697.v1.pht007706.v1.p1",28,6,34,"2018/03/26","dbgap"
"8302","phs000262.v3.pht006261.v1.p2",31,11,42,"2017/09/05","dbgap"
"8303","phs000222.v6.pht003453.v2.p2",413,696,1109,"2019/08/01","dbgap"
"8304","phs000980.v1.pht004963.v1.p1",16,18,34,"11/16/2015","dbgap"
"8305","phs001256.v2.pht005995.v2.p1",50,18,68,"05/12/2017","dbgap"
"8306","phs001694.v1.pht008495.v1.p1",6,2,8,"2018/10/24","dbgap"
"8307","phs000382.v3.pht002321.v3.p1",51,55,106,"2018/01/18","dbgap"
"8308","phs000219.v1.pht001058.v1.p1",76,134,210,"01/19/2010","dbgap"
"8309","phs000479.v1.pht002667.v1.p1",2,1,3,"08/15/2012","dbgap"
"8310","phs000007.v32.pht002568.v7.p13",1428,1741,3169,"2020/12/21","dbgap"
"8311","phs000590.v1.pht008270.v1.p1",32,36,68,"2018/08/03","dbgap"
"8313","phs000589.v1.pht009181.v1.p1",9,127,136,"2019/06/14","dbgap"
"8314","phs000128.v3.pht000488.v2.p3",2943,3500,6443,"04/29/2016","dbgap"
"8315","phs001683.v2.pht008865.v2.p1",372,363,735,"2020/07/15","dbgap"
"8316","phs001436.v1.pht007250.v1.p1",819,863,1682,"2019/09/20","dbgap"
"8317","phs000620.v1.pht003896.v1.p1",2824,3273,6097,"03/03/2015","dbgap"
"8318","phs001311.v1.pht007925.v1.p1",32,26,58,"2018/05/15","dbgap"
"8320","phs000286.v6.pht001976.v2.p2",1291,2153,3444,"2019/03/11","dbgap"
"8321","phs002333.v1.pht010919.v1.p1",4,4,8,"2021/02/04","dbgap"
"8322","phs000455.v1.pht002575.v1.p1",7,3,10,"06/20/2012","dbgap"
"8323","phs001318.v1.pht008035.v1.p1",23,13,36,"2018/05/31","dbgap"
"8324","phs000007.v32.pht000144.v7.p13",1155,944,2099,"2020/12/21","dbgap"
"8325","phs001317.v1.pht008045.v1.p1",6,6,12,"2018/06/01","dbgap"
"8326","phs001897.v1.pht009543.v1.p1",20,18,38,"2019/12/03","dbgap"
"8327","phs000588.v1.pht009287.v1.p1",1,2,3,"2019/07/26","dbgap"
"8328","phs000257.v3.pht003092.v1.p1",32,37,69,"2018/09/19","dbgap"
"8329","phs000138.v2.pht000642.v2.p1",18,1510,1528,"06/01/2010","dbgap"
"8330","phs001090.v1.pht009051.v1.p1",2345,2538,4883,"2019/05/21","dbgap"
"8331","phs001030.v1.pht005091.v1.p1",187,201,388,"05/31/2017","dbgap"
"8332","phs000128.v3.pht000588.v2.p3",2943,3500,6443,"04/29/2016","dbgap"
"8333","phs000639.v1.pht004778.v1.p1",479,326,805,"11/02/2015","dbgap"
"8334","phs000504.v2.pht002821.v2.p2",55,37,92,"11/27/2013","dbgap"
"8335","phs001808.v1.pht008975.v1.p1",4,10,14,"2019/04/19","dbgap"
"8336","phs000571.v3.pht003187.v3.p2",35,26,61,"12/01/2015","dbgap"
"8337","phs001219.v1.pht007857.v1.p1",236,239,475,"2018/04/23","dbgap"
"8338","phs001834.v1.pht009421.v1.p1",12,18,30,"2020/01/10","dbgap"
"8339","phs001202.v1.pht005775.v1.p1",7431,2665,10096,"07/10/2017","dbgap"
"8340","phs001331.v2.pht006931.v2.p1",123,65,188,"2019/08/30","dbgap"
"8341","phs001359.v3.pht008688.v1.p1",509,560,1069,"2021/06/10","dbgap"
"8343","phs001734.v1.pht008826.v1.p1",363,244,607,"2019/03/25","dbgap"
"8344","phs000367.v1.pht003262.v1.p1",330,377,707,"08/09/2013","dbgap"
"8345","phs000007.v32.pht003098.v6.p13",1764,2007,3771,"2020/12/21","dbgap"
"8346","phs000209.v13.pht001984.v1.p3",435,467,902,"11/05/2014","dbgap"
"8347","phs001306.v1.pht006190.v1.p1",5394,6280,11674,"06/01/2017","dbgap"
"8348","phs000280.v7.pht006432.v1.p1",603,785,1388,"2020/06/18","dbgap"
"8350","phs000171.v1.pht000751.v1.p1",303,626,929,"12/11/2009","dbgap"
"8351","phs001406.v1.pht007744.v1.p1",450,821,1271,"2019/10/11","dbgap"
"8352","phs000280.v7.pht004113.v2.p1",6120,7409,13529,"2020/06/18","dbgap"
"8353","phs000007.v32.pht000304.v8.p13",1895,2163,4058,"2020/12/21","dbgap"
"8354","phs001767.v1.pht008660.v1.p1",143,55,198,"2019/01/29","dbgap"
"8355","phs001115.v1.pht005479.v1.p1",2,1,3,"05/19/2016","dbgap"
"8357","phs001378.v1.pht006689.v1.p1",4,2,6,"2019/05/02","dbgap"
"8359","phs000575.v2.pht005901.v2.p1",177,213,390,"2020/02/14","dbgap"
"8360","phs002333.v1.pht010920.v1.p1",4,4,8,"2021/02/04","dbgap"
"8361","phs000285.v3.pht001594.v2.p2",947,1065,2012,"08/20/2013","dbgap"
"8362","phs001539.v1.pht007524.v1.p1",44,57,101,"2018/02/27","dbgap"
"8363","phs002245.v1.pht010530.v1.p1",338,246,584,"2020/10/16","dbgap"
"8366","phs001493.v2.pht007298.v1.p1",44,24,68,"2020/01/10","dbgap"
"8367","phs000886.v1.pht004647.v1.p1",30,44,74,"05/26/2016","dbgap"
"8368","phs001876.v1.pht009390.v1.p1",611,405,1016,"2019/08/10","dbgap"
"8369","phs001156.v2.pht007048.v1.p1",137,159,296,"2017/10/20","dbgap"
"8370","phs000794.v1.pht004310.v1.p1",7,5,12,"12/18/2014","dbgap"
"8371","phs001810.v1.pht009065.v1.p1",837,724,1561,"2019/07/01","dbgap"
"8372","phs000007.v32.pht000084.v8.p13",1636,1839,3475,"2020/12/21","dbgap"
"8374","phs001194.v3.pht005823.v2.p2",439,329,768,"2020/07/24","dbgap"
"8375","phs000128.v3.pht000511.v2.p3",2943,3500,6443,"04/29/2016","dbgap"
"8376","phs000280.v7.pht004117.v2.p1",4883,6019,10902,"2020/06/18","dbgap"
"8377","phs000576.v1.pht006145.v1.p1",116,128,244,"05/24/2017","dbgap"
"8378","phs001802.v1.pht008958.v1.p1",3,2,5,"2019/04/09","dbgap"
"8379","phs001733.v1.pht008619.v1.p1",7,10,17,"2019/01/07","dbgap"
"8380","phs000961.v1.pht005331.v1.p1",1144,1173,2317,"03/07/2016","dbgap"
"8381","phs001332.v2.pht007446.v2.p1",158,188,346,"2019/11/08","dbgap"
"8382","phs000616.v2.pht003370.v2.p2",467,468,935,"07/15/2015","dbgap"
"8383","phs001906.v1.pht009659.v1.p1",7,9,16,"2019/12/11","dbgap"
"8385","phs000007.v32.pht002142.v7.p13",2111,2427,4538,"2020/12/21","dbgap"
"8386","phs000093.v2.pht000118.v2.p2",974,655,1629,"10/09/2009","dbgap"
"8387","phs000007.v32.pht010733.v1.p13",2110,2443,4553,"2020/12/21","dbgap"
"8388","phs000484.v1.pht002681.v1.p1",5,2,7,"06/01/2012","dbgap"
"8389","phs000222.v6.pht007351.v1.p2",470,866,1336,"2019/08/01","dbgap"
"8390","phs001590.v2.pht007892.v2.p1",9873,12975,22848,"2021/04/08","dbgap"
"8392","phs001488.v1.pht007434.v1.p1",260,293,553,"2018/02/08","dbgap"
"8393","phs001387.v3.pht008971.v2.p1",1151,1178,2329,"2021/06/10","dbgap"
"8394","phs000581.v1.pht003207.v1.p1",22,29,51,"06/04/2013","dbgap"
"8395","phs000903.v1.pht004869.v1.p1",1395,1693,3088,"10/14/2015","dbgap"
"8396","phs000171.v1.pht000777.v1.p1",329,669,998,"12/11/2009","dbgap"
"8397","phs000007.v32.pht000017.v3.p13",1014,1497,2511,"2020/12/21","dbgap"
"8398","phs000681.v2.pht003873.v1.p1",859,1676,2535,"2019/05/03","dbgap"
"8399","phs000219.v1.pht001069.v1.p1",133,223,356,"01/19/2010","dbgap"
"8400","phs001288.v1.pht006777.v1.p1",4,2,6,"2017/10/19","dbgap"
"8401","phs000558.v1.pht006231.v1.p1",91,84,175,"03/31/2017","dbgap"
"8402","phs000280.v7.pht004082.v2.p1",5349,6516,11865,"2020/06/18","dbgap"
"8403","phs002486.v1.pht011471.v1.p1",10,10,20,"2021/08/13","dbgap"
"8404","phs000007.v32.pht000012.v3.p13",1502,1971,3473,"2020/12/21","dbgap"
"8405","phs000285.v3.pht001809.v2.p2",880,993,1873,"08/20/2013","dbgap"
"8406","phs000455.v1.pht002578.v1.p1",7,3,10,"06/20/2012","dbgap"
"8407","phs001398.v1.pht007142.v1.p1",1734,256,1990,"2018/08/06","dbgap"
"8408","phs000007.v32.pht000020.v3.p13",684,1039,1723,"2020/12/21","dbgap"
"8409","phs000007.v32.pht005152.v3.p13",1469,1552,3021,"2020/12/21","dbgap"
"8410","phs001329.v2.pht007173.v2.p1",1,4,5,"2019/05/07","dbgap"
"8411","phs001470.v1.pht008166.v1.p1",8,1470,1478,"2018/06/21","dbgap"
"8412","phs001194.v3.pht005828.v2.p2",3680,2876,6556,"2020/07/24","dbgap"
"8413","phs001488.v1.pht007403.v1.p1",257,286,543,"2018/02/08","dbgap"
"8414","phs001837.v1.pht009312.v1.p1",78,46,124,"2019/08/26","dbgap"
"8415","phs002224.v1.pht010848.v1.p1",31,85,116,"2021/05/18","dbgap"
"8416","phs002405.v1.pht011236.v1.p1",7,9,16,"2021/08/13","dbgap"
"8417","phs000007.v32.pht002889.v5.p13",1761,2006,3767,"2020/12/21","dbgap"
"8418","phs000007.v32.pht000298.v8.p13",1888,2154,4042,"2020/12/21","dbgap"
"8419","phs001662.v2.pht010067.v1.p1",843,758,1601,"2021/08/19","dbgap"
"8420","phs001833.v1.pht009152.v1.p1",134,165,299,"2019/06/14","dbgap"
"8422","phs001932.v1.pht009656.v1.p1",722,678,1400,"2019/12/16","dbgap"
"8424","phs001194.v3.pht005821.v2.p2",57,47,104,"2020/07/24","dbgap"
"8425","phs002240.v1.pht010861.v1.p1",30,66,96,"2021/01/15","dbgap"
"8426","phs001488.v1.pht007417.v1.p1",260,292,552,"2018/02/08","dbgap"
"8429","phs000819.v1.pht004379.v1.p1",6,14,20,"2018/01/18","dbgap"
"8430","phs001488.v1.pht007406.v1.p1",260,293,553,"2018/02/08","dbgap"
"8432","phs000563.v1.pht003082.v1.p1",1,3,4,"10/24/2013","dbgap"
"8433","phs000583.v1.pht003295.v1.p1",828,721,1549,"03/21/2014","dbgap"
"8436","phs002486.v1.pht011469.v1.p1",10,10,20,"2021/08/13","dbgap"
"8437","phs000086.v3.pht000260.v1.p1",129,144,273,"11/04/2014","dbgap"
"8438","phs001869.v1.pht009394.v1.p1",526,475,1001,"2019/08/18","dbgap"
"8439","phs000344.v1.pht002169.v1.p1",301,595,896,"06/27/2011","dbgap"
"8440","phs001246.v1.pht006084.v1.p1",12,14,26,"01/23/2017","dbgap"
"8441","phs002212.v1.pht010986.v1.p1",16,2,18,"2021/02/22","dbgap"
"8443","phs001318.v1.pht008024.v1.p1",26,13,39,"2018/05/31","dbgap"
"8445","phs000924.v4.pht006320.v3.p1",178,207,385,"2019/10/07","dbgap"
"8446","phs000594.v1.pht006491.v1.p1",5,3,8,"06/12/2017","dbgap"
"8448","phs000422.v1.pht003226.v1.p1",67,124,191,"05/14/2013","dbgap"
"8449","phs000280.v7.pht004070.v2.p1",5445,6661,12106,"2020/06/18","dbgap"
"8450","phs002289.v1.pht010894.v1.p1",9,4,13,"2021/01/28","dbgap"
"8451","phs000007.v32.pht000308.v9.p13",1792,1752,3544,"2020/12/21","dbgap"
"8453","phs001403.v1.pht006842.v1.p1",7,14,21,"2017/09/12","dbgap"
"8454","phs000280.v7.pht004039.v3.p1",5391,6575,11966,"2020/06/18","dbgap"
"8455","phs000280.v7.pht006482.v1.p1",2352,3141,5493,"2020/06/18","dbgap"
"8456","phs001834.v1.pht009422.v1.p1",12,18,30,"2020/01/10","dbgap"
"8457","phs001993.v1.pht010085.v1.p1",17,22,39,"2020/09/04","dbgap"
"8458","phs001342.v1.pht008052.v1.p1",30,16,46,"2018/06/01","dbgap"
"8459","phs001845.v1.pht009408.v1.p1",5,3,8,"2019/08/27","dbgap"
"8460","phs001089.v4.pht005485.v4.p1",726,670,1396,"2021/09/23","dbgap"
"8462","phs001151.v1.pht005539.v1.p1",2,3,5,"06/21/2016","dbgap"
"8464","phs001655.v1.pht008256.v1.p1",35,47,82,"2018/08/06","dbgap"
"8466","phs001316.v1.pht008009.v1.p1",2,1,3,"2018/05/31","dbgap"
"8467","phs000220.v2.pht002385.v2.p2",11920,13760,25680,"2018/06/11","dbgap"
"8468","phs001595.v1.pht007995.v1.p1",36,14,50,"2018/05/22","dbgap"
"8469","phs000906.v1.pht007150.v1.p1",4648,4362,9010,"2017/12/04","dbgap"
"8471","phs001329.v2.pht007174.v2.p1",1,4,5,"2019/05/07","dbgap"
"8473","phs000007.v32.pht000106.v8.p13",1145,1386,2531,"2020/12/21","dbgap"
"8474","phs000738.v1.pht003833.v1.p1",117,99,216,"05/07/2014","dbgap"
"8475","phs001238.v2.pht006045.v1.p1",432,1050,1482,"2018/06/14","dbgap"
"8478","phs000495.v1.pht002866.v1.p1",599,425,1024,"08/22/2012","dbgap"
"8480","phs000594.v1.pht006490.v1.p1",6,3,9,"06/12/2017","dbgap"
"8483","phs001793.v1.pht008902.v1.p1",21,12,33,"2020/08/04","dbgap"
"8484","phs001459.v1.pht007310.v1.p1",7,29,36,"2020/09/28","dbgap"
"8485","phs001794.v1.pht008905.v1.p1",6,6,12,"2019/03/28","dbgap"
"8486","phs001049.v1.pht005228.v1.p1",17,13,30,"2018/08/18","dbgap"
"8487","phs002392.v1.pht011256.v1.p1",18,23,41,"2021/07/13","dbgap"
"8488","phs000590.v1.pht008268.v1.p1",32,36,68,"2018/08/03","dbgap"
"8489","phs000666.v1.pht003574.v1.p1",10,17,27,"01/13/2014","dbgap"
"8490","phs002341.v1.pht011058.v1.p1",36,36,72,"2021/03/24","dbgap"
"8491","phs001732.v2.pht010139.v1.p1",43,46,89,"2021/08/26","dbgap"
"8492","phs002176.v2.pht010949.v2.p1",18,20,38,"2021/05/10","dbgap"
"8494","phs001719.v1.pht008920.v1.p1",49,53,102,"2019/05/07","dbgap"
"8496","phs000630.v1.pht003381.v1.p1",466,480,946,"04/29/2014","dbgap"
"8499","phs000409.v1.pht002735.v1.p1",64,29,93,"05/23/2012","dbgap"
"8500","phs000285.v3.pht001858.v2.p2",876,990,1866,"08/20/2013","dbgap"
"8503","phs000809.v1.pht004348.v1.p1",6,2,8,"11/07/2014","dbgap"
"8504","phs000592.v1.pht006580.v1.p1",156,131,287,"07/12/2017","dbgap"
"8505","phs000814.v1.pht004584.v1.p1",3187,405,3592,"01/07/2016","dbgap"
"8506","phs000007.v32.pht005165.v4.p13",1297,1522,2819,"2020/12/21","dbgap"
"8507","phs001480.v1.pht010831.v1.p1",80,194,274,"2021/01/13","dbgap"
"8508","phs001913.v1.pht009515.v1.p1",79,198,277,"2019/12/10","dbgap"
"8509","phs001358.v1.pht006337.v1.p1",1092,1230,2322,"05/02/2017","dbgap"
"8511","phs000304.v3.pht001905.v1.p1",945,1245,2190,"2018/05/03","dbgap"
"8512","phs000285.v3.pht001610.v2.p2",16,15,31,"08/20/2013","dbgap"
"8513","phs000086.v3.pht000736.v2.p1",740,661,1401,"11/04/2014","dbgap"
"8514","phs000280.v7.pht004119.v2.p1",4883,6019,10902,"2020/06/18","dbgap"
"8515","phs000491.v1.pht002697.v1.p1",2,1,3,"04/24/2012","dbgap"
"8516","phs001388.v2.pht006880.v1.p1",1230,2066,3296,"2021/03/05","dbgap"
"8517","phs000577.v1.pht007267.v1.p1",3,4,7,"2017/12/20","dbgap"
"8519","phs000001.v3.pht000373.v2.p1",2098,2659,4757,"02/24/2012","dbgap"
"8520","phs001438.v1.pht006820.v1.p1",1,2,3,"2017/12/19","dbgap"
"8521","phs000742.v1.pht008106.v1.p1",3862,4008,7870,"2018/07/23","dbgap"
"8522","phs000750.v1.pht003937.v1.p1",112,138,250,"09/03/2014","dbgap"
"8523","phs000286.v6.pht008748.v1.p2",426,834,1260,"2019/03/11","dbgap"
"8525","phs001252.v1.pht006395.v1.p1",1678,1052,2730,"05/16/2017","dbgap"
"8526","phs001319.v1.pht006211.v1.p1",4456,3110,7566,"03/29/2017","dbgap"
"8527","phs002368.v1.pht011044.v1.p1",1,1,2,"2021/03/11","dbgap"
"8528","phs000537.v1.pht003026.v1.p1",2,2,4,"10/24/2012","dbgap"
"8529","phs000649.v2.pht003758.v2.p2",517,523,1040,"2021/01/08","dbgap"
"8530","phs000888.v1.pht004679.v1.p1",12354,16239,28593,"08/12/2016","dbgap"
"8531","phs000128.v3.pht000590.v2.p3",2943,3500,6443,"04/29/2016","dbgap"
"8533","phs000007.v32.pht002234.v6.p13",560,493,1053,"2020/12/21","dbgap"
"8534","phs001073.v2.pht005952.v2.p1",18,47,65,"2020/12/18","dbgap"
"8535","phs000458.v1.pht003591.v1.p1",59,63,122,"11/26/2013","dbgap"
"8537","phs001011.v2.pht005532.v1.p1",935,633,1568,"2020/07/21","dbgap"
"8539","phs001889.v1.pht009741.v1.p1",10,7,17,"2019/12/26","dbgap"
"8540","phs002433.v1.pht011260.v1.p1",22,16,38,"2021/05/27","dbgap"
"8543","phs000284.v2.pht001903.v1.p1",292,369,661,"2018/09/26","dbgap"
"8545","phs000784.v3.pht004284.v1.p1",917,859,1776,"2019/11/15","dbgap"
"8546","phs000219.v1.pht001060.v1.p1",305,558,863,"01/19/2010","dbgap"
"8547","phs000280.v7.pht004201.v2.p1",6608,7982,14590,"2020/06/18","dbgap"
"8548","phs000955.v1.pht005450.v1.p1",1744,2385,4129,"06/09/2016","dbgap"
"8550","phs000347.v1.pht003125.v1.p1",19,10,29,"07/09/2013","dbgap"
"8552","phs001266.v2.pht007223.v1.p1",752,579,1331,"2020/03/09","dbgap"
"8553","phs001207.v3.pht005790.v3.p1",718,1201,1919,"2021/07/09","dbgap"
"8555","phs000408.v1.pht002440.v1.p1",174,788,962,"11/15/2011","dbgap"
"8556","phs000209.v13.pht001217.v5.p3",3060,3369,6429,"11/05/2014","dbgap"
"8558","phs001311.v1.pht007931.v1.p1",35,26,61,"2018/05/15","dbgap"
"8559","phs000575.v2.pht005884.v2.p1",136,156,292,"2020/02/14","dbgap"
"8560","phs000587.v1.pht003519.v1.p1",16,13,29,"04/25/2014","dbgap"
"8561","phs000584.v1.pht010795.v1.p1",1226,1409,2635,"2021/01/27","dbgap"
"8562","phs001260.v1.pht006054.v1.p1",24,19,43,"01/05/2017","dbgap"
"8563","phs000729.v1.pht003773.v1.p1",4,5,9,"04/08/2014","dbgap"
"8564","phs001545.v2.pht009965.v1.p1",315,152,467,"2021/07/13","dbgap"
"8565","phs000699.v1.pht004383.v1.p1",29,29,58,"12/12/2014","dbgap"
"8566","phs000832.v1.pht004425.v1.p1",199,182,381,"03/31/2015","dbgap"
"8567","phs001332.v2.pht007462.v2.p1",3,1,4,"2019/11/08","dbgap"
"8568","phs001359.v3.pht008690.v1.p1",505,558,1063,"2021/06/10","dbgap"
"8570","phs001551.v1.pht008348.v1.p1",49,52,101,"2018/09/07","dbgap"
"8572","phs000988.v5.pht005245.v5.p1",2293,2076,4369,"2021/09/28","dbgap"
"8573","phs001597.v1.pht008125.v1.p1",38,24,62,"2019/03/22","dbgap"
"8574","phs000894.v1.pht004661.v1.p1",320,235,555,"05/12/2015","dbgap"
"8575","phs001434.v2.pht009858.v1.p1",47,18,65,"2021/06/23","dbgap"
"8577","phs000367.v1.pht003260.v1.p1",722,788,1510,"12/03/2013","dbgap"
"8578","phs000167.v1.pht000719.v1.p1",1820,1209,3029,"04/22/2009","dbgap"
"8579","phs001623.v2.pht008362.v2.p1",30,11,41,"2019/10/31","dbgap"
"8580","phs000266.v4.pht002360.v3.p1",71,43,114,"09/09/2013","dbgap"
"8581","phs000963.v1.pht004858.v1.p1",3771,2119,5890,"05/11/2016","dbgap"
"8582","phs000712.v1.pht003713.v1.p1",303,220,523,"09/25/2015","dbgap"
"8583","phs001501.v1.pht007227.v1.p1",726,391,1117,"2020/08/24","dbgap"
"8584","phs001213.v2.pht005839.v1.p1",1121,590,1711,"2020/02/27","dbgap"
"8585","phs000048.v1.pht000071.v1.p1",485,401,886,"Tue Feb 26 18:05:10 2008","dbgap"
"8587","phs000196.v3.pht000875.v2.p1",2131,1880,4011,"03/24/2015","dbgap"
"8588","phs001193.v1.pht005975.v1.p1",901,696,1597,"12/06/2016","dbgap"
"8589","phs001198.v1.pht007866.v1.p1",49,44,93,"2018/05/21","dbgap"
"8590","phs000291.v2.pht002271.v1.p1",214,123,337,"05/11/2012","dbgap"
"8591","phs000351.v1.pht002204.v1.p1",3506,1229,4735,"05/13/2011","dbgap"
"8592","phs000285.v3.pht001590.v2.p2",947,1065,2012,"08/20/2013","dbgap"
"8595","phs000286.v6.pht008721.v1.p2",1239,2107,3346,"2019/03/11","dbgap"
"8596","phs000400.v1.pht002536.v1.p1",5,20,25,"02/21/2012","dbgap"
"8597","phs000617.v1.pht005475.v1.p1",162,128,290,"05/19/2016","dbgap"
"8598","phs001441.v1.pht007115.v1.p1",271,294,565,"2017/11/06","dbgap"
"8599","phs002428.v1.pht011266.v1.p1",72,137,209,"2021/06/02","dbgap"
"8600","phs000007.v32.pht000607.v5.p13",825,928,1753,"2020/12/21","dbgap"
"8602","phs000543.v1.pht002939.v1.p1",7,8,15,"10/31/2014","dbgap"
"8603","phs000576.v1.pht006147.v1.p1",75,81,156,"05/24/2017","dbgap"
"8604","phs001278.v1.pht006265.v1.p1",68,94,162,"06/16/2017","dbgap"
"8605","phs001595.v1.pht007993.v1.p1",36,14,50,"2018/05/22","dbgap"
"8606","phs000171.v1.pht000767.v1.p1",635,1284,1919,"12/11/2009","dbgap"
"8607","phs000587.v1.pht003517.v1.p1",16,13,29,"04/25/2014","dbgap"
"8608","phs001252.v1.pht006373.v1.p1",1683,1050,2733,"05/16/2017","dbgap"
"8610","phs001682.v2.pht009765.v1.p1",214,210,424,"2021/08/06","dbgap"
"8611","phs000479.v1.pht002665.v1.p1",2,1,3,"08/15/2012","dbgap"
"8612","phs002015.v1.pht010397.v1.p1",1816,2387,4203,"2020/09/18","dbgap"
"8614","phs002290.v1.pht010821.v1.p1",82,36,118,"2020/12/30","dbgap"
"8615","phs000794.v1.pht004308.v1.p1",7,5,12,"12/18/2014","dbgap"
"8616","phs000656.v1.pht003483.v1.p1",15,13,28,"08/26/2013","dbgap"
"8617","phs000888.v1.pht005587.v1.p1",9169,13130,22299,"08/12/2016","dbgap"
"8618","phs000170.v2.pht000738.v2.p1",5222,5834,11056,"02/27/2015","dbgap"
"8619","phs000007.v32.pht000293.v7.p13",1314,1657,2971,"2020/12/21","dbgap"
"8620","phs000266.v4.pht001265.v4.p1",71,43,114,"09/09/2013","dbgap"
"8621","phs001750.v1.pht008588.v1.p1",21,18,39,"2018/12/11","dbgap"
"8623","phs001311.v1.pht007930.v1.p1",32,25,57,"2018/05/15","dbgap"
"8624","phs001206.v1.pht007343.v1.p1",6,6,12,"2018/02/27","dbgap"
"8625","phs000285.v3.pht001607.v2.p2",48,83,131,"08/20/2013","dbgap"
"8626","phs000761.v1.pht004498.v1.p1",1428,2018,3446,"03/26/2015","dbgap"
"8627","phs000360.v3.pht003252.v2.p1",8474,10189,18663,"08/05/2016","dbgap"
"8628","phs000440.v1.pht002491.v1.p1",693,660,1353,"03/15/2012","dbgap"
"8629","phs000007.v32.pht009755.v1.p13",1172,1516,2688,"2020/12/21","dbgap"
"8630","phs001395.v2.pht006625.v1.p1",3380,4713,8093,"2021/06/09","dbgap"
"8632","phs001327.v2.pht011195.v1.p1",9914,8137,18051,"2021/05/07","dbgap"
"8633","phs001418.v1.pht007236.v1.p1",13,20,33,"2018/11/15","dbgap"
"8634","phs000286.v6.pht008765.v1.p2",938,1570,2508,"2019/03/11","dbgap"
"8635","phs000982.v1.pht004982.v1.p1",1358,1489,2847,"09/14/2015","dbgap"
"8636","phs000904.v1.pht004687.v1.p1",6,8,14,"2018/01/30","dbgap"
"8637","phs000284.v2.pht001900.v2.p1",1828,1679,3507,"2018/09/26","dbgap"
"8639","phs001490.v1.pht008135.v1.p1",1065,1522,2587,"2018/06/13","dbgap"
"8640","phs000007.v32.pht001892.v5.p13",244,267,511,"2020/12/21","dbgap"
"8642","phs000387.v1.pht002445.v1.p1",716,194,910,"12/19/2011","dbgap"
"8644","phs000285.v3.pht001811.v2.p2",880,993,1873,"08/20/2013","dbgap"
"8645","phs001787.v1.pht009044.v1.p1",23,28,51,"2020/06/18","dbgap"
"8646","phs000007.v32.pht000021.v3.p13",559,881,1440,"2020/12/21","dbgap"
"8648","phs001279.v1.pht007209.v1.p1",15,23,38,"2017/12/08","dbgap"
"8649","phs000007.v32.pht009757.v2.p13",3236,3809,7045,"2020/12/21","dbgap"
"8650","phs000496.v1.pht003166.v1.p1",1488,2492,3980,"03/28/2014","dbgap"
"8651","phs002020.v1.pht010227.v1.p1",544,458,1002,"2020/05/26","dbgap"
"8653","phs000285.v3.pht001686.v2.p2",50,50,100,"08/20/2013","dbgap"
"8654","phs001925.v1.pht010569.v1.p1",2,4,6,"2020/10/27","dbgap"
"8655","phs000166.v2.pht000702.v2.p1",522,312,834,"09/03/2009","dbgap"
"8657","phs001216.v1.pht005788.v1.p1",241,206,447,"09/29/2016","dbgap"
"8658","phs000102.v1.pht000283.v1.p1",119,100,219,"Mon Jun 16 14:32:00 2008","dbgap"
"8659","phs000185.v7.pht003281.v3.p1",8,8,16,"2020/04/29","dbgap"
"8661","phs000958.v1.pht004957.v1.p1",48,52,100,"08/31/2015","dbgap"
"8662","phs001651.v1.pht008233.v1.p1",36,15,51,"2018/07/18","dbgap"
"8664","phs001812.v1.pht009105.v1.p1",64,51,115,"2021/02/22","dbgap"
"8665","phs000007.v32.pht000041.v8.p13",2424,2578,5002,"2020/12/21","dbgap"
"8666","phs001505.v1.pht007320.v1.p1",268,140,408,"2018/09/06","dbgap"
"8667","phs001330.v2.pht007527.v2.p1",25,15,40,"2019/11/08","dbgap"
"8668","phs001257.v2.pht005997.v1.p1",10,6,16,"03/24/2017","dbgap"
"8669","phs001316.v1.pht008012.v1.p1",2,1,3,"2018/05/31","dbgap"
"8670","phs001807.v1.pht008979.v1.p1",8,3,11,"2019/06/11","dbgap"
"8671","phs001372.v1.pht006535.v1.p1",3,2,5,"2017/10/10","dbgap"
"8672","phs000885.v1.pht004605.v1.p1",42,8,50,"03/19/2015","dbgap"
"8673","phs001110.v3.pht006515.v2.p1",306,288,594,"2020/09/08","dbgap"
"8674","phs000343.v3.pht003153.v1.p1",1379,785,2164,"03/12/2013","dbgap"
"8676","phs000007.v32.pht010737.v1.p13",91,75,166,"2020/12/21","dbgap"
"8677","phs001281.v2.pht006131.v2.p1",15,25,40,"2019/02/21","dbgap"
"8678","phs001511.v1.pht007295.v1.p1",212,338,550,"2019/10/17","dbgap"
"8679","phs001493.v2.pht007297.v2.p1",44,24,68,"2020/01/10","dbgap"
"8681","phs001794.v1.pht008903.v1.p1",6,6,12,"2019/03/28","dbgap"
"8682","phs001488.v1.pht007428.v1.p1",260,293,553,"2018/02/08","dbgap"
"8684","phs000100.v3.pht001125.v1.p1",944,762,1706,"04/11/2011","dbgap"
"8685","phs000742.v1.pht008109.v1.p1",2559,2979,5538,"2018/07/23","dbgap"
"8686","phs001571.v1.pht009507.v1.p1",964,1270,2234,"2020/08/06","dbgap"
"8687","phs000775.v1.pht003943.v1.p1",497,362,859,"07/18/2014","dbgap"
"8688","phs000820.v1.pht004332.v1.p1",410,133,543,"11/13/2015","dbgap"
"8689","phs001848.v1.pht009207.v1.p1",1,2,3,"2019/06/24","dbgap"
"8690","phs000713.v1.pht004273.v1.p1",328,380,708,"10/16/2014","dbgap"
"8692","phs001419.v1.pht007089.v1.p1",1,2,3,"2017/12/04","dbgap"
"8696","phs000908.v1.pht004707.v1.p1",96,104,200,"01/19/2016","dbgap"
"8697","phs000949.v1.pht005222.v1.p1",1352,1875,3227,"02/08/2016","dbgap"
"8698","phs000511.v1.pht002816.v1.p1",37,11,48,"07/09/2012","dbgap"
"8699","phs000792.v1.pht004249.v1.p1",15,3,18,"09/18/2014","dbgap"
"8700","phs000285.v3.pht001760.v2.p2",867,972,1839,"08/20/2013","dbgap"
"8702","phs001194.v3.pht005827.v2.p2",3676,2871,6547,"2020/07/24","dbgap"
"8703","phs000333.v1.pht002311.v1.p1",1084,1635,2719,"10/06/2011","dbgap"
"8704","phs001504.v2.pht007911.v1.p1",489,487,976,"2021/03/05","dbgap"
"8706","phs002105.v1.pht010707.v1.p1",69,150,219,"2020/12/01","dbgap"
"8709","phs000017.v3.pht000383.v1.p1",277,409,686,"Wed Nov 26 07:49:58 2008","dbgap"
"8710","phs001430.v2.pht008066.v2.p1",13,9,22,"2020/02/06","dbgap"
"8711","phs000521.v2.pht007046.v2.p1",65,53,118,"2020/03/13","dbgap"
"8712","phs000999.v3.pht005183.v3.p1",130,112,242,"2019/11/22","dbgap"
"8713","phs001392.v1.pht006886.v1.p1",20,10,30,"2017/09/22","dbgap"
"8714","phs002319.v1.pht010923.v1.p1",716,813,1529,"2021/02/05","dbgap"
"8715","phs000007.v32.pht001225.v6.p13",1113,913,2026,"2020/12/21","dbgap"
"8716","phs001611.v1.pht009160.v1.p1",40,30,70,"2019/06/13","dbgap"
"8718","phs001602.v2.pht009976.v1.p1",5,2,7,"2021/07/16","dbgap"
"8719","phs001774.v1.pht008804.v1.p1",22,28,50,"2020/02/27","dbgap"
"8720","phs000634.v1.pht003829.v1.p1",801,1519,2320,"06/25/2015","dbgap"
"8721","phs000703.v1.pht003669.v1.p1",1880,1378,3258,"07/23/2014","dbgap"
"8722","phs001787.v1.pht009043.v1.p1",72,78,150,"2020/06/18","dbgap"
"8723","phs001514.v2.pht009816.v1.p1",211,234,445,"2021/06/28","dbgap"
"8724","phs000855.v1.pht004554.v1.p1",8,7,15,"03/10/2015","dbgap"
"8725","phs000372.v1.pht002857.v1.p1",2595,3470,6065,"02/13/2014","dbgap"
"8726","phs001788.v1.pht008818.v1.p1",3903,858,4761,"2019/03/05","dbgap"
"8727","phs001281.v2.pht006134.v2.p1",4,7,11,"2019/02/21","dbgap"
"8728","phs001539.v1.pht007522.v1.p1",44,57,101,"2018/02/27","dbgap"
"8729","phs000017.v3.pht000057.v1.p1",208,213,421,"Wed Nov 26 07:37:03 2008","dbgap"
"8731","phs001713.v1.pht008523.v1.p1",722,1352,2074,"2019/12/19","dbgap"
"8732","phs000128.v3.pht000497.v2.p3",2943,3500,6443,"04/29/2016","dbgap"
"8733","phs000209.v13.pht002705.v1.p3",933,896,1829,"11/05/2014","dbgap"
"8734","phs000521.v2.pht007033.v2.p1",70,57,127,"2020/03/13","dbgap"
"8735","phs000381.v1.pht002422.v1.p1",743,488,1231,"12/19/2011","dbgap"
"8736","phs001252.v1.pht006406.v1.p1",1367,792,2159,"05/16/2017","dbgap"
"8737","phs001247.v1.pht008301.v1.p1",451,448,899,"2018/08/13","dbgap"
"8738","phs001705.v1.pht009273.v1.p1",314,251,565,"2019/07/26","dbgap"
"8739","phs000698.v1.pht007679.v1.p1",17,31,48,"2018/03/23","dbgap"
"8740","phs001122.v1.pht008639.v1.p1",137,102,239,"2021/03/23","dbgap"
"8741","phs001313.v1.pht007973.v1.p1",1,4,5,"2018/05/17","dbgap"
"8742","phs000280.v7.pht004114.v2.p1",6120,7410,13530,"2020/06/18","dbgap"
"8744","phs000698.v1.pht007683.v1.p1",18,32,50,"2018/03/23","dbgap"
"8746","phs000280.v7.pht004121.v2.p1",6704,8003,14707,"2020/06/18","dbgap"
"8747","phs000291.v2.pht002270.v2.p1",214,123,337,"05/11/2012","dbgap"
"8749","phs001749.v2.pht009320.v2.p1",911,1204,2115,"2021/05/14","dbgap"
"8750","phs001576.v2.pht008224.v2.p2",8,4,12,"2019/09/27","dbgap"
"8751","phs000007.v32.pht000386.v4.p13",387,147,534,"2020/12/21","dbgap"
"8752","phs001406.v1.pht007742.v1.p1",1170,1785,2955,"2019/10/11","dbgap"
"8754","phs000575.v2.pht005895.v2.p1",175,212,387,"2020/02/14","dbgap"
"8755","phs001342.v1.pht008049.v1.p1",12,8,20,"2018/06/01","dbgap"
"8756","phs001252.v1.pht006376.v1.p1",560,386,946,"05/16/2017","dbgap"
"8757","phs000847.v2.pht004633.v2.p1",878,1007,1885,"12/02/2016","dbgap"
"8760","phs001954.v1.pht009799.v1.p1",36,53,89,"2020/01/10","dbgap"
"8761","phs001604.v2.pht009984.v1.p1",29,27,56,"2021/07/16","dbgap"
"8763","phs000237.v1.pht002160.v1.p1",26,85,111,"04/18/2011","dbgap"
"8764","phs000286.v6.pht008740.v1.p2",896,1482,2378,"2019/03/11","dbgap"
"8766","phs001488.v1.pht007432.v1.p1",260,293,553,"2018/02/08","dbgap"
"8767","phs001177.v2.pht005667.v2.p1",1475,1882,3357,"2019/11/27","dbgap"
"8769","phs000283.v1.pht001537.v1.p1",3022,3335,6357,"07/26/2010","dbgap"
"8770","phs001441.v1.pht007113.v1.p1",271,294,565,"2017/11/06","dbgap"
"8771","phs000763.v1.pht004253.v1.p1",1848,1709,3557,"01/16/2015","dbgap"
"8772","phs000219.v1.pht001062.v1.p1",664,1054,1718,"01/19/2010","dbgap"
"8774","phs000280.v7.pht006447.v1.p1",717,1008,1725,"2020/06/18","dbgap"
"8775","phs000286.v6.pht008757.v1.p2",1295,2163,3458,"2019/03/11","dbgap"
"8776","phs001036.v1.pht005270.v1.p1",21,13,34,"02/27/2017","dbgap"
"8777","phs002508.v1.pht011500.v1.p1",1,5,6,"2021/08/20","dbgap"
"8778","phs000128.v3.pht000581.v2.p3",2943,3500,6443,"04/29/2016","dbgap"
"8780","phs000007.v32.pht010735.v1.p13",1563,1823,3386,"2020/12/21","dbgap"
"8781","phs001826.v1.pht009140.v1.p1",2995,3119,6114,"2019/07/16","dbgap"
"8782","phs000128.v3.pht000409.v2.p3",2943,3500,6443,"04/29/2016","dbgap"
"8783","phs001455.v1.pht007758.v1.p1",1905,3890,5795,"2018/04/04","dbgap"
"8784","phs001206.v1.pht007345.v1.p1",6,6,12,"2018/02/27","dbgap"
"8786","phs000302.v1.pht002176.v1.p1",200,150,350,"08/18/2011","dbgap"
"8787","phs000343.v3.pht003151.v1.p1",1364,780,2144,"03/12/2013","dbgap"
"8788","phs001049.v1.pht005230.v1.p1",17,13,30,"2018/08/18","dbgap"
"8790","phs001406.v1.pht007753.v1.p1",6,7,13,"2019/10/11","dbgap"
"8791","phs001719.v1.pht008919.v1.p1",49,53,102,"2019/05/07","dbgap"
"8792","phs000789.v1.pht004292.v1.p1",998,1410,2408,"10/21/2015","dbgap"
"8793","phs001616.v2.pht008542.v2.p2",9771,11478,21249,"2020/10/27","dbgap"
"8795","phs001860.v1.pht009452.v1.p1",86,120,206,"2020/05/15","dbgap"
"8796","phs001300.v1.pht006720.v1.p1",276,156,432,"2018/01/18","dbgap"
"8797","phs000594.v1.pht006493.v1.p1",3,2,5,"06/12/2017","dbgap"
"8798","phs001578.v1.pht007874.v1.p1",40,42,82,"2018/11/30","dbgap"
"8799","phs000007.v32.pht000670.v7.p13",1036,1244,2280,"2020/12/21","dbgap"
"8800","phs000410.v1.pht002450.v1.p1",30,134,164,"03/11/2014","dbgap"
"8801","phs001493.v2.pht007299.v2.p1",44,24,68,"2020/01/10","dbgap"
"8802","phs001641.v1.pht010038.v1.p1",337,821,1158,"2020/03/24","dbgap"
"8803","phs001349.v2.pht010330.v1.p1",10093,515,10608,"2021/04/07","dbgap"
"8806","phs000285.v3.pht001575.v2.p2",947,1065,2012,"08/20/2013","dbgap"
"8807","phs001561.v1.pht010996.v1.p1",70,65,135,"2021/03/31","dbgap"
"8808","phs000955.v1.pht005451.v1.p1",1744,2385,4129,"06/09/2016","dbgap"
"8809","phs002304.v1.pht010850.v1.p1",377,244,621,"2021/04/07","dbgap"
"8810","phs000182.v2.pht000795.v1.p1",1341,1999,3340,"08/06/2010","dbgap"
"8812","phs001786.v1.pht008839.v1.p1",17,19,36,"2019/08/01","dbgap"
"8813","phs001376.v1.pht006553.v1.p1",4,5,9,"06/15/2017","dbgap"
"8814","phs000904.v1.pht004688.v1.p1",4,4,8,"2018/01/30","dbgap"
"8815","phs001143.v4.pht005903.v1.p1",989,866,1855,"2021/06/01","dbgap"
"8817","phs001313.v1.pht007968.v1.p1",1,4,5,"2018/05/17","dbgap"
"8818","phs000390.v1.pht002328.v1.p1",408,1209,1617,"04/20/2012","dbgap"
"8819","phs000247.v5.pht001288.v5.p3",85,86,171,"07/27/2017","dbgap"
"8821","phs000687.v1.pht003694.v1.p1",905,921,1826,"06/13/2014","dbgap"
"8822","phs002368.v1.pht011043.v1.p1",1,1,2,"2021/03/11","dbgap"
"8823","phs001602.v2.pht009979.v1.p1",5,2,7,"2021/07/16","dbgap"
"8824","phs001232.v4.pht006075.v4.p2",2430,2384,4814,"2021/08/23","dbgap"
"8825","phs000521.v2.pht007039.v2.p1",70,57,127,"2020/03/13","dbgap"
"8826","phs001423.v3.pht008551.v1.p2",640,437,1077,"2021/05/13","dbgap"
"8828","phs000086.v3.pht000216.v1.p1",761,680,1441,"11/04/2014","dbgap"
"8829","phs000768.v2.pht004478.v2.p1",31,22,53,"12/20/2016","dbgap"
"8830","phs001419.v1.pht007097.v1.p1",488,498,986,"2017/12/04","dbgap"
"8831","phs000209.v13.pht003090.v1.p3",364,394,758,"11/05/2014","dbgap"
"8832","phs000285.v3.pht001721.v2.p2",587,642,1229,"08/20/2013","dbgap"
"8833","phs000961.v1.pht005333.v1.p1",1144,1173,2317,"03/07/2016","dbgap"
"8834","phs002050.v1.pht010357.v1.p1",1113,1415,2528,"2020/11/19","dbgap"
"8835","phs000351.v1.pht002205.v1.p1",3506,1229,4735,"05/13/2011","dbgap"
"8837","phs000007.v32.pht000910.v8.p13",1132,1357,2489,"2020/12/21","dbgap"
"8838","phs000091.v2.pht000799.v2.p1",15,30,45,"08/24/2009","dbgap"
"8840","phs000578.v1.pht007006.v1.p1",49,44,93,"2017/10/11","dbgap"
"8841","phs000288.v2.pht002516.v2.p2",1381,1188,2569,"2017/11/06","dbgap"
"8842","phs001238.v2.pht006036.v1.p1",201,551,752,"2018/06/14","dbgap"
"8843","phs001963.v1.pht009828.v1.p1",3885,2953,6838,"2020/11/24","dbgap"
"8844","phs000168.v2.pht000709.v2.p2",4181,5200,9381,"08/27/2012","dbgap"
"8847","phs000827.v3.pht004470.v3.p1",241,351,592,"11/14/2016","dbgap"
"8849","phs001522.v1.pht007729.v1.p1",1915,1898,3813,"2018/04/05","dbgap"
"8850","phs002046.v1.pht010627.v1.p1",69,129,198,"2020/11/02","dbgap"
"8851","phs001906.v1.pht009660.v1.p1",7,9,16,"2019/12/11","dbgap"
"8852","phs000007.v32.pht004374.v6.p13",3249,4083,7332,"2020/12/21","dbgap"
"8853","phs000343.v3.pht002216.v1.p1",1379,785,2164,"03/12/2013","dbgap"
"8855","phs001426.v1.pht006916.v1.p1",43,39,82,"2017/09/19","dbgap"
"8856","phs000086.v3.pht000350.v1.p1",13,23,36,"11/04/2014","dbgap"
"8857","phs000701.v1.pht005524.v1.p1",47,43,90,"06/01/2017","dbgap"
"8859","phs000796.v1.pht005384.v1.p1",1111,2024,3135,"05/17/2016","dbgap"
"8860","phs002030.v1.pht010262.v1.p1",407,231,638,"2020/06/02","dbgap"
"8861","phs000286.v6.pht001970.v2.p2",1033,1812,2845,"2019/03/11","dbgap"
"8862","phs000007.v32.pht000098.v8.p13",1720,1925,3645,"2020/12/21","dbgap"
"8863","phs001518.v1.pht007332.v1.p1",1764,815,2579,"2020/01/07","dbgap"
"8864","phs000343.v3.pht002721.v1.p1",1228,712,1940,"03/12/2013","dbgap"
"8865","phs001882.v1.pht010490.v1.p1",68,49999,50067,"2021/07/20","dbgap"
"8866","phs000007.v32.pht000602.v3.p13",425,648,1073,"2020/12/21","dbgap"
"8868","phs001097.v1.pht005615.v1.p1",1072,1154,2226,"08/09/2016","dbgap"
"8869","phs001333.v2.pht006524.v2.p1",9,11,20,"2019/08/29","dbgap"
"8870","phs001311.v1.pht007936.v1.p1",8,14,22,"2018/05/15","dbgap"
"8871","phs000007.v32.pht002895.v2.p13",184,252,436,"2020/12/21","dbgap"
"8872","phs000007.v32.pht002146.v7.p13",2111,2426,4537,"2020/12/21","dbgap"
"8873","phs001959.v1.pht009791.v1.p1",2,3,5,"2020/03/05","dbgap"
"8875","phs001543.v2.pht009914.v1.p1",265,84,349,"2021/07/08","dbgap"
"8876","phs001779.v1.pht010204.v1.p1",47,127,174,"2020/06/25","dbgap"
"8877","phs000894.v1.pht004659.v1.p1",320,235,555,"05/12/2015","dbgap"
"8879","phs001107.v1.pht005490.v1.p1",3,3,6,"05/26/2016","dbgap"
"8882","phs000185.v7.pht003282.v3.p1",8,8,16,"2020/04/29","dbgap"
"8883","phs001473.v1.pht009687.v1.p1",38,23,61,"2020/12/15","dbgap"
"8884","phs001782.v2.pht008798.v2.p1",327,465,792,"2021/07/02","dbgap"
"8885","phs001684.v1.pht008390.v1.p1",16,18,34,"2018/09/19","dbgap"
"8886","phs000698.v1.pht007675.v1.p1",17,29,46,"2018/03/23","dbgap"
"8887","phs001458.v1.pht007778.v1.p1",5868,5910,11778,"2018/04/12","dbgap"
"8888","phs000209.v13.pht003086.v3.p3",91,107,198,"11/05/2014","dbgap"
"8889","phs001489.v2.pht008582.v2.p2",6057,6807,12864,"2021/03/18","dbgap"
"8891","phs002334.v1.pht010959.v1.p1",11,18,29,"2021/02/12","dbgap"
"8892","phs001007.v1.pht005066.v1.p1",19,4,23,"11/30/2015","dbgap"
"8893","phs000286.v6.pht001941.v2.p2",281,555,836,"2019/03/11","dbgap"
"8894","phs001107.v1.pht005488.v1.p1",3,3,6,"05/26/2016","dbgap"
"8895","phs000086.v3.pht000284.v1.p1",706,643,1349,"11/04/2014","dbgap"
"8897","phs001392.v1.pht006896.v1.p1",17,10,27,"2017/09/22","dbgap"
"8898","phs001862.v1.pht009748.v1.p1",278,380,658,"2019/12/26","dbgap"
"8899","phs001233.v1.pht005943.v1.p1",3,3,6,"11/21/2016","dbgap"
"8900","phs001095.v1.pht005620.v1.p1",421,437,858,"09/28/2016","dbgap"
"8901","phs001124.v1.pht009256.v1.p1",47,228,275,"2019/07/22","dbgap"
"8902","phs000360.v3.pht003251.v2.p1",8474,10189,18663,"08/05/2016","dbgap"
"8903","phs000285.v3.pht001720.v2.p2",888,957,1845,"08/20/2013","dbgap"
"8904","phs000286.v6.pht008769.v1.p2",940,1572,2512,"2019/03/11","dbgap"
"8905","phs002071.v1.pht010455.v1.p1",14,10,24,"2020/12/10","dbgap"
"8906","phs000007.v32.pht000149.v7.p13",2103,2646,4749,"2020/12/21","dbgap"
"8907","phs000088.v1.pht000072.v1.p1",587,619,1206,"01/06/2010","dbgap"
"8908","phs000086.v3.pht000356.v1.p1",183,185,368,"11/04/2014","dbgap"
"8909","phs001884.v1.pht009640.v1.p1",81,273,354,"2019/11/27","dbgap"
"8910","phs002252.v1.pht010670.v1.p1",9,4,13,"2021/01/06","dbgap"
"8911","phs001805.v1.pht008954.v1.p1",2,2,4,"2019/04/09","dbgap"
"8916","phs000509.v1.pht004313.v1.p1",55,23,78,"02/18/2015","dbgap"
"8918","phs001366.v1.pht006577.v1.p1",3,9,12,"2017/12/04","dbgap"
"8919","phs002235.v1.pht011081.v1.p1",19,18,37,"2021/03/25","dbgap"
"8920","phs000280.v7.pht006489.v2.p1",665,879,1544,"2020/06/18","dbgap"
"8923","phs001823.v1.pht009058.v1.p1",169,92,261,"2019/08/07","dbgap"
"8924","phs002015.v1.pht010368.v1.p1",250,310,560,"2020/09/18","dbgap"
"8926","phs001442.v3.pht010302.v1.p2",237,209,446,"2021/08/13","dbgap"
"8927","phs000285.v3.pht001568.v2.p2",947,1065,2012,"08/20/2013","dbgap"
"8928","phs000874.v1.pht004657.v1.p1",498,452,950,"04/13/2015","dbgap"
"8929","phs001072.v1.pht005355.v1.p1",42,15,57,"03/31/2016","dbgap"
"8930","phs000607.v3.pht003446.v2.p2",764,837,1601,"2018/05/01","dbgap"
"8932","phs000007.v32.pht000824.v7.p13",2050,2552,4602,"2020/12/21","dbgap"
"8933","phs000804.v1.pht005374.v1.p1",53,49,102,"09/06/2016","dbgap"
"8934","phs000007.v32.pht005159.v4.p13",1792,1677,3469,"2020/12/21","dbgap"
"8935","phs001662.v2.pht010068.v1.p1",843,758,1601,"2021/08/19","dbgap"
"8937","phs002063.v1.pht010407.v1.p1",21,13,34,"2020/07/24","dbgap"
"8938","phs000831.v1.pht004905.v1.p1",84,73,157,"08/13/2015","dbgap"
"8939","phs000285.v3.pht001741.v2.p2",75,93,168,"08/20/2013","dbgap"
"8940","phs001853.v1.pht009812.v1.p1",11,4,15,"2020/02/19","dbgap"
"8941","phs000269.v1.pht001497.v1.p1",371,323,694,"08/05/2010","dbgap"
"8942","phs000888.v1.pht005557.v1.p1",556,694,1250,"08/12/2016","dbgap"
"8943","phs000007.v32.pht010736.v1.p13",91,75,166,"2020/12/21","dbgap"
"8944","phs000809.v1.pht004347.v1.p1",6,2,8,"11/07/2014","dbgap"
"8946","phs000209.v13.pht003378.v1.p3",940,907,1847,"11/05/2014","dbgap"
"8947","phs000280.v7.pht006474.v1.p1",1050,1267,2317,"2020/06/18","dbgap"
"8948","phs000285.v3.pht001769.v1.p2",1,4,5,"08/20/2013","dbgap"
"8949","phs001437.v1.pht006809.v1.p1",157,83,240,"2019/09/11","dbgap"
"8951","phs001853.v1.pht009811.v1.p1",11,4,15,"2020/02/19","dbgap"
"8952","phs001488.v1.pht007418.v1.p1",260,293,553,"2018/02/08","dbgap"
"8954","phs001326.v1.pht007823.v1.p1",21,2,23,"2018/04/16","dbgap"
"8955","phs002493.v1.pht011462.v1.p1",57,32,89,"2021/09/21","dbgap"
"8956","phs000286.v6.pht008723.v1.p2",1081,1910,2991,"2019/03/11","dbgap"
"8958","phs000007.v32.pht000011.v3.p13",1609,2103,3712,"2020/12/21","dbgap"
"8961","phs001208.v2.pht008658.v1.p1",2523,2892,5415,"2019/08/10","dbgap"
"8962","phs000820.v1.pht004333.v1.p1",410,133,543,"11/13/2015","dbgap"
"8963","phs001828.v1.pht009368.v1.p1",799,593,1392,"2019/08/01","dbgap"
"8964","phs000494.v1.pht002800.v1.p1",2543,2019,4562,"07/19/2012","dbgap"
"8965","phs001814.v1.pht009008.v1.p1",149,130,279,"2019/06/03","dbgap"
"8967","phs000357.v2.pht002330.v2.p1",85,748,833,"2018/09/19","dbgap"
"8968","phs000547.v1.pht003004.v1.p1",20,18,38,"10/18/2012","dbgap"
"8969","phs001955.v1.pht009793.v1.p1",6342,6346,12688,"2020/07/06","dbgap"
"8970","phs000128.v3.pht000463.v2.p3",2943,3500,6443,"04/29/2016","dbgap"
"8971","phs000542.v1.pht003016.v1.p1",2,2,4,"10/24/2012","dbgap"
"8972","phs002433.v1.pht011257.v1.p1",22,16,38,"2021/05/27","dbgap"
"8973","phs000086.v3.pht000255.v1.p1",761,680,1441,"11/04/2014","dbgap"
"8976","phs000280.v7.pht006450.v1.p1",720,1009,1729,"2020/06/18","dbgap"
"8977","phs001543.v2.pht009913.v1.p1",265,84,349,"2021/07/08","dbgap"
"8978","phs001872.v1.pht009363.v1.p1",292,311,603,"2019/07/31","dbgap"
"8979","phs001419.v1.pht007090.v1.p1",487,497,984,"2017/12/04","dbgap"
"8980","phs000422.v1.pht003225.v1.p1",67,124,191,"05/14/2013","dbgap"
"8982","phs000671.v1.pht003547.v1.p1",9,1,10,"10/25/2013","dbgap"
"8984","phs001304.v1.pht008313.v1.p1",60,81,141,"2018/10/05","dbgap"
"8985","phs000734.v1.pht003772.v1.p1",409,285,694,"04/04/2014","dbgap"
"8986","phs000169.v1.pht000731.v1.p1",1367,1435,2802,"12/03/2009","dbgap"
"8987","phs000387.v1.pht002443.v1.p1",716,194,910,"12/19/2011","dbgap"
"8990","phs000739.v1.pht003825.v1.p1",5,2,7,"05/02/2014","dbgap"
"8991","phs001001.v1.pht005653.v1.p1",811,214,1025,"2018/02/28","dbgap"
"8992","phs001899.v2.pht009570.v2.p1",883,997,1880,"2020/11/02","dbgap"
"8993","phs000495.v1.pht002867.v1.p1",599,425,1024,"08/22/2012","dbgap"
"8994","phs000287.v7.pht001467.v1.p1",2105,2647,4752,"2020/01/23","dbgap"
"8995","phs001123.v2.pht006061.v2.p1",3904,6281,10185,"2019/09/16","dbgap"
"8996","phs000497.v3.pht002711.v3.p2",252,164,416,"10/07/2016","dbgap"
"8997","phs001318.v1.pht008032.v1.p1",27,13,40,"2018/05/31","dbgap"
"8998","phs001055.v1.pht005915.v1.p1",413,404,817,"2017/08/16","dbgap"
"8999","phs000007.v32.pht002571.v2.p13",242,201,443,"2020/12/21","dbgap"
"9000","phs001845.v1.pht009409.v1.p1",5,3,8,"2019/08/27","dbgap"
"9001","phs002335.v1.pht010940.v1.p1",6,6,12,"2021/02/08","dbgap"
"9002","phs001700.v1.pht008502.v1.p1",39,85,124,"2020/11/24","dbgap"
"9003","phs000226.v2.pht002289.v1.p1",1565,2424,3989,"07/18/2011","dbgap"
"9006","phs001936.v1.pht009648.v1.p1",2,7,9,"2020/01/21","dbgap"
"9008","phs000182.v2.pht000797.v1.p1",1375,2028,3403,"08/06/2010","dbgap"
"9009","phs001238.v2.pht006035.v1.p1",201,551,752,"2018/06/14","dbgap"
"9010","phs001065.v1.pht005422.v1.p1",293,308,601,"05/24/2016","dbgap"
"9011","phs001392.v1.pht006889.v1.p1",10,6,16,"2017/09/22","dbgap"
"9012","phs001910.v1.pht009535.v1.p1",22,24,46,"2019/10/15","dbgap"
"9013","phs000007.v32.pht001893.v8.p13",1748,1601,3349,"2020/12/21","dbgap"
"9015","phs000852.v1.pht006696.v1.p1",419,365,784,"07/26/2017","dbgap"
"9016","phs000007.v32.pht000210.v8.p13",2112,2444,4556,"2020/12/21","dbgap"
"9017","phs002499.v1.pht011449.v1.p1",6,3,9,"2021/08/05","dbgap"
"9018","phs000910.v1.pht004726.v1.p1",4063,3942,8005,"08/20/2015","dbgap"
"9019","phs001331.v2.pht006924.v2.p1",543,362,905,"2019/08/30","dbgap"
"9020","phs001955.v1.pht009795.v1.p1",6342,6346,12688,"2020/07/06","dbgap"
"9021","phs000494.v1.pht002798.v1.p1",2543,2019,4562,"07/19/2012","dbgap"
"9022","phs001585.v1.pht008828.v1.p1",257,181,438,"2019/03/18","dbgap"
"9023","phs002176.v2.pht010948.v1.p1",18,20,38,"2021/05/10","dbgap"
"9024","phs001071.v1.pht005344.v1.p1",26,22,48,"2017/09/27","dbgap"
"9025","phs000782.v1.pht003990.v1.p1",15,1,16,"2017/10/04","dbgap"
"9026","phs001347.v2.pht006796.v2.p1",147,120,267,"2017/12/29","dbgap"
"9027","phs001686.v1.pht008564.v1.p1",3,3,6,"2018/11/26","dbgap"
"9029","phs001546.v2.pht009975.v1.p1",5,1,6,"2021/07/14","dbgap"
"9030","phs000837.v1.pht004438.v1.p1",3,3,6,"01/26/2015","dbgap"
"9031","phs001065.v1.pht005402.v1.p1",290,308,598,"05/24/2016","dbgap"
"9032","phs000293.v1.pht003367.v1.p1",755,1318,2073,"07/25/2013","dbgap"
"9033","phs001702.v1.pht008427.v1.p1",13,147,160,"2018/10/02","dbgap"
"9036","phs001180.v2.pht006991.v1.p1",2194,2264,4458,"2020/06/29","dbgap"
"9037","phs000378.v1.pht002319.v1.p1",438,813,1251,"04/23/2014","dbgap"
"9038","phs001423.v3.pht006984.v3.p2",973,678,1651,"2021/05/13","dbgap"
"9039","phs000007.v32.pht005160.v3.p13",1442,1537,2979,"2020/12/21","dbgap"
"9040","phs001078.v1.pht005725.v1.p1",8174,9550,17724,"2018/09/14","dbgap"
"9041","phs001889.v1.pht009737.v1.p1",10,7,17,"2019/12/26","dbgap"
"9042","phs001252.v1.pht006369.v1.p1",1683,1050,2733,"05/16/2017","dbgap"
"9044","phs000864.v1.pht004493.v1.p1",3976,16,3992,"05/08/2015","dbgap"
"9046","phs000979.v3.pht005193.v2.p2",607,363,970,"2019/09/16","dbgap"
"9047","phs000286.v6.pht001960.v2.p2",673,967,1640,"2019/03/11","dbgap"
"9048","phs001488.v1.pht007426.v1.p1",260,293,553,"2018/02/08","dbgap"
"9049","phs000205.v6.pht003014.v2.p2",21065,14622,35687,"06/13/2016","dbgap"
"9050","phs001095.v1.pht005618.v1.p1",421,437,858,"07/01/2016","dbgap"
"9052","phs000286.v6.pht008789.v1.p2",893,1477,2370,"2019/03/11","dbgap"
"9053","phs001327.v2.pht011182.v1.p1",13724,11941,25665,"2021/05/07","dbgap"
"9054","phs000380.v1.pht002457.v1.p1",199,783,982,"01/13/2012","dbgap"
"9055","phs000888.v1.pht005589.v1.p1",7247,11680,18927,"08/12/2016","dbgap"
"9057","phs000521.v2.pht007036.v2.p1",40,32,72,"2020/03/13","dbgap"
"9059","phs000280.v7.pht004043.v2.p1",2878,3381,6259,"2020/06/18","dbgap"
"9060","phs001357.v1.pht006697.v1.p1",41,33,74,"07/26/2017","dbgap"
"9061","phs000339.v2.pht002136.v1.p1",11,16,27,"02/22/2013","dbgap"
"9063","phs001169.v2.pht006185.v2.p1",104,28,132,"2020/06/10","dbgap"
"9064","phs001180.v2.pht006990.v2.p1",2179,2248,4427,"2020/06/29","dbgap"
"9066","phs000848.v1.pht004410.v1.p1",1,2,3,"12/10/2014","dbgap"
"9068","phs001380.v1.pht009228.v1.p1",2337,959,3296,"2019/10/11","dbgap"
"9069","phs000994.v1.pht005063.v1.p1",12,7,19,"11/02/2015","dbgap"
"9071","phs001556.v1.pht007846.v1.p1",67,33,100,"2018/04/20","dbgap"
"9073","phs000759.v1.pht003912.v1.p1",8,10,18,"06/20/2014","dbgap"
"9076","phs000017.v3.pht000369.v1.p1",131,284,415,"Wed Nov 26 07:49:55 2008","dbgap"
"9077","phs001717.v1.pht008580.v1.p1",152,150,302,"2019/03/11","dbgap"
"9078","phs000171.v1.pht000776.v1.p1",329,669,998,"12/11/2009","dbgap"
"9079","phs000358.v1.pht002241.v1.p1",763,620,1383,"05/23/2011","dbgap"
"9080","phs001430.v2.pht008086.v2.p1",11,9,20,"2020/02/06","dbgap"
"9081","phs001444.v2.pht006961.v1.p1",190,138,328,"2019/11/04","dbgap"
"9082","phs001158.v2.pht005593.v2.p1",11,10,21,"2019/02/05","dbgap"
"9083","phs001660.v1.pht008413.v1.p1",59,44,103,"2018/10/05","dbgap"
"9084","phs001154.v1.pht008376.v1.p1",7278,3340,10618,"2018/09/17","dbgap"
"9085","phs001217.v3.pht007765.v1.p1",981,882,1863,"2021/06/08","dbgap"
"9088","phs002046.v1.pht010625.v1.p1",1332,4028,5360,"2020/11/02","dbgap"
"9090","phs002244.v1.pht010550.v1.p1",23,10,33,"2020/10/02","dbgap"
"9091","phs001662.v2.pht010055.v1.p1",843,758,1601,"2021/08/19","dbgap"
"9092","phs000086.v3.pht000628.v1.p1",71,67,138,"11/04/2014","dbgap"
"9093","phs002408.v1.pht011160.v1.p1",4,3,7,"2021/04/28","dbgap"
"9094","phs001045.v1.pht009261.v1.p1",169,154,323,"2019/07/25","dbgap"
"9095","phs000598.v2.pht003324.v2.p2",42,9,51,"10/28/2013","dbgap"
"9096","phs000884.v1.pht004602.v1.p1",146,94,240,"03/17/2015","dbgap"
"9097","phs001935.v1.pht009767.v1.p1",6,6,12,"2020/02/06","dbgap"
"9098","phs000473.v2.pht002601.v2.p2",6600,5780,12380,"08/15/2016","dbgap"
"9099","phs001588.v1.pht007962.v1.p1",34212,45997,80209,"2018/07/18","dbgap"
"9100","phs001932.v1.pht009657.v1.p1",722,678,1400,"2019/12/16","dbgap"
"9102","phs001931.v1.pht009678.v1.p1",10,26,36,"2020/02/03","dbgap"
"9103","phs000007.v32.pht003309.v5.p13",1914,2417,4331,"2020/12/21","dbgap"
"9105","phs001954.v1.pht009796.v1.p1",36,53,89,"2020/01/10","dbgap"
"9106","phs000287.v7.pht001487.v1.p1",2375,3156,5531,"2020/01/23","dbgap"
"9107","phs000007.v32.pht000748.v7.p13",1433,1752,3185,"2020/12/21","dbgap"
"9111","phs001855.v1.pht009250.v1.p1",277,323,600,"2019/07/29","dbgap"
"9112","phs000007.v32.pht000040.v5.p13",2294,2785,5079,"2020/12/21","dbgap"
"9113","phs001932.v1.pht009654.v1.p1",722,678,1400,"2019/12/16","dbgap"
"9114","phs000007.v32.pht000201.v2.p13",561,772,1333,"2020/12/21","dbgap"
"9116","phs000331.v1.pht002092.v1.p1",424,405,829,"03/27/2012","dbgap"
"9117","phs000280.v7.pht006424.v1.p1",1124,1409,2533,"2020/06/18","dbgap"
"9118","phs000272.v1.pht001912.v1.p1",1413,1080,2493,"09/20/2010","dbgap"
"9119","phs000280.v7.pht006437.v1.p1",2287,2983,5270,"2020/06/18","dbgap"
"9120","phs000285.v3.pht001699.v2.p2",947,1065,2012,"08/20/2013","dbgap"
"9121","phs000209.v13.pht001208.v2.p3",3018,2831,5849,"11/05/2014","dbgap"
"9122","phs000674.v1.pht003642.v1.p1",32008,46478,78486,"01/27/2014","dbgap"
"9125","phs002068.v1.pht010874.v1.p1",807,637,1444,"2021/01/26","dbgap"
"9126","phs000568.v1.pht003113.v1.p1",8,9,17,"01/02/2013","dbgap"
"9127","phs001795.v1.pht008950.v1.p1",46,49,95,"2019/06/24","dbgap"
"9128","phs000801.v2.pht004613.v2.p1",5068,5423,10491,"09/20/2016","dbgap"
"9129","phs000007.v32.pht002852.v5.p13",2061,2363,4424,"2020/12/21","dbgap"
"9130","phs000402.v1.pht002539.v1.p1",125,78,203,"02/29/2012","dbgap"
"9131","phs000327.v1.pht003010.v1.p1",107,85,192,"03/22/2013","dbgap"
"9132","phs000287.v7.pht001463.v1.p1",2316,3087,5403,"2020/01/23","dbgap"
"9133","phs001300.v1.pht006721.v1.p1",276,156,432,"2018/01/18","dbgap"
"9136","phs000128.v3.pht000425.v2.p3",2943,3500,6443,"04/29/2016","dbgap"
"9137","phs000378.v1.pht002320.v1.p1",438,813,1251,"04/23/2014","dbgap"
"9138","phs001584.v2.pht009073.v2.p2",47973,56726,104699,"2020/11/13","dbgap"
"9139","phs001288.v1.pht006779.v1.p1",61,39,100,"2017/10/19","dbgap"
"9140","phs000007.v32.pht000093.v8.p13",1520,1750,3270,"2020/12/21","dbgap"
"9141","phs000888.v1.pht005571.v1.p1",3300,3006,6306,"08/12/2016","dbgap"
"9142","phs000007.v32.pht007776.v1.p13",659,730,1389,"2020/12/21","dbgap"
"9143","phs000128.v3.pht000363.v1.p3",1258,1502,2760,"04/29/2016","dbgap"
"9146","phs000007.v32.pht007770.v3.p13",1647,1943,3590,"2020/12/21","dbgap"
"9147","phs000280.v7.pht006419.v1.p1",2377,3195,5572,"2020/06/18","dbgap"
"9148","phs000248.v1.pht001200.v1.p1",2070,1379,3449,"02/10/2014","dbgap"
"9150","phs001792.v1.pht008933.v1.p1",92,372,464,"2019/04/15","dbgap"
"9151","phs001438.v1.pht006821.v1.p1",1,2,3,"2017/12/19","dbgap"
"9152","phs000128.v3.pht000492.v2.p3",2943,3500,6443,"04/29/2016","dbgap"
"9153","phs000086.v3.pht000241.v1.p1",759,680,1439,"11/04/2014","dbgap"
"9154","phs000589.v1.pht009172.v1.p1",7,104,111,"2019/06/14","dbgap"
"9155","phs000589.v1.pht009202.v1.p1",9,127,136,"2019/06/14","dbgap"
"9158","phs000285.v3.pht001766.v2.p2",52,35,87,"08/20/2013","dbgap"
"9159","phs000128.v3.pht000413.v2.p3",2943,3500,6443,"04/29/2016","dbgap"
"9160","phs001845.v1.pht009407.v1.p1",5,3,8,"2019/08/27","dbgap"
"9161","phs000415.v1.pht002414.v1.p1",137,119,256,"08/13/2015","dbgap"
"9162","phs000007.v32.pht002145.v6.p13",2071,2390,4461,"2020/12/21","dbgap"
"9166","phs000722.v2.pht003898.v2.p2",266,410,676,"05/01/2017","dbgap"
"9167","phs000942.v1.pht004835.v1.p1",26,232,258,"03/01/2016","dbgap"
"9168","phs002392.v1.pht011255.v1.p1",18,23,41,"2021/07/13","dbgap"
"9169","phs002204.v1.pht010907.v1.p1",2,2,4,"2021/02/02","dbgap"
"9170","phs001252.v1.pht006382.v1.p1",1691,1055,2746,"05/16/2017","dbgap"
"9171","phs000303.v1.pht001897.v1.p1",950,965,1915,"10/25/2011","dbgap"
"9172","phs000007.v32.pht004800.v4.p13",2098,2412,4510,"2020/12/21","dbgap"
"9175","phs001071.v1.pht005346.v1.p1",21,16,37,"2017/09/27","dbgap"
"9177","phs000160.v1.pht000732.v1.p1",925,1473,2398,"Fri Feb 20 11:36:01 2009","dbgap"
"9179","phs001421.v1.pht007026.v1.p1",20,17,37,"2018/01/11","dbgap"
"9180","phs002046.v1.pht010628.v1.p1",1332,4028,5360,"2020/11/02","dbgap"
"9182","phs000809.v1.pht004349.v1.p1",6,2,8,"11/07/2014","dbgap"
"9183","phs000264.v2.pht001418.v1.p1",114,69,183,"03/04/2011","dbgap"
"9184","phs002245.v1.pht010529.v1.p1",338,246,584,"2020/10/16","dbgap"
"9186","phs000574.v1.pht005862.v1.p1",14,91,105,"03/06/2017","dbgap"
"9187","phs001818.v3.pht009021.v3.p1",8,8,16,"2021/03/11","dbgap"
"9188","phs001097.v1.pht005617.v1.p1",1072,1154,2226,"07/05/2016","dbgap"
"9190","phs000437.v1.pht003691.v1.p1",4,8,12,"04/09/2014","dbgap"
"9191","phs000299.v2.pht001551.v2.p1",15,6,21,"02/27/2014","dbgap"
"9192","phs001713.v1.pht008522.v1.p1",722,1352,2074,"2019/12/19","dbgap"
"9193","phs000783.v2.pht006292.v1.p1",267,199,466,"2018/03/09","dbgap"
"9194","phs001332.v2.pht007461.v2.p1",158,187,345,"2019/11/08","dbgap"
"9195","phs000280.v7.pht006438.v1.p1",2287,2983,5270,"2020/06/18","dbgap"
"9196","phs000007.v32.pht000147.v5.p13",166,157,323,"2020/12/21","dbgap"
"9197","phs001288.v1.pht006771.v1.p1",45,28,73,"2017/10/19","dbgap"
"9198","phs000280.v7.pht006466.v1.p1",2600,3546,6146,"2020/06/18","dbgap"
"9199","phs000904.v1.pht004686.v1.p1",6,8,14,"2018/01/30","dbgap"
"9200","phs000007.v32.pht010748.v1.p13",925,1071,1996,"2020/12/21","dbgap"
"9202","phs000294.v1.pht001535.v1.p1",4620,1422,6042,"08/17/2010","dbgap"
"9204","phs001980.v1.pht010078.v1.p1",4,1,5,"2020/12/22","dbgap"
"9205","phs000901.v1.pht004675.v1.p1",44,13,57,"06/01/2015","dbgap"
"9206","phs001976.v2.pht009900.v1.p1",4,8,12,"2020/03/31","dbgap"
"9207","phs001571.v1.pht009506.v1.p1",964,1270,2234,"2020/08/06","dbgap"
"9210","phs001288.v1.pht006763.v1.p1",59,40,99,"2017/10/19","dbgap"
"9211","phs000984.v1.pht005702.v1.p1",82,93,175,"09/21/2016","dbgap"
"9212","phs001049.v1.pht005227.v1.p1",17,13,30,"2018/08/18","dbgap"
"9214","phs001737.v2.pht008559.v2.p1",2,1,3,"2019/09/18","dbgap"
"9215","phs000285.v3.pht001554.v3.p2",949,1067,2016,"08/20/2013","dbgap"
"9216","phs000622.v1.pht003952.v1.p1",1604,1990,3594,"07/25/2014","dbgap"
"9217","phs001877.v1.pht009483.v1.p1",24,7,31,"2019/09/19","dbgap"
"9218","phs001438.v1.pht006819.v1.p1",1,2,3,"2017/12/19","dbgap"
"9220","phs000866.v1.pht004618.v1.p1",45,42,87,"03/23/2015","dbgap"
"9222","phs001193.v1.pht005974.v1.p1",901,696,1597,"12/06/2016","dbgap"
"9224","phs000285.v3.pht001735.v2.p2",574,594,1168,"08/20/2013","dbgap"
"9225","phs001430.v2.pht008071.v2.p1",13,10,23,"2020/02/06","dbgap"
"9226","phs000209.v13.pht001207.v2.p3",3053,3364,6417,"11/05/2014","dbgap"
"9227","phs000285.v3.pht001674.v2.p2",194,195,389,"08/20/2013","dbgap"
"9228","phs001000.v1.pht005030.v1.p1",1973,349,2322,"03/16/2016","dbgap"
"9230","phs001711.v1.pht008530.v1.p1",5,3,8,"2021/02/11","dbgap"
"9231","phs000508.v2.pht002810.v1.p1",19,16,35,"04/15/2014","dbgap"
"9232","phs000637.v1.pht003536.v1.p1",650,617,1267,"10/21/2013","dbgap"
"9233","phs001210.v1.pht005961.v1.p1",2501,2834,5335,"11/30/2016","dbgap"
"9234","phs000512.v1.pht002860.v1.p1",59,38,97,"10/15/2012","dbgap"
"9235","phs001122.v1.pht008640.v1.p1",137,102,239,"2021/03/23","dbgap"
"9236","phs000448.v1.pht002510.v1.p1",2164,932,3096,"08/28/2012","dbgap"
"9237","phs001326.v1.pht007828.v1.p1",5,2,7,"2018/04/16","dbgap"
"9238","phs000615.v1.pht003306.v1.p1",5703,5475,11178,"08/14/2014","dbgap"
"9239","phs000707.v2.pht003714.v2.p1",10,8,18,"03/29/2017","dbgap"
"9240","phs001332.v2.pht007457.v2.p1",157,184,341,"2019/11/08","dbgap"
"9241","phs001880.v1.pht009560.v1.p1",194,235,429,"2019/10/28","dbgap"
"9243","phs001709.v1.pht009494.v1.p1",1,199,200,"2019/09/27","dbgap"
"9244","phs001281.v2.pht006125.v2.p1",4,5,9,"2019/02/21","dbgap"
"9245","phs000007.v32.pht000671.v7.p13",1464,1692,3156,"2020/12/21","dbgap"
"9246","phs001949.v1.pht009705.v1.p1",13495,15325,28820,"2019/12/26","dbgap"
"9248","phs001831.v1.pht009915.v1.p1",101,88,189,"2020/08/26","dbgap"
"9249","phs001718.v1.pht009425.v1.p1",1240,855,2095,"2019/09/16","dbgap"
"9250","phs002334.v1.pht010957.v1.p1",11,18,29,"2021/02/12","dbgap"
"9251","phs001854.v1.pht009253.v1.p1",3,3,6,"2019/10/07","dbgap"
"9252","phs001641.v1.pht010037.v1.p1",421,1114,1535,"2020/03/24","dbgap"
"9253","phs001384.v1.pht006740.v1.p1",20,11,31,"2017/08/02","dbgap"
"9255","phs001710.v1.pht011292.v1.p1",235,181,416,"2021/06/07","dbgap"
"9256","phs000285.v3.pht001739.v2.p2",467,492,959,"08/20/2013","dbgap"
"9257","phs000698.v1.pht007671.v1.p1",18,32,50,"2018/03/23","dbgap"
"9258","phs000280.v7.pht004130.v2.p1",6120,7410,13530,"2020/06/18","dbgap"
"9259","phs001238.v2.pht006658.v1.p1",374,539,913,"2018/06/14","dbgap"
"9262","phs001326.v1.pht007819.v1.p1",33,4,37,"2018/04/16","dbgap"
"9263","phs000128.v3.pht000419.v2.p3",2943,3500,6443,"04/29/2016","dbgap"
"9264","phs000209.v13.pht003122.v3.p3",2576,2817,5393,"11/05/2014","dbgap"
"9265","phs001396.v1.pht006738.v1.p1",749,821,1570,"2018/05/14","dbgap"
"9266","phs001138.v4.pht007077.v2.p2",467,423,890,"2021/10/21","dbgap"
"9267","phs000758.v1.pht003999.v1.p1",15,13,28,"08/21/2014","dbgap"
"9268","phs000248.v1.pht003682.v1.p1",2058,1369,3427,"02/10/2014","dbgap"
"9271","phs000234.v2.pht001151.v2.p2",1359,1774,3133,"2018/05/29","dbgap"
"9272","phs000209.v13.pht002512.v1.p3",2526,2729,5255,"11/05/2014","dbgap"
"9273","phs000280.v7.pht006449.v1.p1",713,1001,1714,"2020/06/18","dbgap"
"9275","phs001670.v1.pht008880.v1.p1",23,25,48,"2019/03/27","dbgap"
"9276","phs000007.v32.pht000303.v8.p13",1887,2152,4039,"2020/12/21","dbgap"
"9277","phs001612.v1.pht009496.v1.p1",811,943,1754,"2019/11/13","dbgap"
"9279","phs000903.v1.pht004873.v1.p1",1149,1464,2613,"10/14/2015","dbgap"
"9280","phs000984.v1.pht005009.v1.p1",96,106,202,"09/21/2016","dbgap"
"9281","phs000257.v3.pht003093.v1.p1",29,33,62,"2018/09/19","dbgap"
"9283","phs000343.v3.pht003159.v1.p1",1379,785,2164,"03/12/2013","dbgap"
"9284","phs002448.v1.pht011301.v1.p1",1,6,7,"2021/06/09","dbgap"
"9285","phs000001.v3.pht002477.v1.p1",2098,2659,4757,"02/24/2012","dbgap"
"9286","phs000285.v3.pht001598.v2.p2",909,1029,1938,"08/20/2013","dbgap"
"9287","phs000792.v1.pht004248.v1.p1",15,3,18,"09/18/2014","dbgap"
"9289","phs000584.v1.pht010796.v1.p1",679,764,1443,"2021/01/27","dbgap"
"9291","phs001596.v1.pht007965.v1.p1",15,22,37,"2018/05/17","dbgap"
"9292","phs000690.v1.pht003618.v1.p1",97,120,217,"12/16/2013","dbgap"
"9293","phs000286.v6.pht008739.v1.p2",1295,2163,3458,"2019/03/11","dbgap"
"9294","phs000007.v32.pht000740.v10.p13",7046,8098,15144,"2020/12/21","dbgap"
"9295","phs001288.v1.pht006785.v1.p1",4,1,5,"2017/10/19","dbgap"
"9296","phs001288.v1.pht006780.v1.p1",39,27,66,"2017/10/19","dbgap"
"9297","phs001252.v1.pht006366.v1.p1",1691,1055,2746,"05/16/2017","dbgap"
"9298","phs000285.v3.pht001743.v2.p2",78,94,172,"08/20/2013","dbgap"
"9299","phs000285.v3.pht001605.v2.p2",2,17,19,"08/20/2013","dbgap"
"9300","phs001585.v1.pht008830.v1.p1",255,179,434,"2019/03/18","dbgap"
"9301","phs000662.v1.pht003558.v1.p1",299,342,641,"12/17/2013","dbgap"
"9302","phs001412.v3.pht006745.v1.p1",169,234,403,"2021/06/16","dbgap"
"9303","phs002269.v1.pht010580.v1.p1",25,12,37,"2020/10/16","dbgap"
"9304","phs001213.v2.pht005838.v2.p1",761,282,1043,"2020/02/27","dbgap"
"9306","phs001222.v1.pht005907.v1.p1",476,938,1414,"2019/05/30","dbgap"
"9307","phs000657.v1.pht003492.v1.p1",6,3,9,"08/30/2013","dbgap"
"9308","phs000086.v3.pht000221.v1.p1",750,672,1422,"11/04/2014","dbgap"
"9309","phs000777.v1.pht003974.v1.p1",4,6,10,"08/20/2014","dbgap"
"9310","phs000405.v1.pht003065.v1.p1",6,7,13,"11/15/2012","dbgap"
"9311","phs001053.v1.pht007233.v1.p1",143,213,356,"2017/12/13","dbgap"
"9312","phs001935.v1.pht009766.v1.p1",6,6,12,"2020/02/06","dbgap"
"9313","phs000449.v2.pht002778.v2.p1",115,52,167,"07/31/2012","dbgap"
"9314","phs000684.v1.pht003644.v1.p1",2185,3122,5307,"04/18/2014","dbgap"
"9315","phs001475.v1.pht007583.v1.p1",575,512,1087,"2018/08/18","dbgap"
"9317","phs002240.v1.pht010865.v1.p1",30,66,96,"2021/01/15","dbgap"
"9318","phs000690.v1.pht003622.v1.p1",15,45,60,"12/16/2013","dbgap"
"9319","phs000007.v32.pht002080.v2.p13",231,419,650,"2020/12/21","dbgap"
"9320","phs001289.v1.pht007796.v1.p1",16,13,29,"2018/04/16","dbgap"
"9321","phs000879.v1.pht005034.v1.p1",15,15,30,"10/14/2015","dbgap"
"9324","phs000128.v3.pht000594.v2.p3",2943,3500,6443,"04/29/2016","dbgap"
"9325","phs000159.v9.pht000818.v9.p5",49,48,97,"2019/12/06","dbgap"
"9327","phs001884.v1.pht009641.v1.p1",81,273,354,"2019/11/27","dbgap"
"9328","phs000007.v32.pht009760.v2.p13",7046,8098,15144,"2020/12/21","dbgap"
"9329","phs000128.v3.pht000550.v2.p3",2943,3500,6443,"04/29/2016","dbgap"
"9330","phs000007.v32.pht010729.v1.p13",399,395,794,"2020/12/21","dbgap"
"9331","phs001729.v2.pht010128.v1.p1",11,8,19,"2021/08/26","dbgap"
"9332","phs000976.v2.pht005683.v1.p1",10738,9229,19967,"2020/11/09","dbgap"
"9334","phs001526.v1.pht007612.v1.p1",7,5,12,"2018/06/26","dbgap"
"9336","phs001278.v1.pht006274.v1.p1",46,37,83,"06/16/2017","dbgap"
"9338","phs001608.v2.pht009736.v1.p1",289,351,640,"2021/09/29","dbgap"
"9339","phs002290.v1.pht010824.v1.p1",82,36,118,"2020/12/30","dbgap"
"9340","phs001931.v1.pht009679.v1.p1",10,26,36,"2020/02/03","dbgap"
"9342","phs000783.v2.pht004282.v2.p1",264,195,459,"2018/03/09","dbgap"
"9343","phs001682.v2.pht009763.v1.p1",214,210,424,"2021/08/06","dbgap"
"9344","phs000896.v1.pht005124.v1.p1",5,7,12,"11/16/2015","dbgap"
"9345","phs000455.v1.pht002576.v1.p1",7,3,10,"06/20/2012","dbgap"
"9346","phs000200.v9.pht001032.v6.p3",57,49474,49531,"11/08/2013","dbgap"
"9347","phs000576.v1.pht006154.v1.p1",116,128,244,"05/24/2017","dbgap"
"9348","phs000222.v6.pht007350.v1.p2",44,37,81,"2019/08/01","dbgap"
"9349","phs002067.v1.pht010410.v1.p1",38,27,65,"2020/10/21","dbgap"
"9350","phs001867.v1.pht009350.v1.p1",8,9,17,"2019/08/05","dbgap"
"9352","phs002291.v1.pht010803.v1.p1",4,1,5,"2021/01/21","dbgap"
"9354","phs001284.v1.pht009033.v1.p1",125,92,217,"2019/05/09","dbgap"
"9355","phs001900.v1.pht009631.v1.p1",123,96,219,"2020/03/02","dbgap"
"9356","phs000209.v13.pht003609.v1.p3",2082,2300,4382,"11/05/2014","dbgap"
"9357","phs001654.v1.pht008444.v1.p1",68,14,82,"2018/10/31","dbgap"
"9359","phs000285.v3.pht001563.v2.p2",947,1065,2012,"08/20/2013","dbgap"
"9360","phs001724.v1.pht008505.v1.p1",2,1,3,"2018/10/30","dbgap"
"9361","phs000086.v3.pht000218.v1.p1",744,673,1417,"11/04/2014","dbgap"
"9362","phs000007.v32.pht005166.v3.p13",184,215,399,"2020/12/21","dbgap"
"9363","phs000007.v32.pht006017.v2.p13",974,1190,2164,"2020/12/21","dbgap"
"9364","phs000367.v1.pht003263.v1.p1",327,377,704,"08/09/2013","dbgap"
"9365","phs001331.v2.pht006935.v2.p1",120,76,196,"2019/08/30","dbgap"
"9367","phs000286.v6.pht008781.v1.p2",939,1458,2397,"2019/03/11","dbgap"
"9368","phs000710.v1.pht003985.v1.p1",1,2,3,"04/29/2015","dbgap"
"9369","phs000332.v3.pht002336.v2.p2",12,1790,1802,"02/01/2016","dbgap"
"9370","phs001823.v1.pht009057.v1.p1",169,92,261,"2019/08/07","dbgap"
"9371","phs001328.v1.pht006316.v1.p1",54,37,91,"05/17/2017","dbgap"
"9372","phs001346.v1.pht006256.v1.p1",5,10,15,"2019/03/28","dbgap"
"9373","phs001776.v1.pht009209.v1.p1",51,40,91,"2019/06/19","dbgap"
"9374","phs001326.v1.pht007804.v1.p1",32,5,37,"2018/04/16","dbgap"
"9375","phs001546.v2.pht009972.v1.p1",5,1,6,"2021/07/14","dbgap"
"9376","phs001484.v1.pht007739.v1.p1",234,87,321,"2018/05/15","dbgap"
"9377","phs000277.v2.pht002796.v2.p1",3640,2889,6529,"2020/04/02","dbgap"
"9378","phs000340.v3.pht002210.v2.p1",73,33,106,"04/10/2014","dbgap"
"9380","phs001620.v1.pht008179.v1.p1",692,1360,2052,"2018/06/30","dbgap"
"9381","phs000595.v1.pht006630.v1.p1",191,214,405,"07/05/2017","dbgap"
"9384","phs000007.v32.pht000150.v8.p13",1775,2034,3809,"2020/12/21","dbgap"
"9385","phs000092.v1.pht000636.v1.p1",1973,2326,4299,"Wed Nov 19 17:41:25 2008","dbgap"
"9388","phs001705.v1.pht009274.v1.p1",314,251,565,"2019/07/26","dbgap"
"9389","phs000911.v1.pht004978.v1.p1",5233,5558,10791,"05/06/2016","dbgap"
"9390","phs001244.v1.pht006055.v1.p1",73,30,103,"01/09/2017","dbgap"
"9391","phs001775.v1.pht008808.v1.p1",24,16,40,"2019/03/01","dbgap"
"9392","phs001326.v1.pht007801.v1.p1",19,1,20,"2018/04/16","dbgap"
"9393","phs001331.v2.pht006923.v2.p1",172,114,286,"2019/08/30","dbgap"
"9395","phs001834.v1.pht009423.v1.p1",12,18,30,"2020/01/10","dbgap"
"9396","phs000738.v1.pht003837.v1.p1",117,99,216,"05/07/2014","dbgap"
"9399","phs001704.v1.pht008463.v1.p1",16,7,23,"2018/10/16","dbgap"
"9401","phs001317.v1.pht008040.v1.p1",25,34,59,"2018/06/01","dbgap"
"9402","phs001310.v1.pht006872.v1.p1",31,25,56,"2017/09/18","dbgap"
"9404","phs000573.v1.pht003214.v1.p1",49,34,83,"03/20/2013","dbgap"
"9405","phs001961.v1.pht011028.v1.p1",6,4,10,"2021/06/03","dbgap"
"9406","phs001680.v1.pht008913.v1.p1",22,10,32,"2019/03/28","dbgap"
"9407","phs002105.v1.pht010709.v1.p1",69,150,219,"2020/12/01","dbgap"
"9408","phs000436.v1.pht002836.v1.p1",745,457,1202,"11/19/2013","dbgap"
"9409","phs001467.v2.pht011387.v1.p2",11,17,28,"2021/08/10","dbgap"
"9410","phs001982.v1.pht010006.v1.p1",26,36,62,"2020/03/19","dbgap"
"9411","phs001326.v1.pht007803.v1.p1",19,3,22,"2018/04/16","dbgap"
"9412","phs001856.v1.pht009600.v1.p1",4948,4976,9924,"2020/08/05","dbgap"
"9413","phs000280.v7.pht004084.v2.p1",203,91,294,"2020/06/18","dbgap"
"9414","phs000697.v1.pht007697.v1.p1",24,5,29,"2018/03/26","dbgap"
"9415","phs001022.v1.pht005440.v1.p1",96,24,120,"2017/08/17","dbgap"
"9416","phs000206.v5.pht000897.v4.p3",4813,4624,9437,"08/18/2015","dbgap"
"9417","phs001071.v1.pht005348.v1.p1",21,16,37,"2017/09/27","dbgap"
"9418","phs000394.v1.pht002652.v1.p1",647,354,1001,"05/24/2012","dbgap"
"9419","phs000125.v1.pht000319.v1.p1",1041,904,1945,"Thu Oct  2 11:09:39 2008","dbgap"
"9420","phs001419.v1.pht007085.v1.p1",184,185,369,"2017/12/04","dbgap"
"9421","phs002240.v1.pht010863.v1.p1",30,66,96,"2021/01/15","dbgap"
"9422","phs000286.v6.pht008761.v1.p2",964,1849,2813,"2019/03/11","dbgap"
"9423","phs001901.v1.pht009499.v1.p1",901,567,1468,"2019/10/02","dbgap"
"9424","phs001252.v1.pht006374.v1.p1",1273,825,2098,"05/16/2017","dbgap"
"9425","phs000404.v1.pht002365.v1.p1",1512,2091,3603,"12/13/2011","dbgap"
"9426","phs000086.v3.pht000332.v1.p1",236,250,486,"11/04/2014","dbgap"
"9427","phs001549.v1.pht008250.v1.p1",81,70,151,"2018/08/18","dbgap"
"9428","phs002056.v1.pht010450.v1.p1",6353,40,6393,"2021/08/11","dbgap"
"9429","phs000594.v1.pht006502.v1.p1",2,2,4,"06/12/2017","dbgap"
"9432","phs000538.v1.pht003042.v1.p1",2,4,6,"11/07/2012","dbgap"
"9433","phs001734.v1.pht008824.v1.p1",363,244,607,"2019/03/25","dbgap"
"9434","phs000128.v3.pht000487.v2.p3",2943,3500,6443,"04/29/2016","dbgap"
"9435","phs000450.v4.pht002529.v3.p1",171,153,324,"2020/10/29","dbgap"
"9436","phs001106.v1.pht007337.v1.p1",29,30,59,"2018/10/15","dbgap"
"9437","phs001348.v2.pht006232.v2.p1",24,21,45,"2017/09/25","dbgap"
"9438","phs001278.v1.pht006282.v1.p1",85,111,196,"06/16/2017","dbgap"
"9439","phs000343.v3.pht003147.v1.p1",1379,785,2164,"03/12/2013","dbgap"
"9440","phs000536.v2.pht002947.v2.p1",22,12,34,"02/11/2016","dbgap"
"9441","phs000007.v32.pht000010.v3.p13",1702,2207,3909,"2020/12/21","dbgap"
"9443","phs000820.v1.pht004330.v1.p1",410,133,543,"11/13/2015","dbgap"
"9444","phs001387.v3.pht008967.v2.p1",2720,2747,5467,"2021/06/10","dbgap"
"9445","phs000592.v1.pht006598.v1.p1",179,145,324,"07/12/2017","dbgap"
"9446","phs000209.v13.pht002106.v3.p3",444,473,917,"11/05/2014","dbgap"
"9447","phs001584.v2.pht009072.v2.p2",48057,56813,104870,"2020/11/13","dbgap"
"9448","phs001784.v1.pht009002.v1.p1",30,11,41,"2019/06/24","dbgap"
"9449","phs000145.v4.pht000661.v3.p2",3078,2838,5916,"04/16/2013","dbgap"
"9450","phs000244.v1.pht001520.v1.p1",4,2,6,"07/14/2010","dbgap"
"9452","phs000664.v1.pht003543.v1.p1",17,17,34,"10/22/2013","dbgap"
"9454","phs000086.v3.pht000215.v1.p1",761,680,1441,"11/04/2014","dbgap"
"9457","phs001712.v1.pht008675.v1.p1",7,3,10,"2019/01/31","dbgap"
"9459","phs001969.v1.pht009935.v1.p1",14,6,20,"2020/03/04","dbgap"
"9460","phs001074.v1.pht005341.v1.p1",115,135,250,"03/15/2016","dbgap"
"9462","phs000894.v1.pht004660.v1.p1",320,235,555,"05/12/2015","dbgap"
"9463","phs000969.v1.pht004928.v1.p1",2,2,4,"10/05/2015","dbgap"
"9464","phs000364.v2.pht002260.v2.p1",26,16,42,"09/24/2013","dbgap"
"9466","phs000280.v7.pht004235.v2.p1",6783,8155,14938,"2020/06/18","dbgap"
"9467","phs000952.v1.pht005320.v1.p1",1540,1332,2872,"03/10/2016","dbgap"
"9468","phs000280.v7.pht006448.v1.p1",228,224,452,"2020/06/18","dbgap"
"9470","phs000128.v3.pht000476.v2.p3",2943,3500,6443,"04/29/2016","dbgap"
"9471","phs000367.v1.pht003261.v1.p1",718,784,1502,"08/09/2013","dbgap"
"9472","phs000007.v32.pht010743.v1.p13",1205,1430,2635,"2020/12/21","dbgap"
"9473","phs001406.v1.pht007743.v1.p1",71,79,150,"2019/10/11","dbgap"
"9474","phs000280.v7.pht006433.v1.p1",198,274,472,"2020/06/18","dbgap"
"9475","phs002045.v1.pht010310.v1.p1",9,6,15,"2020/06/30","dbgap"
"9476","phs000128.v3.pht000558.v2.p3",2943,3500,6443,"04/29/2016","dbgap"
"9477","phs001065.v1.pht005429.v1.p1",295,312,607,"05/24/2016","dbgap"
"9478","phs002331.v1.pht011102.v1.p1",1681,544,2225,"2021/05/21","dbgap"
"9481","phs000577.v1.pht007270.v1.p1",174,341,515,"2017/12/20","dbgap"
"9482","phs000908.v1.pht004705.v1.p1",211,219,430,"01/19/2016","dbgap"
"9484","phs000541.v1.pht003051.v1.p1",2,5,7,"11/29/2012","dbgap"
"9485","phs000862.v1.pht007835.v1.p1",1,4,5,"2018/04/16","dbgap"
"9486","phs001872.v1.pht009364.v1.p1",292,311,603,"2019/07/31","dbgap"
"9487","phs001394.v1.pht006948.v1.p1",314,451,765,"2017/09/22","dbgap"
"9488","phs000819.v1.pht004380.v1.p1",6,14,20,"2018/01/18","dbgap"
"9489","phs001576.v2.pht008223.v2.p2",35,17,52,"2019/09/27","dbgap"
"9490","phs000224.v3.pht002180.v3.p2",998,1919,2917,"2019/10/08","dbgap"
"9491","phs000086.v3.pht000261.v1.p1",173,169,342,"11/04/2014","dbgap"
"9492","phs000209.v13.pht002388.v1.p3",1305,1491,2796,"11/05/2014","dbgap"
"9493","phs001702.v1.pht008428.v1.p1",13,147,160,"2018/10/02","dbgap"
"9495","phs000285.v3.pht001831.v2.p2",876,990,1866,"08/20/2013","dbgap"
"9496","phs000624.v1.pht009131.v1.p1",345,277,622,"2019/06/03","dbgap"
"9498","phs002417.v1.pht011274.v1.p1",1578,1507,3085,"2021/06/03","dbgap"
"9499","phs001556.v1.pht007845.v1.p1",67,33,100,"2018/04/20","dbgap"
"9500","phs000343.v3.pht003162.v1.p1",1366,776,2142,"03/12/2013","dbgap"
"9501","phs001969.v1.pht009937.v1.p1",14,6,20,"2020/03/04","dbgap"
"9502","phs000286.v6.pht008763.v1.p2",850,1508,2358,"2019/03/11","dbgap"
"9503","phs001884.v1.pht009638.v1.p1",81,273,354,"2019/11/27","dbgap"
"9504","phs001774.v1.pht008803.v1.p1",22,28,50,"2020/02/27","dbgap"
"9505","phs001984.v1.pht010784.v1.p1",706,388,1094,"2020/12/14","dbgap"
"9507","phs001623.v2.pht008363.v2.p1",30,11,41,"2019/10/31","dbgap"
"9508","phs000873.v1.pht004559.v1.p1",2,6,8,"03/13/2015","dbgap"
"9509","phs001547.v2.pht009987.v1.p1",75,15,90,"2021/07/15","dbgap"
"9511","phs001008.v1.pht005110.v1.p1",419,605,1024,"11/13/2015","dbgap"
"9512","phs000606.v1.pht007571.v1.p1",745,276,1021,"2018/03/09","dbgap"
"9513","phs000199.v1.pht000892.v1.p1",922,1104,2026,"01/06/2010","dbgap"
"9514","phs000911.v1.pht004975.v1.p1",9507,9339,18846,"05/06/2016","dbgap"
"9515","phs000285.v3.pht001782.v2.p2",847,930,1777,"08/20/2013","dbgap"
"9516","phs000335.v3.pht003965.v1.p2",2613,1532,4145,"07/25/2014","dbgap"
"9517","phs000101.v5.pht003748.v1.p1",133,114,247,"2018/08/19","dbgap"
"9518","phs000711.v7.pht003720.v6.p2",1828,1747,3575,"2021/03/24","dbgap"
"9519","phs001318.v1.pht008037.v1.p1",15,10,25,"2018/05/31","dbgap"
"9520","phs001488.v1.pht007423.v1.p1",256,292,548,"2018/02/08","dbgap"
"9521","phs001222.v1.pht005909.v1.p1",476,938,1414,"2019/05/30","dbgap"
"9522","phs001065.v1.pht005409.v1.p1",296,313,609,"05/24/2016","dbgap"
"9524","phs001363.v1.pht006519.v1.p1",63,44,107,"2017/08/18","dbgap"
"9525","phs001632.v1.pht008533.v1.p1",648,760,1408,"2018/11/05","dbgap"
"9526","phs001757.v1.pht008669.v1.p1",148,184,332,"2019/03/11","dbgap"
"9528","phs001392.v1.pht006902.v1.p1",2,1,3,"2017/09/22","dbgap"
"9529","phs000209.v13.pht002101.v1.p3",615,627,1242,"11/05/2014","dbgap"
"9530","phs001292.v2.pht007852.v2.p1",234,537,771,"2019/06/03","dbgap"
"9532","phs000219.v1.pht001053.v1.p1",80,120,200,"01/19/2010","dbgap"
"9533","phs001046.v1.pht005293.v1.p1",349,548,897,"2018/06/01","dbgap"
"9534","phs000096.v4.pht001422.v4.p1",7555,7522,15077,"11/16/2011","dbgap"
"9535","phs002346.v1.pht011575.v1.p1",134,26,160,"2021/09/24","dbgap"
"9536","phs001812.v1.pht009107.v1.p1",64,51,115,"2021/02/22","dbgap"
"9537","phs000496.v1.pht003170.v1.p1",1048,2091,3139,"03/28/2014","dbgap"
"9538","phs000223.v1.pht002619.v1.p1",1420,2323,3743,"03/14/2012","dbgap"
"9539","phs000495.v1.pht002864.v1.p1",601,426,1027,"08/22/2012","dbgap"
"9540","phs000280.v7.pht004134.v2.p1",5446,6661,12107,"2020/06/18","dbgap"
"9541","phs001330.v2.pht007536.v2.p1",20,15,35,"2019/11/08","dbgap"
"9542","phs000701.v1.pht005513.v1.p1",39,40,79,"06/01/2017","dbgap"
"9543","phs001425.v1.pht006757.v1.p1",22,12,34,"2017/08/09","dbgap"
"9545","phs000007.v32.pht000741.v3.p13",61,249,310,"2020/12/21","dbgap"
"9547","phs000126.v2.pht000322.v2.p1",363,532,895,"08/29/2016","dbgap"
"9548","phs002049.v1.pht010295.v1.p1",64,53,117,"2020/06/30","dbgap"
"9549","phs000927.v1.pht004753.v1.p1",71,131,202,"04/05/2017","dbgap"
"9550","phs000219.v1.pht001054.v1.p1",199,310,509,"01/19/2010","dbgap"
"9551","phs000280.v7.pht004111.v2.p1",6783,8154,14937,"2020/06/18","dbgap"
"9554","phs001848.v1.pht009203.v1.p1",1,2,3,"2019/06/24","dbgap"
"9556","phs001288.v1.pht006773.v1.p1",44,27,71,"2017/10/19","dbgap"
"9557","phs001521.v1.pht007721.v1.p1",16,11,27,"2018/06/13","dbgap"
"9558","phs001641.v1.pht010032.v1.p1",556,1271,1827,"2020/03/24","dbgap"
"9559","phs001067.v1.pht005285.v1.p1",2,1,3,"02/02/2016","dbgap"
"9562","phs001576.v2.pht008215.v2.p2",35,17,52,"2019/09/27","dbgap"
"9563","phs000867.v1.pht004483.v1.p1",1016,834,1850,"02/13/2015","dbgap"
"9564","phs000007.v32.pht010752.v1.p13",138,180,318,"2020/12/21","dbgap"
"9565","phs000285.v3.pht001559.v2.p2",947,1065,2012,"08/20/2013","dbgap"
"9566","phs000787.v1.pht004257.v1.p1",6,3,9,"09/23/2014","dbgap"
"9567","phs001552.v1.pht008395.v1.p1",1329,497,1826,"2018/09/21","dbgap"
"9568","phs000017.v3.pht000323.v1.p1",301,298,599,"Wed Nov 26 07:46:08 2008","dbgap"
"9569","phs000578.v1.pht007022.v1.p1",49,42,91,"2017/10/11","dbgap"
"9571","phs001279.v1.pht007211.v1.p1",15,23,38,"2017/12/08","dbgap"
"9573","phs002121.v1.pht011549.v1.p1",63,57,120,"2021/09/14","dbgap"
"9574","phs000285.v3.pht001567.v2.p2",947,1064,2011,"08/20/2013","dbgap"
"9575","phs000813.v1.pht004302.v1.p1",1180,1797,2977,"10/21/2015","dbgap"
"9576","phs001304.v1.pht008314.v1.p1",65,86,151,"2018/10/05","dbgap"
"9580","phs001341.v1.pht006863.v1.p1",36,54,90,"2017/11/30","dbgap"
"9582","phs000128.v3.pht000833.v2.p3",8594,8802,17396,"04/29/2016","dbgap"
"9584","phs002015.v1.pht010364.v1.p1",918,1241,2159,"2020/09/18","dbgap"
"9588","phs002255.v1.pht010676.v1.p1",209,180,389,"2020/11/20","dbgap"
"9589","phs000285.v3.pht001857.v2.p2",880,993,1873,"08/20/2013","dbgap"
"9590","phs001626.v1.pht008477.v1.p1",68,64,132,"2018/10/29","dbgap"
"9591","phs000816.v2.pht004344.v2.p1",199,225,424,"04/17/2017","dbgap"
"9592","phs001003.v2.pht010324.v2.p1",56,89,145,"2021/03/01","dbgap"
"9593","phs001346.v1.pht006257.v1.p1",5,10,15,"2019/03/28","dbgap"
"9594","phs001292.v2.pht007855.v2.p1",235,538,773,"2019/06/03","dbgap"
"9595","phs001734.v1.pht008825.v1.p1",363,244,607,"2019/03/25","dbgap"
"9596","phs000933.v2.pht004774.v2.p1",169,121,290,"2018/03/09","dbgap"
"9597","phs000589.v1.pht009182.v1.p1",9,127,136,"2019/06/14","dbgap"
"9598","phs001829.v1.pht010166.v1.p1",10,7,17,"2020/04/24","dbgap"
"9599","phs001022.v1.pht005442.v1.p1",96,24,120,"2017/08/17","dbgap"
"9601","phs000286.v6.pht008744.v1.p2",854,1519,2373,"2019/03/11","dbgap"
"9602","phs001488.v1.pht007413.v1.p1",260,293,553,"2018/02/08","dbgap"
"9603","phs000906.v1.pht007145.v1.p1",4648,4362,9010,"2017/12/04","dbgap"
"9604","phs001305.v1.pht007104.v1.p1",5,7,12,"2017/11/01","dbgap"
"9605","phs000538.v1.pht003040.v1.p1",2,4,6,"11/07/2012","dbgap"
"9606","phs000603.v1.pht007552.v1.p1",5,10,15,"2018/03/06","dbgap"
"9607","phs001020.v2.pht005781.v2.p1",784,467,1251,"2019/10/18","dbgap"
"9608","phs001918.v2.pht010047.v1.p1",5164,3924,9088,"2021/10/07","dbgap"
"9609","phs000664.v1.pht003545.v1.p1",17,17,34,"10/22/2013","dbgap"
"9610","phs001919.v1.pht009591.v1.p1",28,11,39,"2020/03/11","dbgap"
"9611","phs000343.v3.pht002715.v1.p1",1364,780,2144,"03/12/2013","dbgap"
"9614","phs000285.v3.pht001848.v2.p2",873,981,1854,"08/20/2013","dbgap"
"9615","phs001653.v1.pht008704.v1.p1",278,347,625,"2019/04/10","dbgap"
"9616","phs000431.v2.pht002483.v2.p1",2333,1282,3615,"02/20/2015","dbgap"
"9617","phs000966.v2.pht005306.v2.p2",209,279,488,"2021/08/27","dbgap"
"9618","phs000565.v1.pht003075.v1.p1",121,71,192,"12/06/2012","dbgap"
"9619","phs000128.v3.pht000485.v2.p3",2943,3500,6443,"04/29/2016","dbgap"
"9620","phs001899.v2.pht009569.v2.p1",915,1025,1940,"2020/11/02","dbgap"
"9622","phs001316.v1.pht008013.v1.p1",2,1,3,"2018/05/31","dbgap"
"9624","phs001700.v1.pht008500.v1.p1",39,85,124,"2020/11/24","dbgap"
"9625","phs001527.v1.pht007517.v1.p1",213,6,219,"2018/04/04","dbgap"
"9627","phs000946.v5.pht004974.v2.p1",21,53,74,"2021/05/07","dbgap"
"9628","phs000587.v1.pht003518.v1.p1",16,13,29,"04/25/2014","dbgap"
"9630","phs002416.v1.pht011231.v1.p1",3,16,19,"2021/05/18","dbgap"
"9632","phs001430.v2.pht008082.v2.p1",13,9,22,"2020/02/06","dbgap"
"9633","phs001326.v1.pht007805.v1.p1",24,1,25,"2018/04/16","dbgap"
"9634","phs000385.v1.pht002341.v1.p1",53,47,100,"11/28/2011","dbgap"
"9635","phs001678.v1.pht008474.v1.p1",6,2,8,"2018/10/29","dbgap"
"9637","phs001392.v1.pht006885.v1.p1",20,10,30,"2017/09/22","dbgap"
"9638","phs000209.v13.pht004325.v1.p3",2082,2300,4382,"11/05/2014","dbgap"
"9639","phs000767.v1.pht003931.v1.p1",37,12,49,"07/03/2014","dbgap"
"9640","phs000101.v5.pht000187.v1.p1",128,140,268,"2018/08/19","dbgap"
"9641","phs000630.v1.pht003383.v1.p1",466,480,946,"04/29/2014","dbgap"
"9642","phs000734.v1.pht003769.v1.p1",409,285,694,"04/04/2014","dbgap"
"9643","phs000021.v3.pht000289.v1.p2",767,474,1241,"10/25/2010","dbgap"
"9644","phs001724.v1.pht008506.v1.p1",2,1,3,"2018/10/30","dbgap"
"9645","phs000007.v32.pht002424.v6.p13",1708,1885,3593,"2020/12/21","dbgap"
"9646","phs000170.v2.pht000807.v1.p1",1633,2330,3963,"02/27/2015","dbgap"
"9648","phs001229.v1.pht006548.v1.p1",25,14,39,"06/15/2017","dbgap"
"9649","phs001278.v1.pht006273.v1.p1",2,2,4,"06/16/2017","dbgap"
"9650","phs001771.v1.pht008716.v1.p1",163,280,443,"2021/02/12","dbgap"
"9651","phs000282.v1.pht001442.v1.p1",3544,4281,7825,"06/24/2010","dbgap"
"9652","phs001868.v1.pht009779.v1.p1",5418,5814,11232,"2020/04/17","dbgap"
"9653","phs001823.v1.pht009059.v1.p1",169,92,261,"2019/08/07","dbgap"
"9654","phs000286.v6.pht008785.v1.p2",1009,1780,2789,"2019/03/11","dbgap"
"9655","phs000007.v32.pht000694.v8.p13",1885,2147,4032,"2020/12/21","dbgap"
"9656","phs000435.v3.pht002522.v3.p1",104,65,169,"02/27/2017","dbgap"
"9657","phs000244.v1.pht001519.v1.p1",4,2,6,"07/14/2010","dbgap"
"9659","phs001292.v2.pht007850.v2.p1",238,538,776,"2019/06/03","dbgap"
"9660","phs001688.v1.pht008592.v1.p1",23,12,35,"2018/12/06","dbgap"
"9661","phs001725.v2.pht010094.v1.p1",468,172,640,"2021/08/18","dbgap"
"9663","phs000273.v1.pht001434.v1.p1",16,9,25,"07/08/2011","dbgap"
"9664","phs001417.v1.pht007366.v1.p1",136,409,545,"2018/01/26","dbgap"
"9665","phs001736.v1.pht009327.v1.p1",1504,881,2385,"2019/07/29","dbgap"
"9667","phs000371.v2.pht002989.v1.p1",1212,1563,2775,"10/25/2016","dbgap"
"9668","phs001601.v2.pht010665.v2.p2",1271,939,2210,"2021/07/19","dbgap"
