study_id,year,ym,male,female,unknown,total
phs000001.v3.p1,2012,2012.08333333333,3002,3954,1001,7957
phs000007.v32.p13,2020,2020.91666666667,23738,28003,7813,59554
phs000016.v2.p2,2009,2009.83333333333,1718,1040,11,2769
phs000017.v3.p1,,,1505,1756,0,3261
phs000020.v2.p1,,,1291,2449,1,3741
phs000021.v3.p2,2010,2010.75,2786,2278,0,5064
phs000048.v1.p1,,,872,678,0,1550
phs000086.v3.p1,2014,2014.83333333333,758,689,85,1532
phs000089.v3.p2,2010,2010.25,896,845,0,1741
phs000090.v1.p1,2009,2009.91666666667,5995,7254,0,13249
phs000091.v2.p1,2009,2009.58333333333,2663,3425,36,6124
phs000092.v1.p1,,,3898,4587,130,8615
phs000093.v2.p2,2009,2009.75,8241,3096,32,11369
phs000094.v1.p1,2010,2010.25,7880,7254,874,16008
phs000095.v4.p2,2021,2021.66666666667,2013,2399,1380,5792
phs000096.v4.p1,2011,2011.83333333333,2287,7052,5988,15327
phs000101.v5.p1,2018,2018.58333333333,8696,6694,135,15525
phs000102.v1.p1,,,248,237,0,485
phs000126.v2.p1,2016,2016.58333333333,1054,1028,109,2191
phs000127.v2.p1,2010,2010.66666666667,231,201,0,432
phs000128.v3.p3,2016,2016.25,3222,3874,10300,17396
phs000138.v2.p1,2010,2010.41666666667,33,1557,1495,3085
phs000140.v1.p1,2010,2010.83333333333,892,1250,0,2142
phs000142.v1.p1,2009,2009.5,635,2489,1445,4569
phs000144.v1.p1,,,330,432,6,768
phs000147.v3.p1,2015,2015.33333333333,0,2723,0,2723
phs000166.v2.p1,2009,2009.66666666667,2164,1882,604,4650
phs000167.v1.p1,2009,2009.25,1835,1226,0,3061
phs000168.v2.p2,2012,2012.58333333333,2110,3462,4163,9735
phs000170.v2.p1,2015,2015.08333333333,1681,2367,7072,11120
phs000180.v3.p2,2015,2015.33333333333,2196,1930,31,4157
phs000181.v1.p1,2009,2009.91666666667,3419,3665,3886,10970
phs000185.v7.p1,2020,2020.25,512,801,319,1632
phs000187.v1.p1,2010,2010.25,1920,1391,100,3411
phs000188.v1.p1,2010,2010.75,1283,1920,0,3203
phs000196.v3.p1,2015,2015.16666666667,2259,2012,0,4271
phs000199.v1.p1,2010,2010,922,1104,0,2026
phs000200.v9.p3,2013,2013.83333333333,0,51395,6605,58000
phs000202.v1.p1,2010,2010,0,297,0,297
phs000203.v1.p1,2010,2010.75,2123,1309,45,3477
phs000206.v5.p3,2015,2015.58333333333,4940,4762,0,9702
phs000207.v1.p1,2009,2009.91666666667,2300,0,0,2300
phs000209.v13.p3,2014,2014.83333333333,11235,12687,1392,25314
phs000211.v1.p1,2009,2009.66666666667,167,233,0,400
phs000219.v1.p1,2010,2010,619,969,130,1718
phs000223.v1.p1,2012,2012.16666666667,1298,2127,318,3743
phs000224.v3.p2,2019,2019.75,1008,1930,0,2938
phs000238.v1.p1,2013,2013.83333333333,2477,2933,6,5416
phs000239.v2.p1,2010,2010.5,4,12,0,16
phs000240.v1.p1,2011,2011.58333333333,500,631,6,1137
phs000244.v1.p1,2010,2010.5,5,3,0,8
phs000245.v1.p1,2010,2010.66666666667,0,4,0,4
phs000249.v2.p1,2014,2014.25,254,128,0,382
phs000250.v1.p1,2011,2011.5,196,155,0,351
phs000251.v2.p2,2013,2013.83333333333,159,77,0,236
phs000254.v2.p1,2012,2012.75,217,214,0,431
phs000256.v4.p3,2019,2019.75,0,6476,0,6476
phs000258.v2.p1,2011,2011.25,212,387,0,599
phs000260.v4.p2,2015,2015.83333333333,482,93,0,575
phs000262.v3.p2,2017,2017.66666666667,432,130,50,612
phs000263.v1.p1,2010,2010.41666666667,64,84,17,165
phs000266.v4.p1,2013,2013.66666666667,2073,1138,0,3211
phs000267.v5.p2,2016,2016.16666666667,9798,5962,0,15760
phs000268.v1.p1,2011,2011.08333333333,86,98,0,184
phs000269.v1.p1,2010,2010.58333333333,381,332,3,716
phs000272.v1.p1,2010,2010.66666666667,1413,1080,0,2493
phs000273.v1.p1,2011,2011.5,16,9,0,25
phs000275.v1.p1,2012,2012.66666666667,235,689,0,924
phs000276.v2.p1,2014,2014,5203,5712,16,10931
phs000279.v2.p1,2016,2016,405,322,0,727
phs000280.v7.p1,2020,2020.41666666667,19515,24125,578,44218
phs000284.v2.p1,2018,2018.66666666667,688,850,2038,3576
phs000285.v3.p2,2013,2013.58333333333,5834,6969,753,13556
phs000288.v2.p2,2017,2017.83333333333,1381,1188,0,2569
phs000289.v2.p1,2011,2011.33333333333,1360,1400,5,2765
phs000290.v1.p1,2011,2011.58333333333,16,78,2,96
phs000291.v2.p1,2012,2012.33333333333,214,123,0,337
phs000293.v1.p1,2013,2013.5,755,1318,434,2507
phs000294.v1.p1,2010,2010.58333333333,4620,1422,0,6042
phs000298.v4.p3,2018,2018.41666666667,7740,4938,94,12772
phs000302.v1.p1,2011,2011.58333333333,200,150,0,350
phs000303.v1.p1,2011,2011.75,973,983,111,2067
phs000304.v3.p1,2018,2018.33333333333,458,760,1021,2239
phs000306.v4.p1,2014,2014.25,11286,38,328,11652
phs000308.v1.p1,2010,2010.91666666667,903,1340,104,2347
phs000310.v1.p1,2011,2011.33333333333,28,0,0,28
phs000311.v1.p1,2011,2011.33333333333,8,0,0,8
phs000313.v4.p2,2017,2017.83333333333,845,1232,2613,4690
phs000327.v1.p1,2013,2013.16666666667,58,36,0,94
phs000330.v1.p1,2011,2011.08333333333,14,0,0,14
phs000332.v3.p2,2016,2016.08333333333,29,1888,0,1917
phs000335.v3.p2,2014,2014.5,2734,1627,247,4608
phs000337.v1.p1,2016,2016.16666666667,116,68,0,184
phs000339.v2.p1,2013,2013.08333333333,46,88,0,134
phs000340.v3.p1,2014,2014.25,135,61,0,196
phs000341.v2.p1,2016,2016.83333333333,241,138,3,382
phs000343.v3.p1,2013,2013.16666666667,1375,802,64,2241
phs000344.v1.p1,2011,2011.41666666667,301,595,0,896
phs000345.v1.p1,2011,2011.66666666667,545,483,0,1028
phs000347.v1.p1,2013,2013.5,19,10,0,29
phs000348.v2.p1,2014,2014.91666666667,52,26,331,409
phs000351.v1.p1,2011,2011.33333333333,3661,1248,0,4909
phs000352.v1.p1,2011,2011.75,43,50,0,93
phs000353.v1.p1,2011,2011.58333333333,773,1430,2944,5147
phs000354.v1.p1,2013,2013.41666666667,1,11,0,12
phs000357.v2.p1,2018,2018.66666666667,85,748,0,833
phs000362.v1.p1,2013,2013.58333333333,9,3,0,12
phs000364.v2.p1,2013,2013.66666666667,37,23,1,61
phs000365.v1.p1,2011,2011.58333333333,4,2,1,7
phs000367.v1.p1,2013,2013.58333333333,341,389,5,735
phs000368.v1.p1,2011,2011.75,48,8238,90,8376
phs000369.v1.p1,2012,2012.25,0,216,0,216
phs000370.v2.p1,2014,2014.25,138,46,0,184
phs000371.v2.p1,2016,2016.75,1393,1790,28,3211
phs000372.v1.p1,2014,2014.08333333333,2595,3470,0,6065
phs000373.v1.p1,2017,2017.83333333333,5208,66,0,5274
phs000374.v1.p1,2011,2011.58333333333,8,6,4,18
phs000376.v1.p1,2014,2014.75,23,21,33,77
phs000378.v1.p1,2014,2014.25,459,843,0,1302
phs000380.v1.p1,2012,2012,199,783,0,982
phs000381.v1.p1,2011,2011.91666666667,762,502,0,1264
phs000383.v1.p1,2012,2012.91666666667,87,3914,0,4001
phs000384.v1.p1,2012,2012.41666666667,9,9,0,18
phs000385.v1.p1,2011,2011.83333333333,56,48,0,104
phs000387.v1.p1,2011,2011.91666666667,740,203,0,943
phs000390.v1.p1,2012,2012.25,408,1209,0,1617
phs000391.v1.p1,2012,2012.83333333333,332,334,0,666
phs000394.v1.p1,2012,2012.33333333333,675,369,0,1044
phs000397.v3.p3,2020,2020.58333333333,2326,2828,7327,12481
phs000398.v1.p1,2012,2012.08333333333,234,361,0,595
phs000400.v1.p1,2012,2012.08333333333,5,20,0,25
phs000404.v1.p1,2011,2011.91666666667,1495,2069,151,3715
phs000405.v1.p1,2012,2012.83333333333,6,7,0,13
phs000408.v1.p1,2011,2011.83333333333,180,826,0,1006
phs000409.v1.p1,2012,2012.33333333333,219,87,3,309
phs000413.v2.p1,2012,2012.83333333333,43,42,0,85
phs000418.v2.p1,2014,2014.25,14,2,0,16
phs000419.v1.p1,2012,2012.08333333333,0,1,0,1
phs000421.v1.p1,2013,2013.33333333333,1774,3008,767,5549
phs000422.v1.p1,2013,2013.33333333333,67,124,0,191
phs000424.v8.p2,2019,2019.33333333333,15046,7905,0,22951
phs000428.v2.p2,2017,2017,6933,9575,0,16508
phs000434.v1.p1,2012,2012.66666666667,4,4,0,8
phs000435.v3.p1,2017,2017.08333333333,531,397,31,959
phs000438.v1.p1,2014,2014.25,342,380,0,722
phs000440.v1.p1,2012,2012.16666666667,417,551,407,1375
phs000442.v1.p1,2012,2012.25,53,38,0,91
phs000443.v1.p1,2012,2012.33333333333,144,0,0,144
phs000445.v1.p1,2012,2012.75,18,3,0,21
phs000447.v1.p1,2012,2012.25,624,0,0,624
phs000449.v2.p1,2012,2012.5,115,52,5,172
phs000450.v4.p1,2020,2020.75,252,226,0,478
phs000452.v3.p1,2020,2020.08333333333,448,282,295,1025
phs000454.v1.p1,2013,2013.41666666667,2888,996,0,3884
phs000456.v1.p1,2012,2012.33333333333,1455,1177,134,2766
phs000460.v1.p1,2013,2013.83333333333,553,1129,0,1682
phs000474.v3.p2,2016,2016.25,285,261,10,556
phs000475.v1.p1,2012,2012.25,1,0,0,1
phs000476.v1.p1,2012,2012.25,10,10,0,20
phs000477.v1.p1,2012,2012.25,16,15,0,31
phs000478.v1.p1,2012,2012.33333333333,7,6,0,13
phs000479.v1.p1,2012,2012.58333333333,2,1,0,3
phs000480.v1.p1,2020,2020.5,0,129,238,367
phs000481.v3.p2,2020,2020.5,815,800,0,1615
phs000482.v1.p1,2015,2015.91666666667,350,267,0,617
phs000484.v1.p1,2012,2012.41666666667,5,2,0,7
phs000485.v1.p1,2012,2012.25,4,0,0,4
phs000486.v1.p1,2014,2014.91666666667,3622,6868,2919,13409
phs000488.v2.p1,2016,2016.75,0,0,430,430
phs000490.v1.p1,2018,2018.33333333333,3929,3501,0,7430
phs000492.v3.p2,2018,2018.75,72,91,5,168
phs000494.v1.p1,2012,2012.5,2543,2019,0,4562
phs000497.v3.p2,2016,2016.75,256,165,0,421
phs000500.v1.p1,2012,2012.91666666667,4,4,0,8
phs000504.v2.p2,2013,2013.83333333333,110,74,0,184
phs000507.v2.p2,2018,2018.83333333333,463,810,12,1285
phs000508.v2.p1,2014,2014.25,38,32,0,70
phs000510.v1.p1,2020,2020.83333333333,47,3731,0,3778
phs000511.v1.p1,2012,2012.5,37,11,0,48
phs000512.v1.p1,2012,2012.75,59,38,0,97
phs000516.v2.p1,2015,2015.16666666667,68,50,0,118
phs000517.v3.p1,2015,2015.33333333333,0,3790,0,3790
phs000518.v1.p1,2012,2012.58333333333,7,17,0,24
phs000519.v1.p1,2013,2013.66666666667,2001,2078,0,4079
phs000521.v2.p1,2020,2020.16666666667,0,0,131,131
phs000523.v1.p1,2012,2012.58333333333,0,1799,0,1799
phs000524.v1.p1,2012,2012.91666666667,1986,1612,0,3598
phs000536.v2.p1,2016,2016.08333333333,0,0,96,96
phs000537.v1.p1,2012,2012.75,2,2,0,4
phs000538.v1.p1,2012,2012.83333333333,2,4,0,6
phs000539.v1.p1,2012,2012.83333333333,3,5,0,8
phs000540.v1.p1,2012,2012.83333333333,5,3,0,8
phs000541.v1.p1,2012,2012.83333333333,2,5,0,7
phs000542.v1.p1,2012,2012.75,2,2,0,4
phs000543.v1.p1,2014,2014.75,14,16,0,30
phs000545.v1.p1,2015,2015.41666666667,482,282,0,764
phs000546.v1.p1,2013,2013.5,40,35,0,75
phs000547.v1.p1,2012,2012.75,37,35,3642,3714
phs000549.v1.p1,2012,2012.66666666667,2,10,0,12
phs000550.v1.p1,2013,2013,5,3,1,9
phs000551.v1.p1,2013,2013.91666666667,413,225,0,638
phs000552.v2.p1,2014,2014.25,24,106,0,130
phs000553.v1.p1,2013,2013.41666666667,2,4,1,7
phs000554.v1.p1,2017,2017.66666666667,120,0,0,120
phs000558.v1.p1,2017,2017.16666666667,91,84,0,175
phs000559.v1.p1,2013,2013.91666666667,7878,6600,778,15256
phs000561.v1.p1,2012,2012.83333333333,6,5,0,11
phs000562.v1.p1,2012,2012.91666666667,44,13,16,73
phs000563.v1.p1,2013,2013.41666666667,3,7,0,10
phs000564.v2.p1,2015,2015.5,141,137,0,278
phs000565.v1.p1,2012,2012.91666666667,121,71,0,192
phs000567.v1.p1,2012,2012.91666666667,13,13,0,26
phs000568.v1.p1,2013,2013,16,18,0,34
phs000571.v3.p2,2015,2015.91666666667,4354,3829,0,8183
phs000573.v1.p1,2013,2013.16666666667,67,44,17,128
phs000574.v1.p1,2017,2017.16666666667,0,0,1020,1020
phs000575.v2.p1,2020,2020.08333333333,0,0,390,390
phs000576.v1.p1,2017,2017.33333333333,0,0,245,245
phs000577.v1.p1,2017,2017.91666666667,0,0,542,542
phs000578.v1.p1,2017,2017.75,0,0,95,95
phs000579.v1.p1,2013,2013.83333333333,53,52,0,105
phs000581.v1.p1,2013,2013.41666666667,22,26,0,48
phs000582.v1.p1,2013,2013.33333333333,7,5,0,12
phs000584.v1.p1,2021,2021,925,1310,501,2736
phs000587.v1.p1,2014,2014.25,16,13,0,29
phs000588.v1.p1,2019,2019.5,0,0,194,194
phs000589.v1.p1,2019,2019.41666666667,0,0,138,138
phs000590.v1.p1,2018,2018.58333333333,0,0,71,71
phs000592.v1.p1,2017,2017.5,0,0,341,341
phs000594.v1.p1,2017,2017.41666666667,0,0,9,9
phs000595.v1.p1,2017,2017.5,0,0,617,617
phs000596.v1.p1,2017,2017.5,0,0,124,124
phs000597.v1.p1,2013,2013.83333333333,19,0,0,19
phs000598.v2.p2,2013,2013.75,84,18,198,300
phs000600.v1.p1,2013,2013.83333333333,0,230,0,230
phs000601.v1.p1,2013,2013.66666666667,0,20,0,20
phs000603.v1.p1,2018,2018.16666666667,0,0,17,17
phs000605.v1.p1,2018,2018.16666666667,0,0,111,111
phs000606.v1.p1,2018,2018.16666666667,0,0,1051,1051
phs000607.v3.p2,2018,2018.33333333333,4477,4790,729,9996
phs000614.v1.p1,2013,2013.5,0,2,0,2
phs000615.v1.p1,2014,2014.58333333333,5910,5669,0,11579
phs000616.v2.p2,2015,2015.5,480,477,627,1584
phs000618.v1.p1,2013,2013.75,2046,2304,0,4350
phs000619.v1.p1,2013,2013.58333333333,820,0,0,820
phs000620.v1.p1,2015,2015.16666666667,2824,3273,593,6690
phs000621.v1.p1,2013,2013.5,149,66,0,215
phs000622.v1.p1,2014,2014.5,1674,2061,18,3753
phs000623.v1.p1,2013,2013.58333333333,47,59,0,106
phs000624.v1.p1,2019,2019.41666666667,427,339,0,766
phs000626.v1.p1,2015,2015.58333333333,6,6,0,12
phs000627.v1.p1,2013,2013.66666666667,0,0,174,174
phs000628.v1.p1,2014,2014.75,0,5,2,7
phs000630.v1.p1,2014,2014.25,466,480,105,1051
phs000631.v1.p1,2013,2013.91666666667,2176,1595,1,3772
phs000632.v1.p1,2014,2014.08333333333,12,7,13,32
phs000633.v1.p1,2013,2013.91666666667,0,0,103,103
phs000634.v1.p1,2015,2015.41666666667,801,1519,0,2320
phs000636.v1.p1,2013,2013.58333333333,15,29,0,44
phs000637.v1.p1,2013,2013.75,650,617,0,1267
phs000638.v1.p1,2013,2013.83333333333,1341,1146,0,2487
phs000639.v1.p1,2015,2015.83333333333,465,302,38,805
phs000640.v9.p1,2020,2020.25,0,141,0,141
phs000641.v1.p1,2013,2013.58333333333,10,5,0,15
phs000644.v1.p1,2013,2013.58333333333,0,20,0,20
phs000645.v5.p1,2019,2019.16666666667,0,67,206,273
phs000646.v1.p1,2013,2013.58333333333,4,2,0,6
phs000647.v1.p1,2013,2013.58333333333,13,0,0,13
phs000648.v1.p1,2015,2015.41666666667,4717,3641,19,8377
phs000649.v2.p2,2021,2021,517,523,0,1040
phs000652.v1.p1,2013,2013.66666666667,4499,2573,0,7072
phs000656.v1.p1,2013,2013.58333333333,56,49,0,105
phs000657.v1.p1,2013,2013.58333333333,16,9,6,31
phs000658.v1.p1,2014,2014,493,945,3,1441
phs000659.v1.p1,2013,2013.75,0,0,158,158
phs000662.v1.p1,2013,2013.91666666667,299,342,0,641
phs000663.v3.p3,2021,2021.58333333333,673,882,24,1579
phs000664.v1.p1,2013,2013.75,17,17,0,34
phs000666.v1.p1,2014,2014,937,1617,0,2554
phs000669.v1.p1,2016,2016.75,55,7068,4,7127
phs000670.v1.p1,2014,2014,194,335,0,529
phs000671.v1.p1,2013,2013.75,18,2,0,20
phs000673.v4.p1,2020,2020.16666666667,2213,1912,0,4125
phs000674.v1.p1,2014,2014,32008,46478,2429,80915
phs000676.v2.p2,2017,2017.91666666667,0,193,39,232
phs000677.v1.p1,2013,2013.91666666667,0,0,5427,5427
phs000678.v1.p1,2014,2014.33333333333,629,2863,2530,6022
phs000679.v1.p1,2014,2014.25,0,1001,0,1001
phs000681.v2.p1,2019,2019.33333333333,859,1676,0,2535
phs000682.v1.p1,2013,2013.83333333333,103,59,0,162
phs000689.v1.p1,2014,2014.08333333333,0,0,55,55
phs000690.v1.p1,2013,2013.91666666667,15,45,0,60
phs000691.v2.p1,2015,2015.16666666667,291,197,163,651
phs000694.v3.p2,2017,2017.58333333333,0,0,39,39
phs000697.v1.p1,2018,2018.16666666667,0,0,39,39
phs000698.v1.p1,2018,2018.16666666667,0,0,51,51
phs000699.v1.p1,2014,2014.91666666667,58,58,0,116
phs000700.v2.p1,2019,2019.83333333333,14,8,0,22
phs000701.v1.p1,2017,2017.41666666667,0,0,91,91
phs000703.v1.p1,2014,2014.5,1909,1397,0,3306
phs000706.v1.p1,2014,2014.08333333333,0,5,0,5
phs000707.v2.p1,2017,2017.16666666667,10,8,0,18
phs000708.v1.p1,2014,2014.5,90,109,0,199
phs000709.v1.p1,2014,2014.25,0,0,29,29
phs000710.v1.p1,2015,2015.25,44,52,12,108
phs000712.v1.p1,2015,2015.66666666667,310,223,106,639
phs000713.v1.p1,2014,2014.75,328,380,0,708
phs000714.v1.p1,2014,2014.5,0,0,2925,2925
phs000716.v1.p1,2014,2014.08333333333,0,9178,0,9178
phs000718.v1.p1,2015,2015.41666666667,1114,1175,176,2465
phs000719.v1.p1,2014,2014.25,14,88,0,102
phs000720.v4.p1,2021,2021.16666666667,586,361,7,954
phs000722.v2.p2,2017,2017.33333333333,539,830,0,1369
phs000723.v1.p1,2020,2020.5,0,29,0,29
phs000725.v2.p1,2017,2017,144,99,5,248
phs000726.v1.p1,2014,2014.75,546,426,0,972
phs000727.v1.p1,2014,2014.75,215,180,0,395
phs000729.v1.p1,2014,2014.25,8,10,0,18
phs000730.v1.p1,2015,2015.83333333333,103,189,0,292
phs000732.v1.p1,2014,2014.25,12,8,0,20
phs000733.v1.p1,2014,2014.5,4141,40,0,4181
phs000734.v1.p1,2014,2014.25,423,294,0,717
phs000735.v1.p1,2014,2014.25,0,0,48,48
phs000737.v1.p1,2015,2015,565,750,684,1999
phs000739.v1.p1,2014,2014.33333333333,5,2,0,7
phs000740.v1.p1,2014,2014.25,33,7,0,40
phs000741.v2.p1,2016,2016.83333333333,458,510,7576,8544
phs000742.v1.p1,2018,2018.5,0,0,7871,7871
phs000743.v1.p1,2017,2017,982,0,1134,2116
phs000745.v1.p1,2014,2014.33333333333,10,10,0,20
phs000747.v2.p1,2017,2017.66666666667,40,0,0,40
phs000748.v7.p4,2019,2019.08333333333,3055,2025,38,5118
phs000750.v1.p1,2014,2014.66666666667,112,138,20,270
phs000751.v1.p1,2014,2014.33333333333,1090,526,0,1616
phs000753.v1.p1,2014,2014.41666666667,1302,988,0,2290
phs000756.v1.p1,2018,2018.91666666667,4392,4943,0,9335
phs000757.v1.p1,2014,2014.41666666667,33,21,73,127
phs000758.v1.p1,2014,2014.58333333333,10,11,7,28
phs000759.v1.p1,2014,2014.41666666667,13,12,0,25
phs000760.v1.p1,2015,2015.08333333333,335,251,0,586
phs000761.v1.p1,2015,2015.16666666667,1298,1737,411,3446
phs000763.v1.p1,2015,2015,987,1071,1476,3534
phs000766.v1.p1,2015,2015.16666666667,2383,2371,90,4844
phs000767.v1.p1,2014,2014.5,132,45,0,177
phs000768.v2.p1,2016,2016.91666666667,33,23,43,99
phs000770.v1.p1,2016,2016.58333333333,0,29,0,29
phs000771.v2.p1,2017,2017.75,167,65,0,232
phs000772.v1.p1,2014,2014.58333333333,24,11,813,848
phs000774.v2.p1,2017,2017.91666666667,5783,6363,3451,15597
phs000775.v1.p1,2014,2014.5,497,362,0,859
phs000776.v1.p1,2014,2014.58333333333,7,26,0,33
phs000777.v1.p1,2014,2014.58333333333,4,6,0,10
phs000778.v1.p1,2014,2014.5,1,4,0,5
phs000779.v1.p1,2014,2014.5,1457,1445,0,2902
phs000782.v1.p1,2017,2017.75,39,7,0,46
phs000783.v2.p1,2018,2018.16666666667,267,201,3,471
phs000784.v3.p1,2019,2019.83333333333,518,482,776,1776
phs000785.v1.p1,2019,2019.91666666667,0,0,198,198
phs000787.v1.p1,2014,2014.66666666667,150,60,0,210
phs000788.v2.p3,2018,2018.08333333333,5737,8463,0,14200
phs000790.v1.p1,2014,2014.66666666667,0,0,12,12
phs000791.v2.p1,2020,2020,125,113,21,259
phs000792.v1.p1,2014,2014.66666666667,41,5,0,46
phs000794.v1.p1,2014,2014.91666666667,23,19,0,42
phs000795.v1.p1,2014,2014.66666666667,0,6,16,22
phs000796.v1.p1,2016,2016.33333333333,1152,2087,0,3239
phs000797.v1.p1,2014,2014.66666666667,4,1,0,5
phs000798.v1.p1,2014,2014.66666666667,0,11,33,44
phs000799.v1.p1,2015,2015.66666666667,0,5152,0,5152
phs000801.v2.p1,2016,2016.66666666667,5221,5570,0,10791
phs000803.v2.p1,2017,2017.58333333333,0,22,0,22
phs000807.v1.p1,2015,2015,0,1914,0,1914
phs000809.v1.p1,2014,2014.83333333333,6,2,0,8
phs000811.v1.p1,2015,2015,0,0,16,16
phs000812.v1.p1,2014,2014.75,503,187,11811,12501
phs000813.v1.p1,2015,2015.75,1228,1855,15,3098
phs000814.v1.p1,2016,2016,3187,405,0,3592
phs000815.v2.p1,2020,2020.08333333333,424,575,396,1395
phs000816.v2.p1,2017,2017.25,232,279,0,511
phs000817.v1.p1,2015,2015,48,208,8,264
phs000820.v1.p1,2015,2015.83333333333,410,133,0,543
phs000821.v1.p1,2014,2014.83333333333,0,0,1366,1366
phs000822.v1.p1,2016,2016.16666666667,0,466,0,466
phs000823.v1.p1,2016,2016.33333333333,178,209,0,387
phs000824.v1.p1,2015,2015.83333333333,37,63,0,100
phs000825.v1.p1,2014,2014.83333333333,0,0,2,2
phs000826.v1.p1,2014,2014.83333333333,0,0,1579,1579
phs000827.v3.p1,2016,2016.83333333333,241,351,0,592
phs000828.v1.p1,2015,2015.66666666667,0,0,5,5
phs000830.v1.p1,2015,2015.58333333333,22,4,0,26
phs000832.v1.p1,2015,2015.16666666667,199,182,0,381
phs000833.v7.p1,2017,2017.83333333333,1822,4408,3040,9270
phs000837.v1.p1,2015,2015,3,3,0,6
phs000838.v1.p1,2015,2015.41666666667,932,0,0,932
phs000839.v1.p1,2014,2014.91666666667,2,3,140,145
phs000840.v1.p1,2016,2016.5,3434,3531,0,6965
phs000841.v1.p1,2014,2014.91666666667,0,180,0,180
phs000842.v2.p1,2019,2019.16666666667,994,586,248,1828
phs000846.v1.p1,2015,2015,0,0,27,27
phs000847.v2.p1,2016,2016.91666666667,873,1269,350,2492
phs000848.v1.p1,2014,2014.91666666667,1,2,0,3
phs000851.v1.p1,2015,2015.66666666667,0,5367,0,5367
phs000852.v1.p1,2017,2017.5,419,365,0,784
phs000855.v1.p1,2015,2015.16666666667,39,9,0,48
phs000856.v1.p1,2015,2015,0,2,0,2
phs000857.v1.p1,2015,2015.08333333333,0,50,0,50
phs000858.v1.p1,2015,2015.66666666667,2,5,0,7
phs000862.v1.p1,2018,2018.25,0,0,5,5
phs000863.v1.p1,2015,2015.41666666667,358,292,0,650
phs000864.v1.p1,2015,2015.33333333333,3976,16,6,3998
phs000866.v1.p1,2015,2015.16666666667,45,42,0,87
phs000867.v1.p1,2015,2015.08333333333,2182,1746,0,3928
phs000868.v1.p1,2015,2015.16666666667,0,0,29,29
phs000869.v1.p1,2015,2015.16666666667,5550,1379,2,6931
phs000870.v1.p1,2015,2015.75,57,0,0,57
phs000871.v1.p1,2017,2017.33333333333,32,34,0,66
phs000872.v1.p1,2015,2015.16666666667,18,6,0,24
phs000873.v1.p1,2015,2015.16666666667,2,9,4,15
phs000874.v1.p1,2015,2015.25,498,452,0,950
phs000876.v2.p1,2020,2020.16666666667,6682,5533,51,12266
phs000879.v1.p1,2015,2015.75,30,30,0,60
phs000882.v1.p1,2016,2016.58333333333,7639,0,0,7639
phs000883.v1.p1,2016,2016,1331,723,0,2054
phs000885.v1.p1,2015,2015.16666666667,84,16,5,105
phs000886.v1.p1,2016,2016.33333333333,30,44,0,74
phs000892.v2.p2,2015,2015.66666666667,24,178,0,202
phs000893.v1.p1,2016,2016.66666666667,0,299,8323,8622
phs000894.v1.p1,2015,2015.33333333333,320,235,0,555
phs000895.v1.p1,2016,2016.25,176,144,0,320
phs000896.v1.p1,2015,2015.83333333333,30,42,0,72
phs000897.v1.p1,2017,2017.25,0,0,142,142
phs000898.v1.p1,2015,2015.33333333333,0,2,0,2
phs000900.v1.p1,2015,2015.25,0,0,75,75
phs000901.v1.p1,2015,2015.41666666667,44,13,0,57
phs000902.v1.p1,2016,2016,607,177,0,784
phs000903.v1.p1,2015,2015.75,1149,1464,474,3087
phs000904.v1.p1,2018,2018,4,4,6,14
phs000907.v1.p1,2016,2016.83333333333,2,11,0,13
phs000909.v1.p1,2016,2016,300,0,0,300
phs000910.v1.p1,2015,2015.58333333333,4063,3942,0,8005
phs000911.v1.p1,2016,2016.33333333333,8608,8852,1387,18847
phs000912.v1.p1,2018,2018,0,1165,0,1165
phs000914.v1.p1,2016,2016.25,1297,1926,384,3607
phs000915.v2.p2,2018,2018.83333333333,763,0,0,763
phs000916.v1.p1,2016,2016.5,516,283,0,799
phs000917.v1.p1,2016,2016,5982,1309,7,7298
phs000920.v5.p3,2021,2021.75,2016,2021,922,4959
phs000922.v2.p1,2021,2021.33333333333,518,168,2,688
phs000923.v1.p1,2016,2016.58333333333,141,0,0,141
phs000924.v4.p1,2019,2019.75,591,1091,170,1852
phs000925.v1.p1,2017,2017.16666666667,5225,8324,334,13883
phs000926.v1.p1,2015,2015.58333333333,3,1,0,4
phs000927.v1.p1,2017,2017.25,71,131,0,202
phs000928.v1.p1,2016,2016,9,23,0,32
phs000929.v1.p1,2018,2018.33333333333,32,7335,2,7369
phs000932.v1.p1,2016,2016.08333333333,8,0,0,8
phs000933.v2.p1,2018,2018.16666666667,293,212,0,505
phs000934.v1.p1,2015,2015.58333333333,0,0,1291,1291
phs000935.v1.p1,2016,2016.83333333333,93,66,0,159
phs000936.v1.p1,2015,2015.83333333333,3623,2240,7,5870
phs000938.v1.p1,2015,2015.5,0,0,4,4
phs000939.v2.p1,2017,2017.58333333333,13,7,0,20
phs000941.v1.p1,2015,2015.58333333333,0,0,39,39
phs000942.v1.p1,2016,2016.16666666667,26,232,0,258
phs000944.v1.p1,2016,2016.08333333333,2048,2881,2,4931
phs000946.v5.p1,2021,2021.33333333333,21,53,6,80
phs000947.v1.p1,2015,2015.5,0,325,0,325
phs000948.v1.p1,2015,2015.58333333333,684,1284,0,1968
phs000949.v1.p1,2016,2016.08333333333,1399,1929,12,3340
phs000950.v1.p1,2017,2017.91666666667,0,129,0,129
phs000952.v1.p1,2016,2016.16666666667,1539,1333,1012,3884
phs000953.v1.p1,2015,2015.66666666667,0,0,218,218
phs000954.v4.p2,2021,2021.33333333333,579,710,3,1292
phs000955.v1.p1,2016,2016.41666666667,1744,2385,0,4129
phs000956.v5.p1,2021,2021.33333333333,559,552,1081,2192
phs000957.v1.p1,2015,2015.5,3625,5582,5,9212
phs000958.v1.p1,2015,2015.58333333333,96,104,0,200
phs000959.v1.p1,2019,2019.91666666667,1343,194,0,1537
phs000960.v2.p1,2020,2020.08333333333,0,0,63,63
phs000962.v1.p1,2017,2017.75,228,159,144,531
phs000963.v1.p1,2016,2016.33333333333,3771,2119,0,5890
phs000966.v2.p2,2021,2021.58333333333,294,380,1137,1811
phs000967.v1.p1,2015,2015.66666666667,0,32,0,32
phs000968.v2.p1,2020,2020.66666666667,208,0,0,208
phs000969.v1.p1,2015,2015.75,2,2,0,4
phs000970.v1.p1,2015,2015.91666666667,0,17,0,17
phs000971.v3.p1,2021,2021.41666666667,726,908,0,1634
phs000972.v5.p1,2021,2021.33333333333,535,807,0,1342
phs000973.v1.p1,2016,2016.83333333333,46,19,0,65
phs000974.v4.p3,2019,2019.66666666667,1906,2261,0,4167
phs000975.v1.p1,2015,2015.83333333333,0,0,794,794
phs000976.v2.p1,2020,2020.83333333333,1586,1774,16716,20076
phs000977.v1.p1,2015,2015.58333333333,0,2,138,140
phs000978.v1.p1,2015,2015.58333333333,0,0,2,2
phs000979.v3.p2,2019,2019.66666666667,2467,1321,0,3788
phs000980.v1.p1,2015,2015.83333333333,32,36,0,68
phs000982.v1.p1,2015,2015.66666666667,1357,1488,2,2847
phs000984.v1.p1,2016,2016.66666666667,98,110,2,210
phs000985.v1.p1,2015,2015.83333333333,942,0,0,942
phs000988.v5.p1,2021,2021.66666666667,2337,2235,413,4985
phs000989.v4.p1,2021,2021,0,0,7811,7811
phs000991.v1.p1,2016,2016,1116,1136,0,2252
phs000993.v5.p2,2021,2021.33333333333,464,247,0,711
phs000994.v1.p1,2015,2015.83333333333,12,7,65,84
phs000996.v2.p1,2019,2019.75,698,687,0,1385
phs000997.v5.p2,2021,2021.33333333333,118,55,0,173
phs000998.v2.p1,2020,2020.58333333333,21,27,0,48
phs000999.v3.p1,2019,2019.83333333333,130,112,0,242
phs001000.v1.p1,2016,2016.16666666667,1973,349,0,2322
phs001001.v1.p1,2018,2018.08333333333,761,188,448,1397
phs001002.v1.p1,2015,2015.75,761,0,0,761
phs001003.v2.p1,2021,2021.16666666667,259,419,0,678
phs001005.v2.p1,2019,2019.83333333333,18,7,6,31
phs001006.v1.p1,2018,2018.41666666667,0,94,0,94
phs001007.v1.p1,2015,2015.83333333333,53,12,0,65
phs001008.v1.p1,2015,2015.83333333333,419,605,877,1901
phs001009.v1.p1,2016,2016.16666666667,73,105,4,182
phs001011.v2.p1,2020,2020.5,936,635,0,1571
phs001012.v1.p1,2016,2016.41666666667,549,628,953,2130
phs001013.v3.p2,2017,2017.83333333333,606,408,190,1204
phs001014.v1.p1,2016,2016.08333333333,72,101,0,173
phs001015.v1.p1,2016,2016.66666666667,24,56,0,80
phs001016.v1.p1,2016,2016,44,0,92,136
phs001018.v1.p1,2021,2021.08333333333,0,0,22,22
phs001021.v1.p1,2016,2016.08333333333,136,274,0,410
phs001022.v1.p1,2017,2017.58333333333,399,94,6,499
phs001023.v1.p1,2016,2016.33333333333,601,0,0,601
phs001024.v5.p1,2021,2021.33333333333,84,44,0,128
phs001026.v1.p1,2015,2015.83333333333,134,116,0,250
phs001027.v4.p1,2021,2021.41666666667,636,325,0,961
phs001028.v1.p1,2016,2016,0,10,0,10
phs001030.v1.p1,2017,2017.33333333333,246,272,0,518
phs001032.v6.p2,2021,2021.33333333333,826,308,0,1134
phs001033.v1.p1,2016,2016.66666666667,279,257,1529,2065
phs001034.v1.p1,2015,2015.91666666667,0,0,4141,4141
phs001036.v1.p1,2017,2017.08333333333,70,39,0,109
phs001037.v1.p1,2016,2016.83333333333,3570,3442,13190,20202
phs001038.v1.p1,2016,2016.08333333333,9,11,0,20
phs001040.v5.p1,2021,2021.33333333333,0,117,1,118
phs001041.v1.p1,2016,2016.41666666667,156,100,0,256
phs001043.v1.p1,2016,2016.33333333333,0,4658,0,4658
phs001044.v1.p1,2016,2016.66666666667,0,35,0,35
phs001045.v1.p1,2019,2019.5,169,154,0,323
phs001046.v1.p1,2018,2018.41666666667,360,555,0,915
phs001048.v2.p1,2019,2019.25,1214,916,0,2130
phs001049.v1.p1,2018,2018.58333333333,57,48,0,105
phs001050.v1.p1,2016,2016,0,354,0,354
phs001052.v2.p1,2020,2020.83333333333,82,39,0,121
phs001053.v1.p1,2017,2017.91666666667,166,232,1260,1658
phs001055.v1.p1,2017,2017.58333333333,413,404,0,817
phs001057.v1.p1,2016,2016.08333333333,894,99,0,993
phs001058.v1.p1,2016,2016,306,197,0,503
phs001063.v1.p1,2016,2016.33333333333,0,12,0,12
phs001064.v1.p1,2018,2018.08333333333,6,6,0,12
phs001065.v1.p1,2016,2016.33333333333,0,0,609,609
phs001066.v1.p1,2016,2016.08333333333,23,0,0,23
phs001067.v1.p1,2016,2016.08333333333,4,2,0,6
phs001071.v1.p1,2017,2017.66666666667,21,16,13,50
phs001072.v1.p1,2016,2016.16666666667,131,48,0,179
phs001073.v2.p1,2020,2020.91666666667,46,78,0,124
phs001074.v1.p1,2016,2016.16666666667,205,235,164,604
phs001076.v1.p1,2017,2017.25,2379,2104,146,4629
phs001079.v2.p1,2017,2017.58333333333,0,0,66,66
phs001080.v1.p1,2016,2016.25,62,41,0,103
phs001082.v1.p1,2017,2017.08333333333,111,86,6,203
phs001083.v1.p1,2016,2016.16666666667,0,0,99,99
phs001084.v1.p1,2016,2016.16666666667,36,40,0,76
phs001085.v1.p1,2016,2016.5,0,0,35,35
phs001087.v3.p1,2020,2020.66666666667,244,91,0,335
phs001088.v1.p1,2017,2017.5,0,2392,0,2392
phs001090.v1.p1,2019,2019.33333333333,1203,2122,1607,4932
phs001091.v1.p1,2017,2017.33333333333,12,7,0,19
phs001095.v1.p1,2016,2016.66666666667,427,440,0,867
phs001097.v1.p1,2016,2016.58333333333,1072,1154,0,2226
phs001105.v1.p1,2017,2017.66666666667,20,0,0,20
phs001106.v1.p1,2018,2018.75,140,171,69,380
phs001107.v1.p1,2016,2016.33333333333,23,28,0,51
phs001108.v1.p1,2018,2018.16666666667,0,0,46,46
phs001110.v3.p1,2020,2020.66666666667,829,743,786,2358
phs001112.v1.p1,2016,2016.33333333333,0,33,0,33
phs001115.v1.p1,2016,2016.33333333333,4,2,0,6
phs001120.v2.p2,2021,2021.08333333333,12947,0,0,12947
phs001121.v1.p1,2017,2017.16666666667,3,0,0,3
phs001122.v1.p1,2021,2021.16666666667,252,184,360,796
phs001123.v2.p1,2019,2019.66666666667,5947,8558,2690,17195
phs001124.v1.p1,2019,2019.5,54,257,22,333
phs001130.v1.p1,2018,2018.66666666667,96,151,348,595
phs001133.v1.p1,2020,2020.66666666667,0,16783,0,16783
phs001134.v1.p1,2021,2021.33333333333,1122,3493,2,4617
phs001135.v2.p1,2020,2020.16666666667,685,293,9,987
phs001139.v1.p1,2017,2017.08333333333,0,0,94,94
phs001140.v1.p1,2021,2021.08333333333,0,0,5731,5731
phs001141.v1.p1,2017,2017,246,0,0,246
phs001146.v1.p1,2016,2016.41666666667,0,53,0,53
phs001151.v1.p1,2016,2016.41666666667,12,17,0,29
phs001152.v1.p1,2016,2016.58333333333,0,28,0,28
phs001153.v1.p1,2016,2016.58333333333,0,38,0,38
phs001154.v1.p1,2018,2018.66666666667,7278,3340,0,10618
phs001156.v2.p1,2017,2017.75,137,159,0,296
phs001157.v1.p1,2017,2017.25,4534,4895,0,9429
phs001159.v1.p1,2016,2016.41666666667,4,0,0,4
phs001163.v1.p1,2021,2021.25,177,163,8,348
phs001164.v1.p1,2019,2019.16666666667,22,19,0,41
phs001165.v1.p1,2018,2018.33333333333,452,440,8,900
phs001169.v2.p1,2020,2020.41666666667,921,193,0,1114
phs001173.v1.p1,2017,2017.66666666667,2521,812,0,3333
phs001174.v1.p1,2017,2017.25,0,98,0,98
phs001175.v2.p2,2019,2019,0,0,366,366
phs001176.v3.p1,2019,2019.75,921,628,0,1549
phs001177.v2.p1,2019,2019.83333333333,1541,1954,0,3495
phs001178.v1.p1,2018,2018.83333333333,149,150,1,300
phs001179.v1.p1,2017,2017.5,0,0,18004,18004
phs001180.v2.p1,2020,2020.41666666667,2179,2248,35,4462
phs001181.v1.p1,2017,2017.16666666667,0,16,0,16
phs001182.v2.p1,2020,2020.66666666667,41,51,0,92
phs001185.v1.p1,2016,2016.66666666667,931,0,0,931
phs001187.v1.p1,2017,2017.08333333333,0,0,75,75
phs001188.v2.p1,2020,2020,232,190,0,422
phs001189.v4.p1,2021,2021.41666666667,294,70,2,366
phs001191.v1.p1,2017,2017.16666666667,312,588,0,900
phs001192.v1.p1,2016,2016.58333333333,0,0,4,4
phs001194.v3.p2,2020,2020.5,9627,8496,818,18941
phs001196.v1.p1,2018,2018.25,2788,2408,0,5196
phs001198.v1.p1,2018,2018.33333333333,49,44,16,109
phs001199.v1.p1,2016,2016.58333333333,276,118,0,394
phs001200.v1.p1,2016,2016.83333333333,14,12,0,26
phs001201.v2.p1,2019,2019.58333333333,661,799,0,1460
phs001202.v1.p1,2017,2017.5,7506,2713,0,10219
phs001203.v1.p1,2016,2016.91666666667,2530,1046,1,3577
phs001205.v1.p1,2016,2016.75,155,0,317,472
phs001206.v1.p1,2018,2018.08333333333,6,6,0,12
phs001208.v2.p1,2019,2019.58333333333,2523,2892,3087,8502
phs001209.v1.p1,2017,2017.58333333333,17,63,9,89
phs001212.v1.p1,2017,2017.75,50,35,6,91
phs001214.v1.p1,2016,2016.75,13,0,0,13
phs001216.v1.p1,2016,2016.66666666667,241,206,0,447
phs001217.v3.p1,2021,2021.41666666667,973,877,1489,3339
phs001218.v3.p1,2021,2021.41666666667,734,1044,1427,3205
phs001219.v1.p1,2018,2018.25,236,239,0,475
phs001221.v1.p1,2020,2020.08333333333,34736,0,669,35405
phs001223.v1.p1,2016,2016.75,57,0,0,57
phs001224.v1.p1,2016,2016.83333333333,9,8,0,17
phs001226.v1.p1,2017,2017.08333333333,0,0,64,64
phs001229.v1.p1,2017,2017.41666666667,66,62,0,128
phs001231.v2.p1,2018,2018.25,100,48,0,148
phs001232.v4.p2,2021,2021.58333333333,5164,5476,1384,12024
phs001233.v1.p1,2016,2016.83333333333,3,3,0,6
phs001235.v1.p1,2019,2019.16666666667,2,3,0,5
phs001237.v2.p1,2019,2019.75,0,11600,45,11645
phs001238.v2.p1,2018,2018.41666666667,1137,1900,3140,6177
phs001241.v1.p1,2017,2017.83333333333,14,22,0,36
phs001242.v1.p1,2017,2017,0,0,1,1
phs001243.v1.p1,2016,2016.83333333333,0,0,54,54
phs001244.v1.p1,2017,2017,145,58,8,211
phs001245.v1.p1,2018,2018,3,2,2,7
phs001246.v1.p1,2017,2017,12,14,7,33
phs001247.v1.p1,2018,2018.58333333333,451,448,0,899
phs001248.v1.p1,2017,2017.16666666667,42,52,0,94
phs001249.v1.p1,2017,2017.16666666667,0,0,110,110
phs001251.v1.p1,2016,2016.83333333333,2,2,0,4
phs001252.v1.p1,2017,2017.33333333333,1367,792,587,2746
phs001253.v1.p1,2017,2017.08333333333,486,77,0,563
phs001255.v1.p1,2017,2017,0,0,8,8
phs001256.v2.p1,2017,2017.33333333333,50,18,95,163
phs001257.v2.p1,2017,2017.16666666667,20,12,12,44
phs001258.v2.p1,2019,2019.91666666667,676,0,0,676
phs001260.v1.p1,2017,2017,24,19,0,43
phs001261.v1.p1,2017,2017.66666666667,0,17,0,17
phs001264.v1.p1,2018,2018.33333333333,0,4,0,4
phs001265.v1.p1,2017,2017.41666666667,0,58908,1107,60015
phs001266.v2.p1,2020,2020.16666666667,384,261,721,1366
phs001270.v1.p1,2017,2017.75,3,7,4,14
phs001275.v1.p1,2017,2017.41666666667,70,0,0,70
phs001276.v1.p1,2017,2017.08333333333,26,0,78,104
phs001277.v1.p1,2017,2017.75,75,0,0,75
phs001278.v1.p1,2017,2017.41666666667,0,0,198,198
phs001279.v1.p1,2017,2017.91666666667,0,0,39,39
phs001281.v2.p1,2019,2019.08333333333,0,0,40,40
phs001282.v2.p1,2020,2020,29,8,2,39
phs001286.v1.p1,2019,2019.16666666667,10463,2691,0,13154
phs001287.v9.p5,2021,2021.08333333333,941,818,3235,4994
phs001288.v1.p1,2017,2017.75,0,0,264,264
phs001289.v1.p1,2018,2018.25,0,0,29,29
phs001290.v1.p1,2020,2020.5,3297,2933,141,6371
phs001291.v1.p1,2018,2018,0,210,24,234
phs001292.v2.p1,2019,2019.41666666667,0,0,808,808
phs001295.v2.p1,2019,2019.25,0,0,293,293
phs001296.v2.p1,2019,2019.33333333333,0,0,41,41
phs001297.v1.p1,2017,2017.41666666667,369,352,180,901
phs001300.v1.p1,2018,2018,1460,786,0,2246
phs001304.v1.p1,2018,2018.75,591,953,10,1554
phs001305.v1.p1,2017,2017.83333333333,0,0,12,12
phs001307.v1.p1,2021,2021.16666666667,1400,0,0,1400
phs001309.v1.p1,2018,2018.33333333333,0,0,159,159
phs001310.v1.p1,2017,2017.66666666667,0,0,56,56
phs001311.v1.p1,2018,2018.33333333333,0,0,62,62
phs001312.v1.p1,2017,2017.91666666667,2058,3160,0,5218
phs001313.v1.p1,2018,2018.33333333333,0,0,17,17
phs001314.v1.p1,2018,2018.33333333333,0,0,17,17
phs001315.v1.p1,2018,2018.33333333333,4584,4320,197,9101
phs001316.v1.p1,2018,2018.33333333333,0,0,3,3
phs001318.v1.p1,2018,2018.33333333333,0,0,50,50
phs001320.v1.p1,2017,2017.33333333333,0,0,59,59
phs001321.v1.p1,2017,2017.58333333333,0,11841,0,11841
phs001322.v2.p1,2018,2018.25,19,7,0,26
phs001325.v3.p1,2019,2019.83333333333,127,164,112,403
phs001326.v1.p1,2018,2018.25,0,0,748,748
phs001327.v2.p1,2021,2021.33333333333,5497,5866,24538,35901
phs001328.v1.p1,2017,2017.33333333333,0,0,93,93
phs001329.v2.p1,2019,2019.33333333333,0,0,5,5
phs001330.v2.p1,2019,2019.83333333333,0,0,40,40
phs001331.v2.p1,2019,2019.58333333333,0,0,1023,1023
phs001332.v2.p1,2019,2019.83333333333,0,0,354,354
phs001333.v2.p1,2019,2019.58333333333,0,0,21,21
phs001336.v1.p1,2017,2017.16666666667,0,1,0,1
phs001337.v1.p1,2019,2019.83333333333,0,0,48447,48447
phs001338.v1.p1,2017,2017.41666666667,0,0,27,27
phs001340.v1.p1,2019,2019.41666666667,0,0,24,24
phs001341.v1.p1,2017,2017.83333333333,106,158,2,266
phs001342.v1.p1,2018,2018.41666666667,30,16,0,46
phs001343.v1.p1,2017,2017.33333333333,1,0,124,125
phs001344.v1.p1,2017,2017.25,0,52,0,52
phs001345.v3.p1,2021,2021.41666666667,382,882,590,1854
phs001346.v1.p1,2019,2019.16666666667,73,146,0,219
phs001347.v2.p1,2017,2017.91666666667,1619,1319,78,3016
phs001348.v2.p1,2017,2017.66666666667,24,21,0,45
phs001349.v2.p1,2021,2021.25,10093,515,0,10608
phs001351.v1.p1,2019,2019.75,0,0,2,2
phs001352.v1.p1,2017,2017.75,0,0,30,30
phs001357.v1.p1,2017,2017.5,228,196,0,424
phs001358.v1.p1,2017,2017.33333333333,1092,1230,19,2341
phs001359.v3.p1,2021,2021.41666666667,506,558,6,1070
phs001360.v1.p1,2020,2020.33333333333,486,1811,0,2297
phs001362.v1.p1,2017,2017.33333333333,0,3,0,3
phs001363.v1.p1,2017,2017.58333333333,63,44,31,138
phs001364.v1.p1,2018,2018.08333333333,523,619,937,2079
phs001365.v1.p1,2017,2017.41666666667,0,920,0,920
phs001366.v1.p1,2017,2017.91666666667,9,26,0,35
phs001367.v1.p1,2018,2018.5,9474,10474,1556,21504
phs001368.v3.p2,2021,2021.58333333333,1473,2064,0,3537
phs001370.v1.p1,2017,2017.5,57,42,45,144
phs001371.v1.p1,2017,2017.41666666667,0,0,20,20
phs001372.v1.p1,2017,2017.75,912,655,0,1567
phs001373.v2.p2,2019,2019.75,32,20,0,52
phs001374.v2.p1,2021,2021.16666666667,0,0,170,170
phs001376.v1.p1,2017,2017.41666666667,4,5,0,9
phs001377.v1.p1,2017,2017.66666666667,321,44,0,365
phs001378.v1.p1,2019,2019.33333333333,4,2,4,10
phs001380.v1.p1,2019,2019.75,2454,983,0,3437
phs001381.v1.p1,2017,2017.41666666667,352,315,0,667
phs001383.v1.p1,2021,2021,129,138,317,584
phs001384.v1.p1,2017,2017.58333333333,174,94,0,268
phs001385.v1.p1,2017,2017.91666666667,24,180,0,204
phs001386.v2.p1,2020,2020,0,195,3,198
phs001387.v3.p1,2021,2021.41666666667,1158,1185,3138,5481
phs001388.v2.p1,2021,2021.16666666667,2460,4132,0,6592
phs001389.v1.p1,2017,2017.41666666667,54,55,0,109
phs001391.v1.p1,2017,2017.83333333333,1950,0,0,1950
phs001392.v1.p1,2017,2017.66666666667,0,0,30,30
phs001394.v1.p1,2017,2017.66666666667,314,451,405,1170
phs001395.v2.p1,2021,2021.41666666667,3225,4515,0,7740
phs001396.v1.p1,2018,2018.33333333333,749,821,3,1573
phs001397.v1.p1,2017,2017.75,352,469,1256,2077
phs001399.v1.p1,2017,2017.58333333333,69,0,0,69
phs001400.v1.p1,2017,2017.83333333333,6,5,0,11
phs001402.v3.p1,2021,2021.41666666667,795,739,1,1535
phs001403.v1.p1,2017,2017.66666666667,16,28,0,44
phs001404.v1.p1,2020,2020.91666666667,89,344,0,433
phs001405.v1.p1,2017,2017.91666666667,0,28,0,28
phs001406.v1.p1,2019,2019.75,1170,1785,2244,5199
phs001407.v1.p1,2017,2017.58333333333,4,42,0,46
phs001409.v1.p1,2019,2019.33333333333,0,4594,0,4594
phs001411.v1.p1,2018,2018.25,0,0,6385,6385
phs001412.v3.p1,2021,2021.41666666667,169,234,580,983
phs001416.v2.p1,2019,2019.75,2563,2855,0,5418
phs001418.v1.p1,2018,2018.83333333333,13,20,0,33
phs001419.v1.p1,2017,2017.91666666667,0,0,1002,1002
phs001420.v1.p1,2019,2019.41666666667,437,391,0,828
phs001421.v1.p1,2018,2018,34,30,0,64
phs001422.v2.p1,2021,2021.08333333333,28,18,0,46
phs001423.v3.p2,2021,2021.33333333333,927,631,120,1678
phs001424.v1.p1,2017,2017.75,21,15,0,36
phs001425.v1.p1,2017,2017.58333333333,54,31,0,85
phs001426.v1.p1,2017,2017.66666666667,129,117,164,410
phs001427.v2.p1,2021,2021,100,23,0,123
phs001428.v1.p1,2018,2018.66666666667,16,1831,0,1847
phs001430.v2.p1,2020,2020.08333333333,0,0,28,28
phs001432.v1.p1,2017,2017.75,51,35,0,86
phs001433.v1.p1,2017,2017.58333333333,24,18,0,42
phs001434.v2.p1,2021,2021.41666666667,47,18,0,65
phs001435.v2.p1,2021,2021.41666666667,79,41,0,120
phs001438.v1.p1,2017,2017.91666666667,12,25,0,37
phs001439.v1.p1,2018,2018.91666666667,0,335,0,335
phs001441.v1.p1,2017,2017.83333333333,271,294,0,565
phs001442.v3.p2,2021,2021.58333333333,21998,21012,10739,53749
phs001444.v2.p1,2019,2019.83333333333,747,532,637,1916
phs001447.v1.p1,2018,2018.08333333333,21,0,0,21
phs001448.v1.p1,2017,2017.75,81,93,3,177
phs001454.v1.p1,2017,2017.75,0,0,28,28
phs001455.v1.p1,2018,2018.25,1905,3890,0,5795
phs001457.v1.p1,2018,2018.25,2840,7342,11,10193
phs001458.v1.p1,2018,2018.25,721,1165,9893,11779
phs001459.v1.p1,2020,2020.66666666667,463,6410,19200,26073
phs001460.v1.p1,2017,2017.66666666667,45,15,0,60
phs001461.v1.p1,2017,2017.83333333333,0,11,0,11
phs001463.v1.p1,2017,2017.75,0,0,8,8
phs001464.v1.p1,2017,2017.75,34,29,0,63
phs001465.v1.p1,2019,2019.75,153,0,0,153
phs001466.v2.p1,2021,2021.41666666667,425,409,66,900
phs001467.v2.p2,2021,2021.58333333333,1699,3160,52,4911
phs001468.v3.p1,2021,2021.66666666667,1298,1450,47,2795
phs001470.v1.p1,2018,2018.41666666667,18,1504,0,1522
phs001471.v1.p1,2020,2020,141,370,154,665
phs001472.v2.p1,2021,2021.5,1591,898,0,2489
phs001473.v1.p1,2020,2020.91666666667,174,108,0,282
phs001474.v1.p1,2017,2017.83333333333,13,11,0,24
phs001475.v1.p1,2018,2018.58333333333,575,518,0,1093
phs001479.v1.p1,2018,2018.41666666667,2,1,0,3
phs001481.v1.p1,2018,2018.41666666667,238,218,0,456
phs001482.v1.p1,2017,2017.83333333333,0,0,9125,9125
phs001483.v1.p1,2018,2018.25,0,180,0,180
phs001484.v1.p1,2018,2018.33333333333,234,87,0,321
phs001485.v2.p1,2021,2021.16666666667,117,91,0,208
phs001486.v3.p3,2021,2021.75,545,531,0,1076
phs001488.v1.p1,2018,2018.08333333333,0,0,553,553
phs001490.v1.p1,2018,2018.41666666667,1065,1522,0,2587
phs001493.v2.p1,2020,2020,89,48,6,143
phs001495.v2.p1,2019,2019,1,13,0,14
phs001498.v1.p1,2018,2018.16666666667,0,0,237,237
phs001500.v2.p1,2021,2021.25,106,0,0,106
phs001501.v1.p1,2020,2020.58333333333,698,378,0,1076
phs001503.v1.p1,2018,2018,0,864,18,882
phs001504.v2.p1,2021,2021.16666666667,489,487,0,976
phs001505.v1.p1,2018,2018.66666666667,268,140,0,408
phs001511.v1.p1,2019,2019.75,212,338,0,550
phs001512.v1.p1,2018,2018.16666666667,28,40,0,68
phs001513.v1.p1,2018,2018,71,38,0,109
phs001515.v2.p2,2021,2021.66666666667,6460,2710,4,9174
phs001516.v1.p1,2018,2018.16666666667,9563,12137,1,21701
phs001517.v2.p2,2020,2020.25,514,480,12,1006
phs001518.v1.p1,2020,2020,1764,815,0,2579
phs001521.v1.p1,2018,2018.41666666667,179,118,72,369
phs001522.v1.p1,2018,2018.25,654,637,2522,3813
phs001523.v1.p1,2018,2018.83333333333,0,0,10580,10580
phs001524.v1.p1,2019,2019.33333333333,5639,35,0,5674
phs001525.v1.p1,2018,2018.08333333333,111,69,0,180
phs001528.v1.p1,2018,2018.08333333333,0,2,0,2
phs001529.v1.p1,2018,2018.16666666667,0,0,20287,20287
phs001531.v1.p1,2018,2018.08333333333,0,188,0,188
phs001534.v1.p1,2019,2019.66666666667,51,4523,9,4583
phs001535.v1.p1,2018,2018.58333333333,0,34,0,34
phs001538.v1.p1,2018,2018.41666666667,0,0,541,541
phs001539.v1.p1,2018,2018.08333333333,44,57,0,101
phs001541.v1.p1,2019,2019.83333333333,387,10506,2025,12918
phs001543.v2.p1,2021,2021.5,265,84,1,350
phs001544.v2.p1,2021,2021.5,114,7,0,121
phs001545.v2.p1,2021,2021.5,315,152,9,476
phs001546.v2.p1,2021,2021.5,5,1,0,6
phs001547.v2.p1,2021,2021.5,75,15,0,90
phs001550.v2.p1,2018,2018.75,179,152,17,348
phs001554.v1.p1,2018,2018.16666666667,1075,1817,0,2892
phs001555.v1.p1,2018,2018.25,0,0,144,144
phs001556.v1.p1,2018,2018.25,142,69,0,211
phs001557.v1.p1,2018,2018.33333333333,0,3,0,3
phs001559.v1.p1,2018,2018.16666666667,155,28,10,193
phs001563.v1.p1,2018,2018.58333333333,0,0,87,87
phs001564.v3.p1,2020,2020.08333333333,95,97,40,232
phs001566.v1.p1,2018,2018.16666666667,0,2,0,2
phs001568.v1.p1,2018,2018.33333333333,0,49,666,715
phs001570.v2.p1,2020,2020.25,3,679,0,682
phs001571.v1.p1,2020,2020.58333333333,964,1270,9,2243
phs001572.v1.p1,2018,2018.25,390,234,0,624
phs001573.v1.p1,2020,2020.25,322,180,0,502
phs001575.v2.p1,2019,2019.83333333333,0,0,42,42
phs001576.v2.p2,2019,2019.66666666667,0,0,52,52
phs001578.v1.p1,2018,2018.83333333333,176,192,0,368
phs001580.v1.p1,2018,2018.58333333333,45,66,0,111
phs001581.v1.p1,2018,2018.66666666667,27,7,3,37
phs001584.v2.p2,2020,2020.83333333333,47973,56726,54,104753
phs001585.v1.p1,2019,2019.16666666667,269,198,4,471
phs001586.v1.p1,2018,2018.41666666667,172,176,0,348
phs001587.v1.p1,2018,2018.33333333333,31,0,0,31
phs001590.v2.p1,2021,2021.25,9873,12975,0,22848
phs001591.v1.p1,2021,2021.58333333333,1834,3419,1918,7171
phs001594.v1.p1,2018,2018.41666666667,15,28,0,43
phs001595.v1.p1,2018,2018.33333333333,0,0,50,50
phs001596.v1.p1,2018,2018.33333333333,15,22,0,37
phs001597.v1.p1,2019,2019.16666666667,38,24,0,62
phs001598.v2.p1,2021,2021.41666666667,222,68,0,290
phs001599.v1.p1,2021,2021.5,459,484,0,943
phs001600.v2.p2,2021,2021.5,710,701,0,1411
phs001601.v2.p2,2021,2021.5,1300,953,0,2253
phs001602.v2.p1,2021,2021.5,5,2,0,7
phs001604.v2.p1,2021,2021.5,29,27,0,56
phs001605.v2.p1,2021,2021.5,109,187,0,296
phs001606.v2.p1,2021,2021.5,134,190,0,324
phs001608.v2.p1,2021,2021.66666666667,289,351,2,642
phs001609.v1.p1,2019,2019,89,875,0,964
phs001611.v1.p1,2019,2019.41666666667,106,81,2,189
phs001615.v1.p1,2018,2018.5,0,0,213,213
phs001616.v2.p2,2020,2020.75,22923,26871,66,49860
phs001618.v1.p1,2018,2018.5,43,41,0,84
phs001619.v3.p1,2021,2021.16666666667,211,215,125,551
phs001620.v1.p1,2018,2018.41666666667,673,1338,41,2052
phs001621.v1.p1,2018,2018.91666666667,680,0,0,680
phs001623.v2.p1,2019,2019.75,306,111,56,473
phs001625.v1.p1,2018,2018.41666666667,112,140,0,252
phs001626.v1.p1,2018,2018.75,375,418,38,831
phs001627.v1.p1,2018,2018.5,3,0,0,3
phs001628.v1.p1,2019,2019.16666666667,0,0,119,119
phs001629.v1.p1,2018,2018.41666666667,2,0,0,2
phs001630.v1.p1,2020,2020.41666666667,1956,720,129,2805
phs001632.v1.p1,2018,2018.83333333333,648,760,0,1408
phs001641.v1.p1,2020,2020.16666666667,0,0,2385,2385
phs001643.v1.p1,2018,2018.41666666667,8,0,0,8
phs001644.v2.p2,2021,2021.58333333333,5029,6993,27,12049
phs001645.v1.p1,2018,2018.5,16,9,0,25
phs001646.v1.p1,2018,2018.41666666667,0,0,30,30
phs001647.v1.p1,2018,2018.58333333333,271,112,131,514
phs001648.v2.p1,2021,2021.16666666667,311,0,0,311
phs001650.v1.p1,2018,2018.5,0,0,129,129
phs001651.v1.p1,2018,2018.5,72,30,0,102
phs001653.v1.p1,2019,2019.25,278,347,0,625
phs001654.v1.p1,2018,2018.75,136,28,0,164
phs001655.v1.p1,2018,2018.58333333333,35,47,0,82
phs001657.v1.p1,2019,2019.58333333333,0,0,1478,1478
phs001658.v1.p1,2018,2018.66666666667,0,0,33,33
phs001659.v1.p1,2018,2018.58333333333,0,0,12,12
phs001661.v3.p1,2021,2021.58333333333,2791,2673,0,5464
phs001662.v2.p1,2021,2021.58333333333,1637,1492,3,3132
phs001663.v1.p1,2018,2018.91666666667,7,0,0,7
phs001664.v1.p1,2018,2018.75,827,392,0,1219
phs001666.v1.p1,2018,2018.75,64,0,0,64
phs001670.v1.p1,2019,2019.16666666667,23,25,0,48
phs001673.v1.p1,2019,2019.25,914,1144,38,2096
phs001674.v1.p1,2018,2018.75,0,0,95,95
phs001676.v1.p1,2020,2020.25,5431,3770,0,9201
phs001678.v1.p1,2018,2018.75,73,43,28,144
phs001680.v1.p1,2019,2019.16666666667,68,30,0,98
phs001682.v2.p1,2021,2021.58333333333,186,184,8,378
phs001683.v2.p1,2020,2020.5,378,391,313,1082
phs001684.v1.p1,2018,2018.66666666667,18,23,0,41
phs001685.v1.p1,2018,2018.66666666667,0,91,0,91
phs001686.v1.p1,2018,2018.83333333333,12,12,0,24
phs001687.v1.p1,2018,2018.66666666667,0,722,0,722
phs001688.v1.p1,2018,2018.91666666667,119,64,0,183
phs001690.v1.p1,2018,2018.83333333333,0,114,0,114
phs001691.v1.p1,2018,2018.83333333333,1,1,0,2
phs001692.v1.p1,2018,2018.75,8,0,0,8
phs001693.v1.p1,2018,2018.75,0,20,0,20
phs001694.v1.p1,2018,2018.75,6,2,0,8
phs001695.v1.p1,2018,2018.75,0,10,0,10
phs001696.v1.p1,2018,2018.75,12,8,0,20
phs001698.v1.p1,2020,2020,129,0,0,129
phs001699.v1.p1,2018,2018.75,0,0,155,155
phs001700.v1.p1,2020,2020.83333333333,39,85,0,124
phs001701.v1.p1,2019,2019.58333333333,425,884,0,1309
phs001702.v1.p1,2018,2018.75,13,147,0,160
phs001703.v3.p1,2019,2019.83333333333,1147,662,0,1809
phs001704.v1.p1,2018,2018.75,42,10,14,66
phs001705.v1.p1,2019,2019.5,314,251,3,568
phs001706.v1.p1,2018,2018.75,17,15,0,32
phs001707.v2.p1,2020,2020,0,0,85,85
phs001709.v1.p1,2019,2019.66666666667,1,477,0,478
phs001710.v1.p1,2021,2021.41666666667,235,181,0,416
phs001711.v1.p1,2021,2021.08333333333,22,10,0,32
phs001712.v1.p1,2019,2019,0,0,152,152
phs001713.v1.p1,2019,2019.91666666667,1219,2339,0,3558
phs001714.v1.p1,2020,2020.5,0,0,311,311
phs001717.v1.p1,2019,2019.16666666667,152,150,0,302
phs001718.v1.p1,2019,2019.66666666667,1240,855,0,2095
phs001720.v1.p1,2018,2018.91666666667,10,0,0,10
phs001721.v1.p1,2020,2020.08333333333,2234,2574,0,4808
phs001722.v1.p1,2020,2020.16666666667,0,0,219,219
phs001723.v1.p1,2020,2020.08333333333,2384,2409,0,4793
phs001724.v1.p1,2018,2018.75,2,1,0,3
phs001725.v2.p1,2021,2021.58333333333,468,172,0,640
phs001727.v2.p1,2021,2021.58333333333,22,40,0,62
phs001728.v2.p1,2021,2021.58333333333,34,16,0,50
phs001729.v2.p1,2021,2021.58333333333,11,8,0,19
phs001730.v2.p1,2021,2021.58333333333,24,17,0,41
phs001732.v2.p1,2021,2021.58333333333,43,46,0,89
phs001735.v2.p1,2021,2021.66666666667,2457,2131,1,4589
phs001737.v2.p1,2019,2019.66666666667,42,21,24,87
phs001738.v1.p1,2020,2020.41666666667,0,0,373,373
phs001739.v1.p1,2019,2019.08333333333,0,1505,0,1505
phs001740.v1.p1,2019,2019.58333333333,355,225,0,580
phs001741.v1.p1,2020,2020,573,332,0,905
phs001742.v2.p1,2019,2019.25,0,113,0,113
phs001743.v1.p1,2019,2019.16666666667,69,9,3,81
phs001745.v1.p1,2019,2019.08333333333,597,506,0,1103
phs001746.v1.p1,2018,2018.83333333333,15,15,0,30
phs001747.v1.p1,2019,2019.16666666667,85,257,0,342
phs001748.v1.p1,2021,2021.08333333333,18,32,4,54
phs001749.v2.p1,2021,2021.33333333333,911,1204,0,2115
phs001750.v1.p1,2018,2018.91666666667,53,30,0,83
phs001752.v1.p1,2019,2019.16666666667,155,0,0,155
phs001753.v1.p1,2019,2019.33333333333,91,132,2,225
phs001754.v4.p2,2021,2021.08333333333,3664,6253,0,9917
phs001757.v1.p1,2019,2019.16666666667,155,190,0,345
phs001758.v1.p1,2018,2018.91666666667,2,8,0,10
phs001759.v1.p1,2019,2019.16666666667,20,106,0,126
phs001765.v1.p1,2019,2019,26,13,2,41
phs001768.v1.p1,2019,2019.25,0,53,0,53
phs001770.v1.p1,2019,2019.08333333333,0,0,356,356
phs001771.v1.p1,2021,2021.08333333333,163,280,0,443
phs001772.v2.p1,2021,2021.5,134,132,0,266
phs001774.v1.p1,2020,2020.08333333333,22,28,0,50
phs001776.v1.p1,2019,2019.41666666667,102,80,0,182
phs001777.v1.p1,2019,2019.16666666667,11,0,0,11
phs001778.v1.p1,2020,2020.5,5,6,0,11
phs001779.v1.p1,2020,2020.41666666667,35,125,18,178
phs001780.v1.p1,2019,2019.08333333333,379,316,2,697
phs001781.v1.p1,2019,2019.16666666667,72,36,0,108
phs001782.v2.p1,2021,2021.5,536,681,0,1217
phs001783.v2.p1,2021,2021.58333333333,758,940,0,1698
phs001784.v1.p1,2019,2019.41666666667,30,11,0,41
phs001785.v1.p1,2021,2021.58333333333,0,0,274,274
phs001786.v1.p1,2019,2019.58333333333,63,74,0,137
phs001787.v1.p1,2020,2020.41666666667,96,110,191,397
phs001788.v1.p1,2019,2019.16666666667,3903,858,16,4777
phs001791.v1.p1,2019,2019.16666666667,2400,0,72,2472
phs001792.v1.p1,2019,2019.25,92,372,0,464
phs001793.v1.p1,2020,2020.58333333333,22,12,0,34
phs001794.v1.p1,2019,2019.16666666667,6,6,0,12
phs001795.v1.p1,2019,2019.41666666667,27,35,33,95
phs001796.v1.p1,2019,2019.16666666667,36,56,32,124
phs001797.v1.p1,2019,2019.16666666667,31,15,0,46
phs001798.v2.p2,2021,2021.5,0,0,2294,2294
phs001799.v1.p1,2019,2019.5,0,0,238,238
phs001800.v2.p1,2020,2020.91666666667,26,4,0,30
phs001802.v1.p1,2019,2019.25,3,2,0,5
phs001803.v1.p1,2019,2019.25,223,696,0,919
phs001804.v1.p1,2019,2019.25,2280,721,146,3147
phs001805.v1.p1,2019,2019.25,6,4,0,10
phs001806.v1.p1,2021,2021.58333333333,0,0,1059,1059
phs001807.v1.p1,2019,2019.41666666667,54,33,3,90
phs001808.v1.p1,2019,2019.25,23,53,0,76
phs001811.v1.p1,2019,2019.33333333333,33,69,0,102
phs001812.v1.p1,2021,2021.08333333333,180,146,18,344
phs001813.v2.p1,2021,2021.66666666667,1254,0,0,1254
phs001814.v1.p1,2019,2019.41666666667,149,130,0,279
phs001816.v1.p1,2020,2020.5,0,0,11,11
phs001817.v1.p1,2019,2019.41666666667,85,177,0,262
phs001818.v3.p1,2021,2021.16666666667,27,24,0,51
phs001819.v2.p1,2020,2020.91666666667,6,8,25,39
phs001820.v1.p1,2020,2020.33333333333,315,182,2,499
phs001823.v1.p1,2019,2019.58333333333,443,324,46,813
phs001824.v1.p1,2019,2019.41666666667,19,0,0,19
phs001825.v1.p1,2019,2019.33333333333,164,0,0,164
phs001826.v1.p1,2019,2019.5,2995,3119,22,6136
phs001828.v1.p1,2019,2019.58333333333,799,593,0,1392
phs001829.v1.p1,2020,2020.25,29,19,0,48
phs001830.v1.p1,2019,2019.33333333333,12,0,0,12
phs001831.v1.p1,2020,2020.58333333333,147,140,0,287
phs001833.v1.p1,2019,2019.41666666667,134,165,0,299
phs001834.v1.p1,2020,2020,12,18,0,30
phs001835.v1.p1,2019,2019.41666666667,0,0,3,3
phs001836.v1.p1,2019,2019.41666666667,16,60,0,76
phs001839.v1.p1,2019,2019.58333333333,4,8,0,12
phs001840.v1.p1,2019,2019.41666666667,6,3,0,9
phs001841.v1.p1,2020,2020.41666666667,327,225,799,1351
phs001842.v1.p1,2019,2019.91666666667,0,44,0,44
phs001845.v1.p1,2019,2019.58333333333,342,237,0,579
phs001846.v1.p1,2020,2020.83333333333,0,0,1805,1805
phs001847.v1.p1,2019,2019.58333333333,4,0,0,4
phs001848.v1.p1,2019,2019.41666666667,1,2,0,3
phs001850.v1.p1,2019,2019.5,34,276,34,344
phs001851.v1.p1,2019,2019.41666666667,0,0,556,556
phs001852.v1.p1,2019,2019.5,212,187,18,417
phs001853.v1.p1,2020,2020.08333333333,33,11,0,44
phs001854.v1.p1,2019,2019.75,544,690,0,1234
phs001855.v1.p1,2019,2019.5,277,323,283,883
phs001856.v1.p1,2020,2020.58333333333,4948,4976,0,9924
phs001857.v1.p1,2020,2020.91666666667,0,677,1351,2028
phs001858.v1.p1,2019,2019.75,15912,18254,138,34304
phs001861.v1.p1,2019,2019.91666666667,0,0,24,24
phs001862.v1.p1,2019,2019.91666666667,278,380,0,658
phs001864.v1.p1,2019,2019.5,13,9,0,22
phs001865.v1.p1,2019,2019.83333333333,0,552,0,552
phs001866.v1.p1,2019,2019.91666666667,0,166,0,166
phs001867.v1.p1,2019,2019.58333333333,12,13,4,29
phs001870.v1.p1,2020,2020.16666666667,0,340,0,340
phs001871.v1.p1,2019,2019.58333333333,137,211,0,348
phs001872.v1.p1,2019,2019.5,290,309,4,603
phs001875.v1.p1,2019,2019.91666666667,8,9,2,19
phs001877.v1.p1,2019,2019.66666666667,65,17,0,82
phs001879.v1.p1,2019,2019.66666666667,292,255,0,547
phs001880.v1.p1,2019,2019.75,194,235,0,429
phs001881.v1.p1,2020,2020.75,2839,1545,0,4384
phs001883.v1.p1,2019,2019.91666666667,0,45,0,45
phs001884.v1.p1,2019,2019.83333333333,81,273,0,354
phs001885.v1.p1,2019,2019.66666666667,0,4486,0,4486
phs001886.v2.p1,2020,2020.5,0,31,0,31
phs001887.v1.p1,2019,2019.66666666667,50,0,0,50
phs001889.v1.p1,2019,2019.91666666667,20,14,4,38
phs001892.v1.p1,2020,2020.16666666667,0,2,11,13
phs001894.v1.p1,2020,2020.25,419,305,0,724
phs001895.v2.p1,2020,2020,378,200,0,578
phs001897.v1.p1,2019,2019.91666666667,64,56,4,124
phs001900.v1.p1,2020,2020.16666666667,670,520,0,1190
phs001903.v1.p1,2020,2020.66666666667,18421,19016,0,37437
phs001906.v1.p1,2019,2019.91666666667,26,37,21,84
phs001907.v1.p1,2019,2019.75,0,58,0,58
phs001908.v2.p1,2021,2021.25,16,34,0,50
phs001910.v1.p1,2019,2019.75,27,35,0,62
phs001911.v1.p1,2019,2019.75,6,11,38,55
phs001912.v1.p1,2020,2020.75,382,45,0,427
phs001913.v1.p1,2019,2019.91666666667,79,198,0,277
phs001914.v1.p1,2020,2020.08333333333,76,34,2,112
phs001916.v2.p1,2020,2020.25,0,100,0,100
phs001917.v1.p1,2019,2019.75,454,370,0,824
phs001918.v2.p1,2021,2021.75,5175,3924,0,9099
phs001919.v1.p1,2020,2020.16666666667,44,16,0,60
phs001921.v1.p1,2019,2019.75,525,0,0,525
phs001922.v1.p1,2019,2019.83333333333,0,339,0,339
phs001924.v1.p1,2019,2019.75,0,8,0,8
phs001925.v1.p1,2020,2020.75,16,22,0,38
phs001929.v1.p1,2020,2020.16666666667,325,275,0,600
phs001930.v1.p1,2019,2019.91666666667,0,0,114,114
phs001931.v1.p1,2020,2020.08333333333,20,64,0,84
phs001932.v1.p1,2019,2019.91666666667,1362,1243,0,2605
phs001933.v1.p1,2021,2021.58333333333,89,24,0,113
phs001934.v1.p1,2020,2020,179,192,51,422
phs001935.v1.p1,2020,2020.08333333333,6,6,6,18
phs001936.v1.p1,2020,2020,4,15,0,19
phs001937.v1.p1,2019,2019.91666666667,0,189,0,189
phs001938.v2.p1,2020,2020.5,377,0,0,377
phs001939.v2.p1,2021,2021.58333333333,126,0,0,126
phs001940.v2.p1,2020,2020,38,34,0,72
phs001941.v1.p1,2020,2020,7,0,0,7
phs001942.v1.p1,2020,2020.75,16,3,0,19
phs001943.v1.p1,2019,2019.91666666667,14,20,0,34
phs001945.v1.p1,2021,2021.33333333333,120,11534,34,11688
phs001947.v1.p1,2020,2020.25,15,8,0,23
phs001949.v1.p1,2019,2019.91666666667,13495,15325,0,28820
phs001951.v1.p1,2020,2020.66666666667,88,40,0,128
phs001953.v1.p1,2020,2020,0,0,89,89
phs001954.v1.p1,2020,2020,144,212,0,356
phs001955.v1.p1,2020,2020.5,6342,6346,703,13391
phs001956.v1.p1,2020,2020,43,36,0,79
phs001957.v1.p1,2020,2020.08333333333,0,0,32,32
phs001959.v1.p1,2020,2020.16666666667,3,4,5,12
phs001960.v1.p1,2020,2020,0,143,0,143
phs001961.v1.p1,2021,2021.41666666667,7,4,0,11
phs001962.v1.p1,2021,2021,0,0,20,20
phs001963.v1.p1,2020,2020.83333333333,3885,2953,69,6907
phs001969.v1.p1,2020,2020.16666666667,27,10,0,37
phs001970.v1.p1,2020,2020.16666666667,0,0,134,134
phs001972.v1.p1,2020,2020.41666666667,1273,1411,101,2785
phs001975.v1.p1,2020,2020.08333333333,0,0,5,5
phs001976.v2.p1,2020,2020.16666666667,44,16,0,60
phs001979.v1.p1,2020,2020.16666666667,224,131,0,355
phs001980.v1.p1,2020,2020.91666666667,4,1,0,5
phs001981.v1.p1,2020,2020.91666666667,32,16,0,48
phs001982.v1.p1,2020,2020.16666666667,26,36,0,62
phs001987.v1.p1,2020,2020.16666666667,0,0,79,79
phs001988.v1.p1,2021,2021.16666666667,157,0,0,157
phs001990.v1.p1,2020,2020.16666666667,344,760,48,1152
phs001993.v1.p1,2020,2020.66666666667,43,31,0,74
phs001994.v1.p1,2020,2020.25,89,31,0,120
phs001995.v1.p1,2020,2020.5,298,380,0,678
phs001997.v1.p1,2020,2020.33333333333,113,111,567,791
phs002000.v1.p1,2020,2020.41666666667,72,68,2,142
phs002001.v1.p1,2021,2021.66666666667,69,64,0,133
phs002002.v1.p1,2020,2020.25,2234,513,0,2747
phs002003.v1.p1,2020,2020.25,111,110,0,221
phs002006.v2.p1,2020,2020.66666666667,15,13,1,29
phs002007.v1.p1,2020,2020.5,0,0,85,85
phs002008.v1.p1,2020,2020.41666666667,74,24,20,118
phs002015.v1.p1,2020,2020.66666666667,0,0,4203,4203
phs002017.v1.p1,2020,2020.25,0,289,0,289
phs002019.v1.p1,2020,2020.83333333333,0,0,22,22
phs002020.v1.p1,2020,2020.33333333333,438,352,486,1276
phs002021.v1.p1,2020,2020.25,0,2,0,2
phs002022.v1.p1,2020,2020.5,16,30,0,46
phs002023.v1.p1,2020,2020.33333333333,6,24,0,30
phs002024.v1.p1,2020,2020.33333333333,271,228,0,499
phs002025.v1.p1,2020,2020.5,2283,1719,0,4002
phs002030.v1.p1,2020,2020.41666666667,407,231,0,638
phs002034.v1.p1,2020,2020.33333333333,86,59,12,157
phs002035.v1.p1,2020,2020.5,25,34,0,59
phs002036.v1.p1,2020,2020.41666666667,1,0,0,1
phs002037.v1.p1,2020,2020.41666666667,252,224,2,478
phs002039.v1.p1,2020,2020.41666666667,6192,29463,0,35655
phs002040.v1.p1,2020,2020.41666666667,2,1,0,3
phs002045.v1.p1,2020,2020.41666666667,48,22,0,70
phs002046.v1.p1,2020,2020.83333333333,1401,4157,27,5585
phs002049.v1.p1,2020,2020.41666666667,84,64,0,148
phs002050.v1.p1,2020,2020.83333333333,2226,2830,0,5056
phs002051.v1.p1,2020,2020.5,0,0,99,99
phs002052.v1.p1,2020,2020.58333333333,20,21,0,41
phs002053.v1.p1,2020,2020.58333333333,0,0,39,39
phs002055.v1.p1,2020,2020.5,179,100,0,279
phs002056.v1.p1,2021,2021.58333333333,6498,79,0,6577
phs002059.v1.p1,2020,2020.91666666667,973,935,227,2135
phs002060.v1.p1,2020,2020.83333333333,0,624,0,624
phs002061.v1.p1,2021,2021.16666666667,0,0,364,364
phs002062.v1.p1,2020,2020.83333333333,0,1089,0,1089
phs002063.v1.p1,2020,2020.5,21,13,0,34
phs002065.v1.p1,2020,2020.91666666667,0,0,18,18
phs002066.v1.p1,2020,2020.5,160,0,13,173
phs002067.v1.p1,2020,2020.75,38,27,1,66
phs002068.v1.p1,2021,2021,1536,1221,0,2757
phs002069.v1.p1,2020,2020.58333333333,154,184,0,338
phs002071.v1.p1,2020,2020.91666666667,24,16,1,41
phs002073.v1.p1,2021,2021,101,139,0,240
phs002075.v1.p1,2020,2020.58333333333,0,13,0,13
phs002083.v1.p1,2021,2021,50,0,0,50
phs002088.v2.p1,2021,2021.41666666667,22,18,0,40
phs002089.v1.p1,2021,2021,6,0,0,6
phs002105.v1.p1,2020,2020.91666666667,69,150,0,219
phs002130.v1.p1,2020,2020.83333333333,0,0,278,278
phs002146.v1.p1,2021,2021.16666666667,16,6,0,22
phs002161.v1.p1,2020,2020.83333333333,0,0,410,410
phs002162.v1.p1,2020,2020.83333333333,0,0,147,147
phs002172.v1.p1,2020,2020.83333333333,0,0,403,403
phs002176.v2.p1,2021,2021.33333333333,43,58,0,101
phs002185.v1.p1,2021,2021.58333333333,3759,2225,0,5984
phs002187.v1.p1,2021,2021.66666666667,0,0,798,798
phs002188.v1.p1,2021,2021.16666666667,10,10,0,20
phs002197.v1.p1,2020,2020.83333333333,9,7,0,16
phs002202.v1.p1,2020,2020.83333333333,0,0,10,10
phs002204.v1.p1,2021,2021.08333333333,11,10,0,21
phs002208.v1.p1,2021,2021.41666666667,104,77,0,181
phs002210.v1.p1,2020,2020.66666666667,0,7,0,7
phs002211.v1.p1,2020,2020.66666666667,0,30,0,30
phs002212.v1.p1,2021,2021.08333333333,16,2,0,18
phs002217.v1.p1,2020,2020.66666666667,3,0,0,3
phs002222.v1.p1,2020,2020.66666666667,12,32,0,44
phs002224.v1.p1,2021,2021.33333333333,31,85,0,116
phs002225.v1.p1,2020,2020.66666666667,0,10,0,10
phs002226.v1.p1,2021,2021.16666666667,3747,0,0,3747
phs002228.v1.p1,2021,2021.25,66,47,0,113
phs002229.v1.p1,2021,2021.5,30,0,0,30
phs002230.v1.p1,2021,2021.08333333333,241,555,556,1352
phs002234.v1.p1,2020,2020.66666666667,3,1,0,4
phs002235.v1.p1,2021,2021.16666666667,4439,3896,0,8335
phs002237.v1.p1,2020,2020.83333333333,0,0,5,5
phs002238.v1.p1,2021,2021.75,419,264,0,683
phs002240.v1.p1,2021,2021,90,162,0,252
phs002244.v1.p1,2020,2020.75,46,20,0,66
phs002245.v1.p1,2020,2020.75,342,251,1,594
phs002252.v1.p1,2021,2021,38,15,0,53
phs002254.v1.p1,2020,2020.66666666667,70,64,0,134
phs002255.v1.p1,2020,2020.83333333333,209,180,2,391
phs002258.v1.p1,2020,2020.75,0,0,732,732
phs002259.v1.p1,2021,2021.33333333333,41,185,0,226
phs002262.v1.p1,2020,2020.75,0,3,0,3
phs002269.v1.p1,2020,2020.75,25,12,0,37
phs002270.v1.p1,2020,2020.75,0,0,82,82
phs002273.v1.p1,2021,2021.08333333333,0,0,89,89
phs002276.v1.p1,2021,2021.75,46,12,2878,2936
phs002279.v1.p1,2020,2020.83333333333,540,0,0,540
phs002280.v1.p1,2021,2021.33333333333,0,0,55,55
phs002283.v1.p1,2020,2020.83333333333,856,467,0,1323
phs002286.v1.p1,2020,2020.83333333333,3,14,0,17
phs002287.v1.p1,2020,2020.91666666667,0,0,72,72
phs002289.v1.p1,2021,2021,34177,16812,0,50989
phs002290.v1.p1,2020,2020.91666666667,95,36,0,131
phs002291.v1.p1,2021,2021,8,2,0,10
phs002292.v1.p1,2021,2021.25,1811,2344,0,4155
phs002294.v1.p1,2021,2021.16666666667,0,72,0,72
phs002295.v1.p1,2020,2020.83333333333,234,0,0,234
phs002298.v1.p1,2020,2020.91666666667,359,36,0,395
phs002299.v1.p1,2020,2020.91666666667,0,0,479,479
phs002301.v1.p1,2020,2020.91666666667,129,69,0,198
phs002304.v1.p1,2021,2021.25,377,244,0,621
phs002308.v1.p1,2021,2021,0,0,88,88
phs002309.v1.p1,2021,2021,6,18,0,24
phs002310.v1.p1,2021,2021.33333333333,1328,559,34,1921
phs002311.v1.p1,2021,2021.16666666667,100,194,2,296
phs002313.v1.p1,2021,2021,0,21,0,21
phs002315.v1.p1,2021,2021.58333333333,0,0,2,2
phs002316.v1.p1,2021,2021.25,0,0,34,34
phs002317.v1.p1,2021,2021.33333333333,232,183,0,415
phs002319.v1.p1,2021,2021.08333333333,716,813,0,1529
phs002323.v1.p1,2021,2021.33333333333,191,176,0,367
phs002327.v1.p1,2021,2021.08333333333,11,13,0,24
phs002328.v1.p1,2021,2021.16666666667,178,90,0,268
phs002330.v1.p1,2021,2021.66666666667,0,0,2297,2297
phs002333.v1.p1,2021,2021.08333333333,8,4,0,12
phs002334.v1.p1,2021,2021.08333333333,31,47,0,78
phs002335.v1.p1,2021,2021.08333333333,7,7,0,14
phs002340.v1.p1,2021,2021.33333333333,0,22,0,22
phs002341.v1.p1,2021,2021.16666666667,72,72,0,144
phs002342.v1.p1,2021,2021.08333333333,5,0,0,5
phs002344.v1.p1,2021,2021.25,0,0,17,17
phs002346.v1.p1,2021,2021.66666666667,325,53,0,378
phs002348.v1.p1,2021,2021.16666666667,0,0,1059,1059
phs002361.v1.p1,2021,2021.16666666667,1,1,0,2
phs002362.v1.p1,2021,2021.16666666667,0,0,5946,5946
phs002364.v1.p1,2021,2021.16666666667,2,1,0,3
phs002365.v1.p1,2021,2021.16666666667,18,0,0,18
phs002366.v1.p1,2021,2021.5,0,1195,0,1195
phs002368.v1.p1,2021,2021.16666666667,2,2,0,4
phs002377.v1.p1,2021,2021.25,42,36,0,78
phs002383.v1.p1,2021,2021.33333333333,0,0,720,720
phs002385.v1.p1,2021,2021.33333333333,0,0,1518,1518
phs002386.v1.p1,2021,2021.16666666667,0,0,79,79
phs002387.v1.p1,2021,2021.33333333333,0,2529,0,2529
phs002389.v1.p1,2021,2021.25,38,22,2,62
phs002392.v1.p1,2021,2021.5,36,46,0,82
phs002394.v1.p1,2021,2021.25,79,95,0,174
phs002398.v1.p1,2021,2021.25,129,0,0,129
phs002405.v1.p1,2021,2021.58333333333,11,12,0,23
phs002407.v1.p1,2021,2021.66666666667,98,83,0,181
phs002408.v1.p1,2021,2021.25,5,4,0,9
phs002410.v1.p1,2021,2021.66666666667,0,0,813,813
phs002411.v1.p1,2021,2021.33333333333,0,88,0,88
phs002415.v1.p1,2021,2021.66666666667,0,0,219,219
phs002416.v1.p1,2021,2021.33333333333,3,36,0,39
phs002417.v1.p1,2021,2021.41666666667,1583,1510,0,3093
phs002419.v1.p1,2021,2021.41666666667,0,159,0,159
phs002421.v1.p1,2021,2021.41666666667,0,0,11,11
phs002428.v1.p1,2021,2021.41666666667,144,274,0,418
phs002433.v1.p1,2021,2021.33333333333,22,16,0,38
phs002436.v1.p1,2021,2021.5,19,17,0,36
phs002437.v1.p1,2021,2021.5,16,18,0,34
phs002440.v1.p1,2021,2021.41666666667,24,14,0,38
phs002444.v1.p1,2021,2021.5,392,323,5,720
phs002448.v1.p1,2021,2021.41666666667,2,12,0,14
phs002457.v1.p1,2021,2021.58333333333,3,92,0,95
phs002462.v1.p1,2021,2021.5,215,0,0,215
phs002464.v1.p1,2021,2021.5,22,1,6,29
phs002471.v1.p1,2021,2021.5,5,0,0,5
phs002480.v1.p1,2021,2021.58333333333,1059,821,2,1882
phs002484.v1.p1,2021,2021.5,49,37,0,86
phs002486.v1.p1,2021,2021.58333333333,30,30,0,60
phs002487.v1.p1,2021,2021.66666666667,508,192,0,700
phs002493.v1.p1,2021,2021.66666666667,160,88,0,248
phs002499.v1.p1,2021,2021.58333333333,13,6,0,19
phs002506.v1.p1,2021,2021.66666666667,4037,3056,0,7093
phs002508.v1.p1,2021,2021.58333333333,483,2373,0,2856
phs002545.v1.p1,2021,2021.66666666667,51,21,0,72
phs002557.v1.p1,2021,2021.58333333333,2,0,2,4
phs002632.v1.p1,2021,2021.75,242,607,0,849
