"ega_stable_id";"male";"female";"unknown";"total";"to_char";"repository"
"EGAS00001002783";"0";"0";"21";"21";"2018-01-02";"EGA"
"EGAS00001002784";"59";"23";"0";"82";"2018-01-03";"EGA"
"EGAS00001002786";"0";"0";"59";"59";"2018-01-05";"EGA"
"EGAS00001002787";"582";"694";"498";"1774";"2018-01-06";"EGA"
"EGAS00001002788";"28";"14";"0";"42";"2018-01-09";"EGA"
"EGAS00001002789";"0";"0";"158";"158";"2018-01-10";"EGA"
"EGAS00001002793";"1102";"612";"0";"1714";"2018-01-11";"EGA"
"EGAS00001002792";"0";"22";"0";"22";"2018-01-11";"EGA"
"EGAS00001002790";"7";"11";"0";"18";"2018-01-11";"EGA"
"EGAS00001002791";"3381";"7757";"0";"11138";"2018-01-11";"EGA"
"EGAS00001002795";"13";"32";"11";"56";"2018-01-12";"EGA"
"EGAS00001002796";"0";"0";"6";"6";"2018-01-12";"EGA"
"EGAS00001002798";"0";"0";"0";"0";"2018-01-16";"EGA"
"EGAS00001002801";"63";"69";"0";"132";"2018-01-17";"EGA"
"EGAS00001002802";"0";"0";"15";"15";"2018-01-17";"EGA"
"EGAS00001002803";"0";"54";"0";"54";"2018-01-19";"EGA"
"EGAS00001002804";"10";"14";"0";"24";"2018-01-20";"EGA"
"EGAS00001002805";"0";"60";"0";"60";"2018-01-20";"EGA"
"EGAS00001002806";"0";"2";"0";"2";"2018-01-20";"EGA"
"EGAS00001002807";"27";"24";"0";"51";"2018-01-20";"EGA"
"EGAS00001002811";"0";"0";"36";"36";"2018-01-24";"EGA"
"EGAS00001002809";"3374";"4795";"0";"8169";"2018-01-24";"EGA"
"EGAS00001002812";"0";"0";"57";"57";"2018-01-24";"EGA"
"EGAS00001002814";"0";"0";"520";"520";"2018-01-25";"EGA"
"EGAS00001002816";"92";"0";"0";"92";"2018-01-26";"EGA"
"EGAS00001002819";"64";"38";"0";"102";"2018-01-27";"EGA"
"EGAS00001002818";"29";"15";"0";"44";"2018-01-27";"EGA"
"EGAS00001002820";"19";"31";"0";"50";"2018-01-28";"EGA"
"EGAS00001002825";"85";"113";"0";"198";"2018-01-30";"EGA"
"EGAS00001002823";"70";"23";"0";"93";"2018-01-30";"EGA"
"EGAS00001002822";"4";"4";"0";"8";"2018-01-30";"EGA"
"EGAS00001002827";"28";"26";"0";"54";"2018-02-02";"EGA"
"EGAS00001002826";"2";"0";"0";"2";"2018-02-02";"EGA"
"EGAS00001002830";"3";"1";"0";"4";"2018-02-06";"EGA"
"EGAS00001002833";"0";"143";"0";"143";"2018-02-07";"EGA"
"EGAS00001002831";"0";"4";"0";"4";"2018-02-07";"EGA"
"EGAS00001002839";"0";"711";"0";"711";"2018-02-08";"EGA"
"EGAS00001002842";"73";"30";"0";"103";"2018-02-09";"EGA"
"EGAS00001002840";"0";"0";"3";"3";"2018-02-09";"EGA"
"EGAS00001002844";"200";"8";"0";"208";"2018-02-12";"EGA"
"EGAS00001002843";"0";"0";"0";"0";"2018-02-12";"EGA"
"EGAS00001002846";"0";"6";"0";"6";"2018-02-13";"EGA"
"EGAS00001002845";"0";"6";"0";"6";"2018-02-13";"EGA"
"EGAS00001002847";"2";"1";"0";"3";"2018-02-14";"EGA"
"EGAS00001002850";"223";"78";"0";"301";"2018-02-19";"EGA"
"EGAS00001002854";"80";"76";"0";"156";"2018-02-19";"EGA"
"EGAS00001002858";"5";"668";"16";"689";"2018-02-19";"EGA"
"EGAS00001002853";"0";"0";"14";"14";"2018-02-19";"EGA"
"EGAS00001002856";"84";"66";"0";"150";"2018-02-19";"EGA"
"EGAS00001002859";"190";"108";"0";"298";"2018-02-19";"EGA"
"EGAS00001002851";"24";"0";"0";"24";"2018-02-19";"EGA"
"EGAS00001002852";"82";"12";"0";"94";"2018-02-19";"EGA"
"EGAS00001002860";"9";"8";"0";"17";"2018-02-20";"EGA"
"EGAS00001002861";"19";"18";"2";"39";"2018-02-21";"EGA"
"EGAS00001002863";"0";"0";"34";"34";"2018-02-21";"EGA"
"EGAS00001002864";"0";"0";"74";"74";"2018-02-21";"EGA"
"EGAS00001002865";"37";"27";"0";"64";"2018-02-22";"EGA"
"EGAS00001002869";"53";"26";"0";"79";"2018-02-22";"EGA"
"EGAS00001002866";"480";"0";"192";"672";"2018-02-22";"EGA"
"EGAS00001002871";"0";"30";"0";"30";"2018-02-23";"EGA"
"EGAS00001002873";"464";"5";"3";"472";"2018-02-24";"EGA"
"EGAS00001002872";"52";"28";"0";"80";"2018-02-24";"EGA"
"EGAS00001002874";"812";"469";"0";"1281";"2018-02-24";"EGA"
"EGAS00001002877";"0";"1";"0";"1";"2018-02-28";"EGA"
"EGAS00001002876";"753";"0";"0";"753";"2018-02-28";"EGA"
"EGAS00001002879";"114";"31";"0";"145";"2018-03-01";"EGA"
"EGAS00001002882";"10";"9";"0";"19";"2018-03-02";"EGA"
"EGAS00001002892";"77";"25";"0";"102";"2018-03-03";"EGA"
"EGAS00001002888";"14";"14";"0";"28";"2018-03-03";"EGA"
"EGAS00001002889";"178";"131";"0";"309";"2018-03-03";"EGA"
"EGAS00001002885";"0";"0";"42";"42";"2018-03-03";"EGA"
"EGAS00001002891";"107";"35";"0";"142";"2018-03-03";"EGA"
"EGAS00001002884";"231";"114";"0";"345";"2018-03-03";"EGA"
"EGAS00001002886";"4";"0";"46";"50";"2018-03-03";"EGA"
"EGAS00001002896";"0";"0";"693";"693";"2018-03-08";"EGA"
"EGAS00001002895";"4";"8";"0";"12";"2018-03-08";"EGA"
"EGAS00001002894";"18";"14";"0";"32";"2018-03-08";"EGA"
"EGAS00001002893";"38";"26";"0";"64";"2018-03-08";"EGA"
"EGAS00001002901";"8";"0";"0";"8";"2018-03-09";"EGA"
"EGAS00001002898";"0";"4";"0";"4";"2018-03-09";"EGA"
"EGAS00001002899";"4";"0";"54";"58";"2018-03-09";"EGA"
"EGAS00001002897";"10";"10";"0";"20";"2018-03-09";"EGA"
"EGAS00001002903";"0";"15";"0";"15";"2018-03-11";"EGA"
"EGAS00001002908";"0";"0";"17";"17";"2018-03-14";"EGA"
"EGAS00001002910";"13";"11";"0";"24";"2018-03-14";"EGA"
"EGAS00001002911";"0";"1";"0";"1";"2018-03-15";"EGA"
"EGAS00001002917";"43";"46";"0";"89";"2018-03-20";"EGA"
"EGAS00001002920";"54";"31";"0";"85";"2018-03-21";"EGA"
"EGAS00001002921";"544";"514";"105";"1163";"2018-03-21";"EGA"
"EGAS00001002922";"0";"0";"0";"0";"2018-03-22";"EGA"
"EGAS00001002923";"557";"0";"249";"806";"2018-03-23";"EGA"
"EGAS00001002928";"0";"0";"589";"589";"2018-03-24";"EGA"
"EGAS00001002927";"10";"14";"0";"24";"2018-03-24";"EGA"
"EGAS00001002932";"0";"0";"76";"76";"2018-03-27";"EGA"
"EGAS00001002931";"0";"0";"37";"37";"2018-03-27";"EGA"
"EGAS00001002929";"0";"0";"5";"5";"2018-03-27";"EGA"
"EGAS00001002933";"96";"2208";"0";"2304";"2018-03-28";"EGA"
"EGAS00001002936";"318";"204";"0";"522";"2018-03-28";"EGA"
"EGAS00001002937";"964";"960";"0";"1924";"2018-03-28";"EGA"
"EGAS00001002935";"21";"17";"0";"38";"2018-03-28";"EGA"
"EGAS00001002940";"6";"3";"0";"9";"2018-03-31";"EGA"
"EGAS00001002941";"678";"0";"0";"678";"2018-04-04";"EGA"
"EGAS00001002945";"0";"0";"0";"0";"2018-04-05";"EGA"
"EGAS00001002948";"633";"0";"84";"717";"2018-04-06";"EGA"
"EGAS00001002947";"0";"183";"0";"183";"2018-04-06";"EGA"
"EGAS00001002953";"60";"43";"0";"103";"2018-04-07";"EGA"
"EGAS00001002952";"59";"37";"0";"96";"2018-04-07";"EGA"
"EGAS00001002954";"64";"26";"0";"90";"2018-04-10";"EGA"
"EGAS00001002955";"16";"7";"0";"23";"2018-04-11";"EGA"
"EGAS00001002957";"8";"11";"0";"19";"2018-04-12";"EGA"
"EGAS00001002962";"123";"77";"0";"200";"2018-04-18";"EGA"
"EGAS00001002963";"0";"26";"0";"26";"2018-04-19";"EGA"
"EGAS00001002965";"140";"0";"0";"140";"2018-04-19";"EGA"
"EGAS00001002964";"1";"1";"46";"48";"2018-04-19";"EGA"
"EGAS00001002966";"152";"305";"0";"457";"2018-04-20";"EGA"
"EGAS00001002968";"0";"0";"1";"1";"2018-04-21";"EGA"
"EGAS00001002969";"1058";"1112";"0";"2170";"2018-04-21";"EGA"
"EGAS00001002967";"0";"0";"437";"437";"2018-04-21";"EGA"
"EGAS00001002976";"322";"374";"0";"696";"2018-04-27";"EGA"
"EGAS00001002977";"133";"59";"0";"192";"2018-04-28";"EGA"
"EGAS00001002979";"136";"82";"6";"224";"2018-04-28";"EGA"
"EGAS00001002981";"102";"10";"0";"112";"2018-04-29";"EGA"
"EGAS00001002980";"14";"13";"1";"28";"2018-04-29";"EGA"
"EGAS00001002983";"36";"16";"9";"61";"2018-05-03";"EGA"
"EGAS00001002988";"20";"0";"0";"20";"2018-05-04";"EGA"
"EGAS00001002987";"1";"6";"0";"7";"2018-05-04";"EGA"
"EGAS00001002991";"0";"0";"5";"5";"2018-05-08";"EGA"
"EGAS00001002993";"0";"0";"639";"639";"2018-05-09";"EGA"
"EGAS00001002996";"11";"11";"0";"22";"2018-05-11";"EGA"
"EGAS00001002999";"1";"0";"0";"1";"2018-05-15";"EGA"
"EGAS00001002998";"0";"55";"0";"55";"2018-05-15";"EGA"
"EGAS00001003003";"0";"17";"0";"17";"2018-05-16";"EGA"
"EGAS00001003001";"14";"0";"0";"14";"2018-05-16";"EGA"
"EGAS00001003004";"327";"494";"52";"873";"2018-05-17";"EGA"
"EGAS00001003006";"0";"0";"0";"0";"2018-05-18";"EGA"
"EGAS00001003007";"44";"0";"0";"44";"2018-05-18";"EGA"
"EGAS00001003010";"0";"0";"256";"256";"2018-05-19";"EGA"
"EGAS00001003008";"382";"141";"0";"523";"2018-05-19";"EGA"
"EGAS00001003016";"5";"5";"0";"10";"2018-05-22";"EGA"
"EGAS00001003017";"2";"12";"0";"14";"2018-05-23";"EGA"
"EGAS00001003018";"23702";"32277";"0";"55979";"2018-05-23";"EGA"
"EGAS00001003023";"799";"27";"142";"968";"2018-05-24";"EGA"
"EGAS00001003025";"0";"2";"0";"2";"2018-05-25";"EGA"
"EGAS00001003027";"102";"108";"1007";"1217";"2018-05-28";"EGA"
"EGAS00001003029";"6";"38";"0";"44";"2018-05-28";"EGA"
"EGAS00001003026";"9";"0";"0";"9";"2018-05-28";"EGA"
"EGAS00001003028";"117";"59";"115";"291";"2018-05-28";"EGA"
"EGAS00001003031";"7";"0";"0";"7";"2018-05-31";"EGA"
"EGAS00001003032";"0";"1";"0";"1";"2018-06-01";"EGA"
"EGAS00001003033";"0";"1";"0";"1";"2018-06-01";"EGA"
"EGAS00001003035";"74";"43";"0";"117";"2018-06-03";"EGA"
"EGAS00001003038";"112";"155";"0";"267";"2018-06-06";"EGA"
"EGAS00001003040";"3212";"1644";"0";"4856";"2018-06-07";"EGA"
"EGAS00001003043";"156";"38";"0";"194";"2018-06-07";"EGA"
"EGAS00001003044";"0";"86";"0";"86";"2018-06-07";"EGA"
"EGAS00001003047";"2";"1";"0";"3";"2018-06-07";"EGA"
"EGAS00001003039";"453";"519";"0";"972";"2018-06-07";"EGA"
"EGAS00001003048";"0";"28";"0";"28";"2018-06-08";"EGA"
"EGAS00001003053";"4";"6";"0";"10";"2018-06-10";"EGA"
"EGAS00001003054";"129";"32";"0";"161";"2018-06-11";"EGA"
"EGAS00001003060";"38";"12";"2";"52";"2018-06-15";"EGA"
"EGAS00001003062";"17";"11";"0";"28";"2018-06-15";"EGA"
"EGAS00001003064";"84";"52";"0";"136";"2018-06-16";"EGA"
"EGAS00001003063";"96";"24";"0";"120";"2018-06-16";"EGA"
"EGAS00001003065";"136";"44";"0";"180";"2018-06-19";"EGA"
"EGAS00001003068";"22";"8";"0";"30";"2018-06-20";"EGA"
"EGAS00001003066";"0";"0";"139";"139";"2018-06-20";"EGA"
"EGAS00001003071";"114";"69";"0";"183";"2018-06-22";"EGA"
"EGAS00001003070";"53";"34";"0";"87";"2018-06-22";"EGA"
"EGAS00001003072";"1";"0";"0";"1";"2018-06-23";"EGA"
"EGAS00001003073";"0";"186";"0";"186";"2018-06-23";"EGA"
"EGAS00001003075";"0";"124";"0";"124";"2018-06-27";"EGA"
"EGAS00001003079";"19";"8";"0";"27";"2018-06-28";"EGA"
"EGAS00001003081";"29";"15";"0";"44";"2018-06-28";"EGA"
"EGAS00001003085";"0";"0";"15";"15";"2018-06-29";"EGA"
"EGAS00001003093";"379";"65";"0";"444";"2018-07-04";"EGA"
"EGAS00001003092";"18";"38";"0";"56";"2018-07-04";"EGA"
"EGAS00001003094";"0";"0";"16";"16";"2018-07-05";"EGA"
"EGAS00001003095";"0";"24";"0";"24";"2018-07-05";"EGA"
"EGAS00001003096";"53";"47";"0";"100";"2018-07-06";"EGA"
"EGAS00001003099";"0";"0";"54";"54";"2018-07-06";"EGA"
"EGAS00001003103";"659";"746";"0";"1405";"2018-07-07";"EGA"
"EGAS00001003101";"0";"0";"129";"129";"2018-07-07";"EGA"
"EGAS00001003105";"0";"0";"109";"109";"2018-07-08";"EGA"
"EGAS00001003110";"34";"37";"0";"71";"2018-07-11";"EGA"
"EGAS00001003108";"0";"36";"0";"36";"2018-07-11";"EGA"
"EGAS00001003112";"0";"0";"886";"886";"2018-07-12";"EGA"
"EGAS00001003113";"1140";"0";"0";"1140";"2018-07-13";"EGA"
"EGAS00001003114";"4";"0";"0";"4";"2018-07-14";"EGA"
"EGAS00001003115";"230";"89";"0";"319";"2018-07-16";"EGA"
"EGAS00001003117";"0";"0";"17";"17";"2018-07-17";"EGA"
"EGAS00001003116";"0";"0";"28";"28";"2018-07-17";"EGA"
"EGAS00001003118";"108";"53";"0";"161";"2018-07-18";"EGA"
"EGAS00001003119";"0";"0";"380";"380";"2018-07-18";"EGA"
"EGAS00001003121";"0";"0";"30";"30";"2018-07-19";"EGA"
"EGAS00001003123";"41";"39";"0";"80";"2018-07-20";"EGA"
"EGAS00001003127";"0";"0";"12";"12";"2018-07-21";"EGA"
"EGAS00001003128";"2";"4";"0";"6";"2018-07-24";"EGA"
"EGAS00001003131";"0";"0";"81";"81";"2018-07-28";"EGA"
"EGAS00001003130";"28";"11";"0";"39";"2018-08-01";"EGA"
"EGAS00001003136";"0";"0";"18";"18";"2018-08-01";"EGA"
"EGAS00001003138";"0";"0";"9";"9";"2018-08-01";"EGA"
"EGAS00001003142";"0";"29";"0";"29";"2018-08-01";"EGA"
"EGAS00001003139";"0";"0";"9";"9";"2018-08-01";"EGA"
"EGAS00001003137";"0";"0";"12";"12";"2018-08-01";"EGA"
"EGAS00001003140";"0";"0";"19";"19";"2018-08-01";"EGA"
"EGAS00001003144";"2747";"1641";"252";"4640";"2018-08-02";"EGA"
"EGAS00001003147";"26";"64";"0";"90";"2018-08-03";"EGA"
"EGAS00001003145";"211";"49";"1";"261";"2018-08-03";"EGA"
"EGAS00001003148";"8";"0";"0";"8";"2018-08-04";"EGA"
"EGAS00001003151";"0";"0";"12";"12";"2018-08-09";"EGA"
"EGAS00001003154";"82";"59";"0";"141";"2018-08-10";"EGA"
"EGAS00001003158";"151";"54";"0";"205";"2018-08-11";"EGA"
"EGAS00001003157";"0";"0";"2";"2";"2018-08-11";"EGA"
"EGAS00001003159";"0";"0";"906";"906";"2018-08-15";"EGA"
"EGAS00001003162";"6";"0";"0";"6";"2018-08-16";"EGA"
"EGAS00001003160";"0";"0";"338";"338";"2018-08-16";"EGA"
"EGAS00001003163";"0";"0";"77";"77";"2018-08-17";"EGA"
"EGAS00001003167";"0";"0";"113";"113";"2018-08-21";"EGA"
"EGAS00001003168";"74";"131";"0";"205";"2018-08-21";"EGA"
"EGAS00001003170";"16";"5";"26";"47";"2018-08-22";"EGA"
"EGAS00001003172";"109";"0";"0";"109";"2018-08-23";"EGA"
"EGAS00001003173";"0";"28";"0";"28";"2018-08-23";"EGA"
"EGAS00001003174";"0";"0";"41";"41";"2018-08-23";"EGA"
"EGAS00001003171";"34";"0";"0";"34";"2018-08-23";"EGA"
"EGAS00001003175";"0";"0";"595";"595";"2018-08-24";"EGA"
"EGAS00001003176";"0";"2";"1";"3";"2018-08-25";"EGA"
"EGAS00001003178";"102";"26";"0";"128";"2018-08-28";"EGA"
"EGAS00001003177";"0";"1";"0";"1";"2018-08-28";"EGA"
"EGAS00001003179";"80";"0";"0";"80";"2018-08-29";"EGA"
"EGAS00001003180";"49";"39";"0";"88";"2018-08-30";"EGA"
"EGAS00001003184";"185";"94";"0";"279";"2018-08-31";"EGA"
"EGAS00001003186";"71";"91";"0";"162";"2018-09-01";"EGA"
"EGAS00001003185";"0";"0";"554";"554";"2018-09-01";"EGA"
"EGAS00001003190";"13318";"31756";"0";"45074";"2018-09-05";"EGA"
"EGAS00001003193";"8";"8";"0";"16";"2018-09-08";"EGA"
"EGAS00001003195";"13866";"29517";"288";"43671";"2018-09-09";"EGA"
"EGAS00001003197";"0";"0";"16";"16";"2018-09-11";"EGA"
"EGAS00001003200";"0";"9";"0";"9";"2018-09-12";"EGA"
"EGAS00001003201";"52";"53";"0";"105";"2018-09-12";"EGA"
"EGAS00001003203";"8";"4";"0";"12";"2018-09-12";"EGA"
"EGAS00001003199";"0";"1";"1";"2";"2018-09-12";"EGA"
"EGAS00001003206";"24";"16";"1";"41";"2018-09-13";"EGA"
"EGAS00001003207";"60";"16";"1055";"1131";"2018-09-13";"EGA"
"EGAS00001003208";"60";"16";"1055";"1131";"2018-09-13";"EGA"
"EGAS00001003212";"0";"0";"2";"2";"2018-09-15";"EGA"
"EGAS00001003213";"1";"3";"0";"4";"2018-09-15";"EGA"
"EGAS00001003214";"70";"50";"0";"120";"2018-09-16";"EGA"
"EGAS00001003215";"16";"0";"0";"16";"2018-09-19";"EGA"
"EGAS00001003220";"4";"4";"0";"8";"2018-09-19";"EGA"
"EGAS00001003216";"6730";"16541";"70";"23341";"2018-09-19";"EGA"
"EGAS00001003217";"5";"3";"3";"11";"2018-09-19";"EGA"
"EGAS00001003221";"0";"198";"0";"198";"2018-09-20";"EGA"
"EGAS00001003223";"169";"94";"0";"263";"2018-09-20";"EGA"
"EGAS00001003225";"0";"0";"22";"22";"2018-09-21";"EGA"
"EGAS00001003228";"94";"12";"0";"106";"2018-09-25";"EGA"
"EGAS00001003232";"18";"16";"0";"34";"2018-09-26";"EGA"
"EGAS00001003231";"3";"3";"0";"6";"2018-09-26";"EGA"
"EGAS00001003235";"8";"6";"0";"14";"2018-09-28";"EGA"
"EGAS00001003237";"93";"17";"0";"110";"2018-09-28";"EGA"
"EGAS00001003233";"138";"76";"4";"218";"2018-09-28";"EGA"
"EGAS00001003234";"12";"8";"0";"20";"2018-09-28";"EGA"
"EGAS00001003238";"0";"28";"0";"28";"2018-09-29";"EGA"
"EGAS00001003239";"2";"2";"0";"4";"2018-10-02";"EGA"
"EGAS00001003242";"0";"107";"0";"107";"2018-10-03";"EGA"
"EGAS00001003244";"665";"713";"0";"1378";"2018-10-03";"EGA"
"EGAS00001003245";"19";"34";"0";"53";"2018-10-03";"EGA"
"EGAS00001003250";"9";"13";"0";"22";"2018-10-05";"EGA"
"EGAS00001003248";"99";"65";"0";"164";"2018-10-05";"EGA"
"EGAS00001003249";"0";"0";"693";"693";"2018-10-05";"EGA"
"EGAS00001003251";"2";"4";"0";"6";"2018-10-06";"EGA"
"EGAS00001003252";"0";"72";"0";"72";"2018-10-09";"EGA"
"EGAS00001003254";"27";"17";"0";"44";"2018-10-10";"EGA"
"EGAS00001003258";"0";"118";"0";"118";"2018-10-10";"EGA"
"EGAS00001003257";"0";"0";"145";"145";"2018-10-10";"EGA"
"EGAS00001003256";"0";"0";"0";"0";"2018-10-10";"EGA"
"EGAS00001003255";"0";"0";"13";"13";"2018-10-10";"EGA"
"EGAS00001003263";"57";"23";"0";"80";"2018-10-16";"EGA"
"EGAS00001003266";"0";"0";"1423";"1423";"2018-10-17";"EGA"
"EGAS00001003275";"20";"12";"0";"32";"2018-10-19";"EGA"
"EGAS00001003274";"8";"4";"0";"12";"2018-10-19";"EGA"
"EGAS00001003276";"86";"102";"0";"188";"2018-10-19";"EGA"
"EGAS00001003278";"0";"0";"1";"1";"2018-10-23";"EGA"
"EGAS00001003280";"229";"355";"0";"584";"2018-10-26";"EGA"
"EGAS00001003281";"17";"3";"0";"20";"2018-10-30";"EGA"
"EGAS00001003282";"16";"36";"0";"52";"2018-10-30";"EGA"
"EGAS00001003284";"34";"24";"0";"58";"2018-10-31";"EGA"
"EGAS00001003285";"44";"12";"0";"56";"2018-10-31";"EGA"
"EGAS00001003286";"11";"0";"0";"11";"2018-11-01";"EGA"
"EGAS00001003288";"4";"1";"19";"24";"2018-11-02";"EGA"
"EGAS00001003292";"0";"96";"0";"96";"2018-11-06";"EGA"
"EGAS00001003290";"0";"1326";"0";"1326";"2018-11-06";"EGA"
"EGAS00001003291";"28";"25";"0";"53";"2018-11-06";"EGA"
"EGAS00001003293";"192";"0";"0";"192";"2018-11-07";"EGA"
"EGAS00001003296";"485";"569";"0";"1054";"2018-11-08";"EGA"
"EGAS00001003295";"9";"25";"0";"34";"2018-11-08";"EGA"
"EGAS00001003298";"60";"97";"0";"157";"2018-11-09";"EGA"
"EGAS00001003297";"1";"53";"224";"278";"2018-11-09";"EGA"
"EGAS00001003300";"2";"0";"0";"2";"2018-11-10";"EGA"
"EGAS00001003302";"409";"314";"106";"829";"2018-11-11";"EGA"
"EGAS00001003303";"70";"54";"0";"124";"2018-11-12";"EGA"
"EGAS00001003309";"2962";"2838";"0";"5800";"2018-11-14";"EGA"
"EGAS00001003307";"0";"0";"72";"72";"2018-11-14";"EGA"
"EGAS00001003305";"0";"0";"156";"156";"2018-11-14";"EGA"
"EGAS00001003310";"11";"9";"0";"20";"2018-11-14";"EGA"
"EGAS00001003306";"0";"0";"72";"72";"2018-11-14";"EGA"
"EGAS00001003325";"27";"0";"0";"27";"2018-11-15";"EGA"
"EGAS00001003317";"0";"46";"0";"46";"2018-11-15";"EGA"
"EGAS00001003315";"0";"49";"0";"49";"2018-11-15";"EGA"
"EGAS00001003320";"0";"12";"0";"12";"2018-11-15";"EGA"
"EGAS00001003321";"6";"24";"0";"30";"2018-11-15";"EGA"
"EGAS00001003322";"0";"24";"0";"24";"2018-11-15";"EGA"
"EGAS00001003324";"18";"0";"0";"18";"2018-11-15";"EGA"
"EGAS00001003319";"0";"0";"2";"2";"2018-11-15";"EGA"
"EGAS00001003316";"0";"0";"8";"8";"2018-11-15";"EGA"
"EGAS00001003318";"0";"29";"0";"29";"2018-11-15";"EGA"
"EGAS00001003329";"200";"16";"0";"216";"2018-11-16";"EGA"
"EGAS00001003331";"100";"24";"0";"124";"2018-11-16";"EGA"
"EGAS00001003332";"0";"4";"0";"4";"2018-11-17";"EGA"
"EGAS00001003333";"31";"25";"1";"57";"2018-11-20";"EGA"
"EGAS00001003335";"0";"0";"478";"478";"2018-11-22";"EGA"
"EGAS00001003337";"34";"55";"11";"100";"2018-11-22";"EGA"
"EGAS00001003341";"2";"2";"0";"4";"2018-11-23";"EGA"
"EGAS00001003342";"60";"18";"0";"78";"2018-11-23";"EGA"
"EGAS00001003343";"0";"3";"0";"3";"2018-11-24";"EGA"
"EGAS00001003345";"2";"16";"0";"18";"2018-11-28";"EGA"
"EGAS00001003344";"0";"34";"0";"34";"2018-11-28";"EGA"
"EGAS00001003350";"2";"1";"0";"3";"2018-11-29";"EGA"
"EGAS00001003349";"0";"4375";"0";"4375";"2018-11-29";"EGA"
"EGAS00001003355";"25";"20";"0";"45";"2018-11-30";"EGA"
"EGAS00001003354";"0";"235";"0";"235";"2018-11-30";"EGA"
"EGAS00001003351";"178";"0";"0";"178";"2018-11-30";"EGA"
"EGAS00001003352";"48";"0";"0";"48";"2018-11-30";"EGA"
"EGAS00001003359";"0";"0";"17";"17";"2018-12-03";"EGA"
"EGAS00001003358";"0";"0";"7";"7";"2018-12-03";"EGA"
"EGAS00001003357";"6";"5";"0";"11";"2018-12-03";"EGA"
"EGAS00001003361";"0";"0";"195";"195";"2018-12-04";"EGA"
"EGAS00001003362";"0";"2";"0";"2";"2018-12-05";"EGA"
"EGAS00001003363";"0";"0";"204";"204";"2018-12-05";"EGA"
"EGAS00001003365";"44";"81";"0";"125";"2018-12-06";"EGA"
"EGAS00001003366";"0";"10";"0";"10";"2018-12-07";"EGA"
"EGAS00001003368";"96";"83";"74";"253";"2018-12-07";"EGA"
"EGAS00001003367";"98";"57";"0";"155";"2018-12-07";"EGA"
"EGAS00001003369";"54";"25";"36";"115";"2018-12-08";"EGA"
"EGAS00001003370";"12";"1";"0";"13";"2018-12-11";"EGA"
"EGAS00001003372";"0";"0";"30657";"30657";"2018-12-11";"EGA"
"EGAS00001003380";"0";"0";"290";"290";"2018-12-13";"EGA"
"EGAS00001003385";"30";"24";"0";"54";"2018-12-13";"EGA"
"EGAS00001003384";"4";"5";"0";"9";"2018-12-13";"EGA"
"EGAS00001003382";"103";"47";"39";"189";"2018-12-13";"EGA"
"EGAS00001003383";"1804";"1195";"2";"3001";"2018-12-13";"EGA"
"EGAS00001003387";"0";"3";"0";"3";"2018-12-13";"EGA"
"EGAS00001003386";"0";"0";"30";"30";"2018-12-13";"EGA"
"EGAS00001003388";"58";"7";"0";"65";"2018-12-14";"EGA"
"EGAS00001003399";"0";"0";"48";"48";"2018-12-18";"EGA"
"EGAS00001003396";"244";"105";"0";"349";"2018-12-18";"EGA"
"EGAS00001003397";"2676";"1119";"699";"4494";"2018-12-18";"EGA"
"EGAS00001003400";"7";"10";"0";"17";"2018-12-19";"EGA"
"EGAS00001003406";"19";"8";"0";"27";"2018-12-20";"EGA"
"EGAS00001003405";"38";"12";"0";"50";"2018-12-20";"EGA"
"EGAS00001003407";"76";"124";"0";"200";"2018-12-22";"EGA"
"EGAS00001003408";"0";"0";"236";"236";"2018-12-27";"EGA"
"EGAS00001003409";"0";"0";"118";"118";"2018-12-27";"EGA"
"EGAS00001003412";"15";"5";"0";"20";"2019-01-01";"EGA"
"EGAS00001003415";"132";"213";"0";"345";"2019-01-03";"EGA"
"EGAS00001003414";"1";"0";"3";"4";"2019-01-03";"EGA"
"EGAS00001003419";"674";"637";"0";"1311";"2019-01-09";"EGA"
"EGAS00001003418";"21";"5";"0";"26";"2019-01-09";"EGA"
"EGAS00001003421";"17";"26";"0";"43";"2019-01-10";"EGA"
"EGAS00001003423";"1868";"1421";"0";"3289";"2019-01-14";"EGA"
"EGAS00001003426";"142";"158";"0";"300";"2019-01-16";"EGA"
"EGAS00001003425";"0";"0";"3";"3";"2019-01-16";"EGA"
"EGAS00001003427";"0";"14";"0";"14";"2019-01-16";"EGA"
"EGAS00001003424";"8820";"13398";"9";"22227";"2019-01-16";"EGA"
"EGAS00001003430";"0";"0";"6";"6";"2019-01-17";"EGA"
"EGAS00001003432";"10";"6";"10";"26";"2019-01-18";"EGA"
"EGAS00001003433";"52";"61";"87";"200";"2019-01-19";"EGA"
"EGAS00001003437";"0";"0";"189";"189";"2019-01-22";"EGA"
"EGAS00001003434";"0";"0";"35";"35";"2019-01-22";"EGA"
"EGAS00001003436";"3";"0";"0";"3";"2019-01-22";"EGA"
"EGAS00001003439";"200";"120";"0";"320";"2019-01-23";"EGA"
"EGAS00001003438";"0";"0";"20";"20";"2019-01-23";"EGA"
"EGAS00001003442";"13";"0";"0";"13";"2019-01-24";"EGA"
"EGAS00001003443";"271";"367";"0";"638";"2019-01-25";"EGA"
"EGAS00001003444";"0";"0";"47";"47";"2019-01-25";"EGA"
"EGAS00001003446";"12";"9";"122";"143";"2019-01-26";"EGA"
"EGAS00001003445";"0";"0";"61";"61";"2019-01-26";"EGA"
"EGAS00001003447";"60";"22";"0";"82";"2019-01-27";"EGA"
"EGAS00001003449";"34";"2";"0";"36";"2019-01-28";"EGA"
"EGAS00001003452";"15";"25";"0";"40";"2019-01-29";"EGA"
"EGAS00001003450";"110";"82";"0";"192";"2019-01-29";"EGA"
"EGAS00001003451";"16";"8";"0";"24";"2019-01-29";"EGA"
"EGAS00001003453";"10";"3";"0";"13";"2019-01-30";"EGA"
"EGAS00001003455";"0";"0";"316";"316";"2019-02-02";"EGA"
"EGAS00001003456";"245";"163";"167";"575";"2019-02-02";"EGA"
"EGAS00001003454";"26";"58";"0";"84";"2019-02-02";"EGA"
"EGAS00001003458";"106";"58";"0";"164";"2019-02-02";"EGA"
"EGAS00001003457";"655";"89";"482";"1226";"2019-02-02";"EGA"
"EGAS00001003460";"0";"1";"0";"1";"2019-02-06";"EGA"
"EGAS00001003462";"6";"19";"0";"25";"2019-02-08";"EGA"
"EGAS00001003463";"49";"46";"0";"95";"2019-02-09";"EGA"
"EGAS00001003467";"26";"46";"0";"72";"2019-02-12";"EGA"
"EGAS00001003468";"75";"37";"0";"112";"2019-02-13";"EGA"
"EGAS00001003469";"1";"3";"0";"4";"2019-02-13";"EGA"
"EGAS00001003474";"37";"10";"0";"47";"2019-02-16";"EGA"
"EGAS00001003481";"46";"94";"0";"140";"2019-02-16";"EGA"
"EGAS00001003471";"0";"0";"47";"47";"2019-02-16";"EGA"
"EGAS00001003486";"65";"80";"0";"145";"2019-02-19";"EGA"
"EGAS00001003485";"367";"369";"0";"736";"2019-02-19";"EGA"
"EGAS00001003484";"66";"32";"0";"98";"2019-02-19";"EGA"
"EGAS00001003487";"0";"370";"0";"370";"2019-02-20";"EGA"
"EGAS00001003488";"52";"32";"0";"84";"2019-02-21";"EGA"
"EGAS00001003489";"29";"25";"0";"54";"2019-02-21";"EGA"
"EGAS00001003490";"0";"0";"280";"280";"2019-02-21";"EGA"
"EGAS00001003493";"4";"2";"0";"6";"2019-02-21";"EGA"
"EGAS00001003496";"0";"0";"330";"330";"2019-02-22";"EGA"
"EGAS00001003497";"0";"3";"0";"3";"2019-02-23";"EGA"
"EGAS00001003498";"0";"0";"53";"53";"2019-02-23";"EGA"
"EGAS00001003499";"4602";"5830";"0";"10432";"2019-02-25";"EGA"
"EGAS00001003500";"9";"0";"34";"43";"2019-02-26";"EGA"
"EGAS00001003501";"183";"0";"0";"183";"2019-02-27";"EGA"
"EGAS00001003504";"0";"598";"0";"598";"2019-02-27";"EGA"
"EGAS00001003503";"0";"20";"0";"20";"2019-02-27";"EGA"
"EGAS00001003506";"0";"0";"34";"34";"2019-02-28";"EGA"
"EGAS00001003507";"58";"37";"0";"95";"2019-03-01";"EGA"
"EGAS00001003508";"166";"131";"0";"297";"2019-03-02";"EGA"
"EGAS00001003510";"2";"1";"0";"3";"2019-03-04";"EGA"
"EGAS00001003511";"3008";"3574";"0";"6582";"2019-03-05";"EGA"
"EGAS00001003513";"0";"0";"53";"53";"2019-03-05";"EGA"
"EGAS00001003514";"0";"0";"40";"40";"2019-03-06";"EGA"
"EGAS00001003519";"66";"35";"52";"153";"2019-03-08";"EGA"
"EGAS00001003517";"66";"39";"12";"117";"2019-03-08";"EGA"
"EGAS00001003520";"0";"0";"6";"6";"2019-03-09";"EGA"
"EGAS00001003521";"3";"1";"0";"4";"2019-03-10";"EGA"
"EGAS00001003525";"13";"2";"3";"18";"2019-03-12";"EGA"
"EGAS00001003530";"479";"221";"2";"702";"2019-03-14";"EGA"
"EGAS00001003532";"0";"0";"0";"0";"2019-03-14";"EGA"
"EGAS00001003531";"0";"0";"18";"18";"2019-03-14";"EGA"
"EGAS00001003535";"0";"162";"0";"162";"2019-03-15";"EGA"
"EGAS00001003534";"0";"150";"0";"150";"2019-03-15";"EGA"
"EGAS00001003538";"0";"0";"30";"30";"2019-03-16";"EGA"
"EGAS00001003536";"28";"5";"1";"34";"2019-03-16";"EGA"
"EGAS00001003539";"75";"56";"0";"131";"2019-03-16";"EGA"
"EGAS00001003540";"0";"0";"187";"187";"2019-03-17";"EGA"
"EGAS00001003544";"0";"19";"0";"19";"2019-03-19";"EGA"
"EGAS00001003542";"45";"19";"982";"1046";"2019-03-19";"EGA"
"EGAS00001003545";"0";"239";"0";"239";"2019-03-20";"EGA"
"EGAS00001003547";"248";"148";"0";"396";"2019-03-21";"EGA"
"EGAS00001003546";"15";"12";"0";"27";"2019-03-21";"EGA"
"EGAS00001003548";"25";"108";"0";"133";"2019-03-22";"EGA"
"EGAS00001003549";"1";"53";"224";"278";"2019-03-22";"EGA"
"EGAS00001003554";"0";"2";"0";"2";"2019-03-23";"EGA"
"EGAS00001003555";"0";"22";"0";"22";"2019-03-25";"EGA"
"EGAS00001003556";"0";"180";"0";"180";"2019-03-27";"EGA"
"EGAS00001003558";"0";"0";"14";"14";"2019-03-27";"EGA"
"EGAS00001003560";"0";"0";"42";"42";"2019-03-28";"EGA"
"EGAS00001003563";"205";"134";"0";"339";"2019-03-30";"EGA"
"EGAS00001003564";"0";"8";"0";"8";"2019-03-31";"EGA"
"EGAS00001003565";"576";"361";"3";"940";"2019-04-02";"EGA"
"EGAS00001003570";"78";"97";"0";"175";"2019-04-04";"EGA"
"EGAS00001003572";"0";"1";"0";"1";"2019-04-04";"EGA"
"EGAS00001003571";"0";"0";"7";"7";"2019-04-04";"EGA"
"EGAS00001003573";"74";"89";"0";"163";"2019-04-04";"EGA"
"EGAS00001003576";"0";"0";"50";"50";"2019-04-05";"EGA"
"EGAS00001003575";"4";"5";"1";"10";"2019-04-05";"EGA"
"EGAS00001003579";"52";"0";"0";"52";"2019-04-06";"EGA"
"EGAS00001003582";"104";"23";"0";"127";"2019-04-09";"EGA"
"EGAS00001003586";"40";"30";"0";"70";"2019-04-10";"EGA"
"EGAS00001003583";"60";"70";"0";"130";"2019-04-10";"EGA"
"EGAS00001003585";"28";"33";"0";"61";"2019-04-10";"EGA"
"EGAS00001003596";"0";"9";"0";"9";"2019-04-13";"EGA"
"EGAS00001003594";"0";"0";"20";"20";"2019-04-13";"EGA"
"EGAS00001003592";"0";"3";"0";"3";"2019-04-13";"EGA"
"EGAS00001003598";"26";"139";"0";"165";"2019-04-16";"EGA"
"EGAS00001003599";"2";"1";"0";"3";"2019-04-16";"EGA"
"EGAS00001003600";"115";"57";"0";"172";"2019-04-17";"EGA"
"EGAS00001003601";"0";"0";"18";"18";"2019-04-18";"EGA"
"EGAS00001003605";"0";"0";"59";"59";"2019-04-19";"EGA"
"EGAS00001003602";"181";"3";"0";"184";"2019-04-19";"EGA"
"EGAS00001003603";"97";"48";"1";"146";"2019-04-19";"EGA"
"EGAS00001003611";"189";"348";"0";"537";"2019-04-25";"EGA"
"EGAS00001003616";"0";"0";"15";"15";"2019-04-27";"EGA"
"EGAS00001003620";"78";"6";"0";"84";"2019-04-27";"EGA"
"EGAS00001003617";"47";"0";"0";"47";"2019-04-27";"EGA"
"EGAS00001003624";"190";"8";"0";"198";"2019-04-30";"EGA"
"EGAS00001003623";"1";"1";"0";"2";"2019-04-30";"EGA"
"EGAS00001003631";"0";"97";"0";"97";"2019-05-03";"EGA"
"EGAS00001003633";"800";"499";"0";"1299";"2019-05-03";"EGA"
"EGAS00001003635";"39";"24";"0";"63";"2019-05-03";"EGA"
"EGAS00001003629";"138";"103";"0";"241";"2019-05-03";"EGA"
"EGAS00001003628";"16";"8";"0";"24";"2019-05-03";"EGA"
"EGAS00001003634";"19";"21";"11";"51";"2019-05-03";"EGA"
"EGAS00001003627";"0";"0";"53";"53";"2019-05-03";"EGA"
"EGAS00001003638";"0";"0";"54";"54";"2019-05-04";"EGA"
"EGAS00001003639";"960";"4278";"0";"5238";"2019-05-05";"EGA"
"EGAS00001003645";"2823";"3482";"1";"6306";"2019-05-08";"EGA"
"EGAS00001003644";"19";"3";"0";"22";"2019-05-08";"EGA"
"EGAS00001003643";"19";"3";"0";"22";"2019-05-08";"EGA"
"EGAS00001003642";"170";"161";"0";"331";"2019-05-08";"EGA"
"EGAS00001003646";"16";"20";"0";"36";"2019-05-08";"EGA"
"EGAS00001003647";"19";"31";"8";"58";"2019-05-09";"EGA"
"EGAS00001003648";"0";"0";"0";"0";"2019-05-09";"EGA"
"EGAS00001003650";"5";"1";"2";"8";"2019-05-11";"EGA"
"EGAS00001003651";"6";"0";"0";"6";"2019-05-13";"EGA"
"EGAS00001003652";"58";"13";"8";"79";"2019-05-14";"EGA"
"EGAS00001003653";"120";"0";"0";"120";"2019-05-16";"EGA"
"EGAS00001003654";"76";"6";"0";"82";"2019-05-17";"EGA"
"EGAS00001003656";"0";"0";"45";"45";"2019-05-18";"EGA"
"EGAS00001003657";"132";"62";"0";"194";"2019-05-19";"EGA"
"EGAS00001003658";"4";"6";"0";"10";"2019-05-21";"EGA"
"EGAS00001003659";"0";"0";"38";"38";"2019-05-21";"EGA"
"EGAS00001003660";"12";"2";"0";"14";"2019-05-21";"EGA"
"EGAS00001003661";"214";"154";"0";"368";"2019-05-22";"EGA"
"EGAS00001003662";"172";"909";"0";"1081";"2019-05-22";"EGA"
"EGAS00001003663";"0";"0";"6";"6";"2019-05-23";"EGA"
"EGAS00001003667";"21";"15";"18";"54";"2019-05-27";"EGA"
"EGAS00001003674";"5";"9";"0";"14";"2019-05-29";"EGA"
"EGAS00001003670";"48";"0";"0";"48";"2019-05-29";"EGA"
"EGAS00001003673";"3";"3";"0";"6";"2019-05-29";"EGA"
"EGAS00001003671";"179";"0";"0";"179";"2019-05-29";"EGA"
"EGAS00001003672";"122";"77";"0";"199";"2019-05-29";"EGA"
"EGAS00001003676";"24";"22";"0";"46";"2019-05-29";"EGA"
"EGAS00001003679";"0";"10";"0";"10";"2019-05-31";"EGA"
"EGAS00001003687";"51";"11";"0";"62";"2019-06-04";"EGA"
"EGAS00001003681";"58";"22";"0";"80";"2019-06-04";"EGA"
"EGAS00001003682";"141";"130";"116";"387";"2019-06-04";"EGA"
"EGAS00001003684";"3";"2";"0";"5";"2019-06-04";"EGA"
"EGAS00001003686";"10";"20";"0";"30";"2019-06-04";"EGA"
"EGAS00001003680";"58";"22";"0";"80";"2019-06-04";"EGA"
"EGAS00001003685";"5";"14";"0";"19";"2019-06-04";"EGA"
"EGAS00001003689";"930";"537";"0";"1467";"2019-06-05";"EGA"
"EGAS00001003690";"88";"53";"6";"147";"2019-06-05";"EGA"
"EGAS00001003695";"39";"11";"0";"50";"2019-06-06";"EGA"
"EGAS00001003699";"62";"57";"1";"120";"2019-06-08";"EGA"
"EGAS00001003700";"6";"1";"0";"7";"2019-06-08";"EGA"
"EGAS00001003701";"70";"69";"0";"139";"2019-06-09";"EGA"
"EGAS00001003702";"429";"70";"21";"520";"2019-06-11";"EGA"
"EGAS00001003705";"0";"224";"0";"224";"2019-06-12";"EGA"
"EGAS00001003709";"25";"15";"0";"40";"2019-06-12";"EGA"
"EGAS00001003710";"224";"172";"0";"396";"2019-06-13";"EGA"
"EGAS00001003715";"41";"0";"0";"41";"2019-06-15";"EGA"
"EGAS00001003711";"3";"0";"0";"3";"2019-06-15";"EGA"
"EGAS00001003714";"7";"12";"0";"19";"2019-06-15";"EGA"
"EGAS00001003719";"85";"15";"7";"107";"2019-06-19";"EGA"
"EGAS00001003722";"248";"69";"0";"317";"2019-06-20";"EGA"
"EGAS00001003723";"12";"10";"0";"22";"2019-06-20";"EGA"
"EGAS00001003724";"12";"10";"0";"22";"2019-06-20";"EGA"
"EGAS00001003726";"0";"0";"162";"162";"2019-06-21";"EGA"
"EGAS00001003725";"12";"13";"0";"25";"2019-06-21";"EGA"
"EGAS00001003727";"350";"369";"0";"719";"2019-06-22";"EGA"
"EGAS00001003731";"226";"80";"108";"414";"2019-06-27";"EGA"
"EGAS00001003734";"0";"0";"10";"10";"2019-06-27";"EGA"
"EGAS00001003733";"0";"0";"10";"10";"2019-06-27";"EGA"
"EGAS00001003730";"38";"16";"4";"58";"2019-06-27";"EGA"
"EGAS00001003732";"39";"10";"0";"49";"2019-06-27";"EGA"
"EGAS00001003736";"7";"24";"20";"51";"2019-06-28";"EGA"
"EGAS00001003737";"62";"73";"1";"136";"2019-06-29";"EGA"
"EGAS00001003738";"0";"0";"2";"2";"2019-06-29";"EGA"
"EGAS00001003739";"93";"86";"0";"179";"2019-06-29";"EGA"
"EGAS00001003745";"46";"76";"0";"122";"2019-07-03";"EGA"
"EGAS00001003746";"47";"69";"0";"116";"2019-07-03";"EGA"
"EGAS00001003750";"0";"0";"90";"90";"2019-07-06";"EGA"
"EGAS00001003753";"0";"40";"0";"40";"2019-07-09";"EGA"
"EGAS00001003754";"99";"77";"35";"211";"2019-07-10";"EGA"
"EGAS00001003755";"188";"208";"0";"396";"2019-07-11";"EGA"
"EGAS00001003756";"0";"0";"0";"0";"2019-07-11";"EGA"
"EGAS00001003763";"0";"3";"0";"3";"2019-07-17";"EGA"
"EGAS00001003766";"0";"0";"30";"30";"2019-07-19";"EGA"
"EGAS00001003767";"26";"17";"0";"43";"2019-07-19";"EGA"
"EGAS00001003765";"9";"0";"0";"9";"2019-07-19";"EGA"
"EGAS00001003764";"16";"0";"0";"16";"2019-07-19";"EGA"
"EGAS00001003769";"4";"6";"0";"10";"2019-07-22";"EGA"
"EGAS00001003774";"0";"0";"312";"312";"2019-07-26";"EGA"
"EGAS00001003776";"0";"2";"0";"2";"2019-07-28";"EGA"
"EGAS00001003775";"0";"0";"2";"2";"2019-07-28";"EGA"
"EGAS00001003778";"129";"39";"15";"183";"2019-07-28";"EGA"
"EGAS00001003779";"16";"17";"0";"33";"2019-07-29";"EGA"
"EGAS00001003781";"174";"60";"60";"294";"2019-07-31";"EGA"
"EGAS00001003784";"3";"0";"0";"3";"2019-08-02";"EGA"
"EGAS00001003785";"5";"1";"0";"6";"2019-08-02";"EGA"
"EGAS00001003786";"0";"0";"44";"44";"2019-08-02";"EGA"
"EGAS00001003787";"20";"7";"0";"27";"2019-08-02";"EGA"
"EGAS00001003790";"15";"7";"0";"22";"2019-08-03";"EGA"
"EGAS00001003791";"24";"14";"0";"38";"2019-08-03";"EGA"
"EGAS00001003792";"0";"20";"0";"20";"2019-08-03";"EGA"
"EGAS00001003789";"0";"220";"0";"220";"2019-08-03";"EGA"
"EGAS00001003800";"0";"7";"0";"7";"2019-08-09";"EGA"
"EGAS00001003802";"0";"0";"827";"827";"2019-08-10";"EGA"
"EGAS00001003803";"8";"7";"0";"15";"2019-08-10";"EGA"
"EGAS00001003801";"0";"0";"827";"827";"2019-08-10";"EGA"
"EGAS00001003804";"0";"0";"252";"252";"2019-08-13";"EGA"
"EGAS00001003806";"66";"40";"0";"106";"2019-08-14";"EGA"
"EGAS00001003805";"18242";"37306";"24";"55572";"2019-08-14";"EGA"
"EGAS00001003809";"1";"2";"0";"3";"2019-08-15";"EGA"
"EGAS00001003812";"1191";"487";"0";"1678";"2019-08-17";"EGA"
"EGAS00001003814";"154";"48";"0";"202";"2019-08-20";"EGA"
"EGAS00001003817";"3";"3";"0";"6";"2019-08-21";"EGA"
"EGAS00001003818";"244";"349";"0";"593";"2019-08-21";"EGA"
"EGAS00001003819";"1083";"1062";"0";"2145";"2019-08-21";"EGA"
"EGAS00001003821";"0";"20";"0";"20";"2019-08-22";"EGA"
"EGAS00001003820";"18";"21";"0";"39";"2019-08-22";"EGA"
"EGAS00001003822";"4";"9";"0";"13";"2019-08-23";"EGA"
"EGAS00001003823";"141";"0";"0";"141";"2019-08-24";"EGA"
"EGAS00001003826";"2";"85";"0";"87";"2019-08-25";"EGA"
"EGAS00001003829";"21";"24";"0";"45";"2019-08-27";"EGA"
"EGAS00001003828";"370";"132";"4";"506";"2019-08-27";"EGA"
"EGAS00001003827";"0";"15";"0";"15";"2019-08-27";"EGA"
"EGAS00001003831";"0";"0";"59";"59";"2019-08-28";"EGA"
"EGAS00001003834";"19";"40";"0";"59";"2019-08-28";"EGA"
"EGAS00001003830";"45";"23";"0";"68";"2019-08-28";"EGA"
"EGAS00001003837";"63";"45";"0";"108";"2019-08-29";"EGA"
"EGAS00001003840";"17";"52";"0";"69";"2019-08-31";"EGA"
"EGAS00001003839";"17";"52";"0";"69";"2019-08-31";"EGA"
"EGAS00001003841";"17";"52";"0";"69";"2019-08-31";"EGA"
"EGAS00001003843";"0";"0";"290";"290";"2019-09-05";"EGA"
"EGAS00001003846";"0";"0";"173";"173";"2019-09-06";"EGA"
"EGAS00001003845";"17";"9";"22";"48";"2019-09-06";"EGA"
"EGAS00001003848";"151";"0";"0";"151";"2019-09-10";"EGA"
"EGAS00001003852";"6";"3";"0";"9";"2019-09-10";"EGA"
"EGAS00001003847";"0";"0";"54";"54";"2019-09-10";"EGA"
"EGAS00001003849";"0";"2";"1";"3";"2019-09-10";"EGA"
"EGAS00001003856";"6";"1";"0";"7";"2019-09-11";"EGA"
"EGAS00001003853";"68";"82";"0";"150";"2019-09-11";"EGA"
"EGAS00001003857";"38";"14";"0";"52";"2019-09-11";"EGA"
"EGAS00001003860";"17";"0";"0";"17";"2019-09-16";"EGA"
"EGAS00001003863";"0";"3";"54";"57";"2019-09-16";"EGA"
"EGAS00001003861";"1";"1";"0";"2";"2019-09-16";"EGA"
"EGAS00001003872";"256";"244";"0";"500";"2019-09-18";"EGA"
"EGAS00001003870";"12";"0";"0";"12";"2019-09-18";"EGA"
"EGAS00001003875";"0";"0";"4810";"4810";"2019-09-19";"EGA"
"EGAS00001003876";"5";"4";"0";"9";"2019-09-21";"EGA"
"EGAS00001003882";"11";"0";"150";"161";"2019-09-21";"EGA"
"EGAS00001003883";"22";"53";"0";"75";"2019-09-24";"EGA"
"EGAS00001003887";"90";"63";"0";"153";"2019-09-24";"EGA"
"EGAS00001003886";"6";"4";"0";"10";"2019-09-24";"EGA"
"EGAS00001003889";"18";"7";"0";"25";"2019-09-25";"EGA"
"EGAS00001003892";"54";"52";"0";"106";"2019-09-27";"EGA"
"EGAS00001003893";"118";"26";"0";"144";"2019-09-27";"EGA"
"EGAS00001003897";"9";"11";"0";"20";"2019-09-28";"EGA"
"EGAS00001003899";"154";"0";"0";"154";"2019-09-28";"EGA"
"EGAS00001003896";"150";"24";"0";"174";"2019-09-28";"EGA"
"EGAS00001003895";"34";"15";"0";"49";"2019-09-28";"EGA"
"EGAS00001003901";"74";"68";"0";"142";"2019-10-01";"EGA"
"EGAS00001003922";"21";"12";"0";"33";"2019-10-01";"EGA"
"EGAS00001003917";"98";"74";"8";"180";"2019-10-01";"EGA"
"EGAS00001003923";"3";"3";"0";"6";"2019-10-02";"EGA"
"EGAS00001003931";"0";"0";"634";"634";"2019-10-06";"EGA"
"EGAS00001003932";"0";"0";"368";"368";"2019-10-06";"EGA"
"EGAS00001003934";"0";"20";"0";"20";"2019-10-06";"EGA"
"EGAS00001003928";"50";"0";"0";"50";"2019-10-06";"EGA"
"EGAS00001003942";"5";"0";"0";"5";"2019-10-08";"EGA"
"EGAS00001003946";"0";"0";"8";"8";"2019-10-09";"EGA"
"EGAS00001003944";"127";"63";"4";"194";"2019-10-09";"EGA"
"EGAS00001003952";"0";"0";"85";"85";"2019-10-11";"EGA"
"EGAS00001003951";"0";"8";"0";"8";"2019-10-11";"EGA"
"EGAS00001003950";"9";"18";"0";"27";"2019-10-11";"EGA"
"EGAS00001003953";"234";"182";"0";"416";"2019-10-11";"EGA"
"EGAS00001003955";"35";"52";"0";"87";"2019-10-15";"EGA"
"EGAS00001003958";"115";"0";"0";"115";"2019-10-16";"EGA"
"EGAS00001003963";"10";"8";"0";"18";"2019-10-18";"EGA"
"EGAS00001003962";"12";"54";"0";"66";"2019-10-18";"EGA"
"EGAS00001003964";"0";"0";"17";"17";"2019-10-18";"EGA"
"EGAS00001003968";"75";"48";"0";"123";"2019-10-19";"EGA"
"EGAS00001003970";"26";"18";"0";"44";"2019-10-19";"EGA"
"EGAS00001003973";"78";"0";"0";"78";"2019-10-21";"EGA"
"EGAS00001003974";"167";"85";"0";"252";"2019-10-22";"EGA"
"EGAS00001003975";"189";"97";"490";"776";"2019-10-23";"EGA"
"EGAS00001003976";"0";"0";"48";"48";"2019-10-24";"EGA"
"EGAS00001003979";"0";"0";"2";"2";"2019-10-25";"EGA"
"EGAS00001003980";"0";"44";"0";"44";"2019-10-26";"EGA"
"EGAS00001003989";"0";"0";"125";"125";"2019-10-29";"EGA"
"EGAS00001003982";"48";"18";"0";"66";"2019-10-29";"EGA"
"EGAS00001003987";"0";"0";"28";"28";"2019-10-29";"EGA"
"EGAS00001003991";"9";"13";"0";"22";"2019-10-29";"EGA"
"EGAS00001003984";"0";"0";"18";"18";"2019-10-29";"EGA"
"EGAS00001003985";"0";"0";"18";"18";"2019-10-29";"EGA"
"EGAS00001003988";"0";"0";"28";"28";"2019-10-29";"EGA"
"EGAS00001003986";"15";"22";"0";"37";"2019-10-29";"EGA"
"EGAS00001003993";"6";"39";"0";"45";"2019-10-30";"EGA"
"EGAS00001003994";"12";"76";"0";"88";"2019-10-30";"EGA"
"EGAS00001003996";"0";"0";"21";"21";"2019-10-30";"EGA"
"EGAS00001003992";"13";"15";"0";"28";"2019-10-30";"EGA"
"EGAS00001004000";"149";"97";"0";"246";"2019-11-01";"EGA"
"EGAS00001003997";"127";"128";"0";"255";"2019-11-01";"EGA"
"EGAS00001004003";"1";"0";"0";"1";"2019-11-03";"EGA"
"EGAS00001004006";"0";"0";"394";"394";"2019-11-05";"EGA"
"EGAS00001004007";"254";"292";"0";"546";"2019-11-05";"EGA"
"EGAS00001004008";"9";"1";"0";"10";"2019-11-05";"EGA"
"EGAS00001004009";"0";"0";"24";"24";"2019-11-06";"EGA"
"EGAS00001004015";"0";"2";"0";"2";"2019-11-07";"EGA"
"EGAS00001004014";"0";"25";"0";"25";"2019-11-07";"EGA"
"EGAS00001004016";"0";"0";"1";"1";"2019-11-08";"EGA"
"EGAS00001004018";"0";"0";"9";"9";"2019-11-09";"EGA"
"EGAS00001004019";"6";"3";"0";"9";"2019-11-09";"EGA"
"EGAS00001004020";"30";"0";"0";"30";"2019-11-09";"EGA"
"EGAS00001004022";"0";"0";"117";"117";"2019-11-10";"EGA"
"EGAS00001004023";"29";"0";"0";"29";"2019-11-11";"EGA"
"EGAS00001004026";"551";"403";"0";"954";"2019-11-14";"EGA"
"EGAS00001004027";"0";"0";"177";"177";"2019-11-14";"EGA"
"EGAS00001004028";"0";"3";"0";"3";"2019-11-15";"EGA"
"EGAS00001004031";"0";"7";"0";"7";"2019-11-16";"EGA"
"EGAS00001004032";"50";"20";"0";"70";"2019-11-16";"EGA"
"EGAS00001004030";"0";"8";"0";"8";"2019-11-16";"EGA"
"EGAS00001004033";"14";"3";"0";"17";"2019-11-18";"EGA"
"EGAS00001004034";"9";"4";"0";"13";"2019-11-19";"EGA"
"EGAS00001004035";"6";"0";"0";"6";"2019-11-19";"EGA"
"EGAS00001004036";"59";"95";"0";"154";"2019-11-19";"EGA"
"EGAS00001004042";"118";"73";"0";"191";"2019-11-20";"EGA"
"EGAS00001004043";"7";"10";"0";"17";"2019-11-21";"EGA"
"EGAS00001004044";"118";"73";"0";"191";"2019-11-21";"EGA"
"EGAS00001004050";"87";"0";"0";"87";"2019-11-22";"EGA"
"EGAS00001004053";"26";"5";"0";"31";"2019-11-23";"EGA"
"EGAS00001004055";"3";"0";"0";"3";"2019-11-26";"EGA"
"EGAS00001004056";"118";"73";"0";"191";"2019-11-26";"EGA"
"EGAS00001004059";"16";"0";"0";"16";"2019-11-27";"EGA"
"EGAS00001004066";"98";"102";"233";"433";"2019-11-28";"EGA"
"EGAS00001004063";"75";"106";"0";"181";"2019-11-28";"EGA"
"EGAS00001004070";"6";"2";"0";"8";"2019-11-30";"EGA"
"EGAS00001004071";"137";"169";"0";"306";"2019-11-30";"EGA"
"EGAS00001004074";"34";"12";"0";"46";"2019-12-03";"EGA"
"EGAS00001004077";"8";"22";"0";"30";"2019-12-04";"EGA"
"EGAS00001004079";"8";"16";"0";"24";"2019-12-04";"EGA"
"EGAS00001004078";"8";"21";"0";"29";"2019-12-04";"EGA"
"EGAS00001004076";"0";"5";"0";"5";"2019-12-04";"EGA"
"EGAS00001004080";"0";"0";"29";"29";"2019-12-05";"EGA"
"EGAS00001004084";"2";"2";"0";"4";"2019-12-05";"EGA"
"EGAS00001004081";"148";"149";"0";"297";"2019-12-05";"EGA"
"EGAS00001004082";"14";"21";"0";"35";"2019-12-05";"EGA"
"EGAS00001004085";"42";"14";"0";"56";"2019-12-05";"EGA"
"EGAS00001004087";"250";"584";"0";"834";"2019-12-06";"EGA"
"EGAS00001004092";"1309";"1293";"0";"2602";"2019-12-06";"EGA"
"EGAS00001004086";"6";"5";"0";"11";"2019-12-06";"EGA"
"EGAS00001004088";"8";"0";"0";"8";"2019-12-06";"EGA"
"EGAS00001004090";"0";"0";"160";"160";"2019-12-06";"EGA"
"EGAS00001004091";"0";"0";"74";"74";"2019-12-06";"EGA"
"EGAS00001004093";"0";"4";"0";"4";"2019-12-07";"EGA"
"EGAS00001004097";"46";"35";"0";"81";"2019-12-08";"EGA"
"EGAS00001004107";"0";"0";"379";"379";"2019-12-12";"EGA"
"EGAS00001004106";"24";"10";"18";"52";"2019-12-12";"EGA"
"EGAS00001004110";"0";"0";"12";"12";"2019-12-13";"EGA"
"EGAS00001004111";"5410";"0";"0";"5410";"2019-12-13";"EGA"
"EGAS00001004113";"0";"0";"16";"16";"2019-12-15";"EGA"
"EGAS00001004112";"26";"19";"0";"45";"2019-12-15";"EGA"
"EGAS00001004114";"118";"49";"0";"167";"2019-12-16";"EGA"
"EGAS00001004118";"0";"23";"1";"24";"2019-12-17";"EGA"
"EGAS00001004115";"6";"4";"0";"10";"2019-12-17";"EGA"
"EGAS00001004117";"0";"40";"0";"40";"2019-12-17";"EGA"
"EGAS00001004122";"97";"102";"11";"210";"2019-12-18";"EGA"
"EGAS00001004123";"3";"9";"0";"12";"2019-12-19";"EGA"
"EGAS00001004124";"22";"20";"0";"42";"2019-12-19";"EGA"
"EGAS00001004126";"401";"262";"0";"663";"2019-12-20";"EGA"
"EGAS00001004127";"0";"0";"499";"499";"2019-12-24";"EGA"
"EGAS00001004135";"49";"21";"0";"70";"2020-01-08";"EGA"
"EGAS00001004136";"0";"0";"10";"10";"2020-01-08";"EGA"
"EGAS00001004139";"159";"474";"0";"633";"2020-01-09";"EGA"
"EGAS00001004145";"4";"3";"0";"7";"2020-01-10";"EGA"
"EGAS00001004147";"30";"0";"0";"30";"2020-01-11";"EGA"
"EGAS00001004151";"50";"34";"0";"84";"2020-01-11";"EGA"
"EGAS00001004152";"0";"0";"48";"48";"2020-01-14";"EGA"
"EGAS00001004153";"24";"11";"3";"38";"2020-01-14";"EGA"
"EGAS00001004156";"0";"21";"34";"55";"2020-01-16";"EGA"
"EGAS00001004157";"7";"2";"1";"10";"2020-01-16";"EGA"
"EGAS00001004160";"0";"0";"164";"164";"2020-01-18";"EGA"
"EGAS00001004168";"94";"0";"0";"94";"2020-01-21";"EGA"
"EGAS00001004165";"259";"122";"0";"381";"2020-01-21";"EGA"
"EGAS00001004169";"12";"14";"4";"30";"2020-01-21";"EGA"
"EGAS00001004175";"259";"122";"0";"381";"2020-01-22";"EGA"
"EGAS00001004177";"220";"83";"0";"303";"2020-01-23";"EGA"
"EGAS00001004181";"0";"0";"40";"40";"2020-01-23";"EGA"
"EGAS00001004182";"0";"60";"0";"60";"2020-01-23";"EGA"
"EGAS00001004176";"0";"2";"0";"2";"2020-01-23";"EGA"
"EGAS00001004186";"132";"0";"0";"132";"2020-01-26";"EGA"
"EGAS00001004189";"0";"0";"74";"74";"2020-01-28";"EGA"
"EGAS00001004192";"977";"0";"0";"977";"2020-01-30";"EGA"
"EGAS00001004194";"0";"0";"60";"60";"2020-01-31";"EGA"
"EGAS00001004196";"2";"4";"0";"6";"2020-02-01";"EGA"
"EGAS00001004200";"0";"20";"0";"20";"2020-02-04";"EGA"
"EGAS00001004201";"80";"0";"0";"80";"2020-02-04";"EGA"
"EGAS00001004204";"53";"85";"0";"138";"2020-02-06";"EGA"
"EGAS00001004212";"68";"65";"0";"133";"2020-02-10";"EGA"
"EGAS00001004208";"0";"0";"31";"31";"2020-02-10";"EGA"
"EGAS00001004209";"153";"261";"21";"435";"2020-02-10";"EGA"
"EGAS00001004211";"0";"8";"0";"8";"2020-02-10";"EGA"
"EGAS00001004216";"0";"0";"40";"40";"2020-02-11";"EGA"
"EGAS00001004213";"102";"56";"0";"158";"2020-02-11";"EGA"
"EGAS00001004218";"0";"18";"0";"18";"2020-02-13";"EGA"
"EGAS00001004224";"2";"564";"0";"566";"2020-02-13";"EGA"
"EGAS00001004220";"0";"14";"0";"14";"2020-02-13";"EGA"
"EGAS00001004221";"0";"25";"0";"25";"2020-02-13";"EGA"
"EGAS00001004229";"3";"0";"0";"3";"2020-02-15";"EGA"
"EGAS00001004228";"0";"0";"0";"0";"2020-02-15";"EGA"
"EGAS00001004230";"6";"2";"0";"8";"2020-02-15";"EGA"
"EGAS00001004231";"10";"0";"0";"10";"2020-02-17";"EGA"
"EGAS00001004233";"10";"0";"0";"10";"2020-02-17";"EGA"
"EGAS00001004232";"10";"0";"0";"10";"2020-02-17";"EGA"
"EGAS00001004239";"26";"25";"0";"51";"2020-02-19";"EGA"
"EGAS00001004235";"0";"516";"0";"516";"2020-02-19";"EGA"
"EGAS00001004243";"0";"0";"74";"74";"2020-02-20";"EGA"
"EGAS00001004242";"54";"47";"0";"101";"2020-02-20";"EGA"
"EGAS00001004249";"0";"79";"0";"79";"2020-02-22";"EGA"
"EGAS00001004248";"0";"20";"0";"20";"2020-02-22";"EGA"
"EGAS00001004255";"4";"8";"0";"12";"2020-02-25";"EGA"
"EGAS00001004266";"5";"0";"0";"5";"2020-02-28";"EGA"
"EGAS00001004268";"0";"31";"0";"31";"2020-02-28";"EGA"
"EGAS00001004267";"814";"719";"22";"1555";"2020-02-28";"EGA"
"EGAS00001004271";"30";"15";"0";"45";"2020-02-29";"EGA"
"EGAS00001004272";"44";"0";"0";"44";"2020-02-29";"EGA"
"EGAS00001004270";"2";"0";"0";"2";"2020-02-29";"EGA"
"EGAS00001004273";"4";"12";"0";"16";"2020-03-01";"EGA"
"EGAS00001004274";"4";"12";"0";"16";"2020-03-02";"EGA"
"EGAS00001004276";"542";"534";"0";"1076";"2020-03-03";"EGA"
"EGAS00001004277";"0";"2";"0";"2";"2020-03-03";"EGA"
"EGAS00001004275";"0";"0";"6";"6";"2020-03-03";"EGA"
"EGAS00001004296";"97";"142";"1";"240";"2020-03-09";"EGA"
"EGAS00001004285";"13";"5";"0";"18";"2020-03-09";"EGA"
"EGAS00001004284";"155";"161";"0";"316";"2020-03-09";"EGA"
"EGAS00001004292";"211";"67";"0";"278";"2020-03-09";"EGA"
"EGAS00001004290";"17";"14";"0";"31";"2020-03-09";"EGA"
"EGAS00001004282";"2";"0";"0";"2";"2020-03-09";"EGA"
"EGAS00001004291";"35";"18";"0";"53";"2020-03-09";"EGA"
"EGAS00001004289";"156";"55";"61";"272";"2020-03-09";"EGA"
"EGAS00001004283";"2";"2";"0";"4";"2020-03-09";"EGA"
"EGAS00001004286";"9";"10";"0";"19";"2020-03-09";"EGA"
"EGAS00001004298";"0";"0";"176";"176";"2020-03-10";"EGA"
"EGAS00001004301";"90";"53";"3";"146";"2020-03-10";"EGA"
"EGAS00001004303";"140";"97";"12";"249";"2020-03-11";"EGA"
"EGAS00001004314";"0";"0";"71";"71";"2020-03-26";"EGA"
"EGAS00001004316";"0";"0";"188";"188";"2020-03-26";"EGA"
"EGAS00001004319";"9";"6";"0";"15";"2020-03-26";"EGA"
"EGAS00001004312";"25";"7";"2";"34";"2020-03-26";"EGA"
"EGAS00001004315";"56";"0";"21";"77";"2020-03-26";"EGA"
"EGAS00001004344";"6";"3";"0";"9";"2020-04-22";"EGA"
"EGAS00001004325";"41";"28";"0";"69";"2020-04-22";"EGA"
"EGAS00001004327";"0";"1782";"0";"1782";"2020-04-22";"EGA"
"EGAS00001004352";"226";"126";"36";"388";"2020-04-22";"EGA"
"EGAS00001004358";"73";"12";"0";"85";"2020-04-22";"EGA"
"EGAS00001004347";"11";"9";"0";"20";"2020-04-22";"EGA"
"EGAS00001004343";"3600";"1346";"824";"5770";"2020-04-22";"EGA"
"EGAS00001004355";"0";"0";"213";"213";"2020-04-22";"EGA"
"EGAS00001004342";"0";"0";"37";"37";"2020-04-22";"EGA"
"EGAS00001004341";"130";"110";"0";"240";"2020-04-22";"EGA"
"EGAS00001004329";"794";"156";"161";"1111";"2020-04-22";"EGA"
"EGAS00001004340";"3";"0";"0";"3";"2020-04-22";"EGA"
"EGAS00001004345";"8";"14";"0";"22";"2020-04-22";"EGA"
"EGAS00001004328";"114";"0";"0";"114";"2020-04-22";"EGA"
"EGAS00001004349";"918";"488";"0";"1406";"2020-04-22";"EGA"
"EGAS00001004353";"3939";"1498";"0";"5437";"2020-04-22";"EGA"
"EGAS00001004356";"0";"154";"0";"154";"2020-04-22";"EGA"
"EGAS00001004335";"0";"10";"0";"10";"2020-04-22";"EGA"
"EGAS00001004366";"0";"112";"0";"112";"2020-04-22";"EGA"
"EGAS00001004357";"18";"14";"0";"32";"2020-04-22";"EGA"
"EGAS00001004364";"0";"0";"1";"1";"2020-04-22";"EGA"
"EGAS00001004365";"180";"286";"0";"466";"2020-04-22";"EGA"
"EGAS00001004348";"12";"12";"0";"24";"2020-04-22";"EGA"
"EGAS00001004361";"0";"19";"0";"19";"2020-04-22";"EGA"
"EGAS00001004370";"25";"20";"0";"45";"2020-04-23";"EGA"
"EGAS00001004367";"163";"66";"0";"229";"2020-04-23";"EGA"
"EGAS00001004373";"0";"0";"83";"83";"2020-04-24";"EGA"
"EGAS00001004375";"0";"0";"11";"11";"2020-04-24";"EGA"
"EGAS00001004374";"0";"0";"16";"16";"2020-04-24";"EGA"
"EGAS00001004379";"30";"8";"0";"38";"2020-04-27";"EGA"
"EGAS00001004381";"0";"4";"0";"4";"2020-04-28";"EGA"
"EGAS00001004386";"474";"137";"0";"611";"2020-04-29";"EGA"
"EGAS00001004383";"48";"48";"0";"96";"2020-04-29";"EGA"
"EGAS00001004388";"8";"6";"17";"31";"2020-04-30";"EGA"
"EGAS00001004392";"0";"5";"0";"5";"2020-05-02";"EGA"
"EGAS00001004397";"30";"3";"0";"33";"2020-05-02";"EGA"
"EGAS00001004394";"5";"5";"0";"10";"2020-05-02";"EGA"
"EGAS00001004396";"73";"0";"0";"73";"2020-05-02";"EGA"
"EGAS00001004390";"0";"92";"0";"92";"2020-05-02";"EGA"
"EGAS00001004395";"109";"52";"0";"161";"2020-05-02";"EGA"
"EGAS00001004391";"97";"74";"97";"268";"2020-05-02";"EGA"
"EGAS00001004401";"113";"83";"0";"196";"2020-05-06";"EGA"
"EGAS00001004404";"24";"0";"0";"24";"2020-05-06";"EGA"
"EGAS00001004402";"17";"13";"0";"30";"2020-05-06";"EGA"
"EGAS00001004406";"81";"86";"0";"167";"2020-05-07";"EGA"
"EGAS00001004405";"0";"39";"0";"39";"2020-05-07";"EGA"
"EGAS00001004407";"12";"12";"2131";"2155";"2020-05-08";"EGA"
"EGAS00001004408";"0";"576";"0";"576";"2020-05-09";"EGA"
"EGAS00001004409";"0";"0";"5";"5";"2020-05-09";"EGA"
"EGAS00001004412";"0";"0";"1";"1";"2020-05-10";"EGA"
"EGAS00001004415";"0";"0";"467";"467";"2020-05-12";"EGA"
"EGAS00001004418";"5";"12";"275";"292";"2020-05-12";"EGA"
"EGAS00001004416";"0";"0";"260";"260";"2020-05-12";"EGA"
"EGAS00001004413";"2";"1";"0";"3";"2020-05-12";"EGA"
"EGAS00001004419";"6";"10";"0";"16";"2020-05-13";"EGA"
"EGAS00001004424";"73";"191";"12";"276";"2020-05-14";"EGA"
"EGAS00001004422";"14";"4";"7";"25";"2020-05-14";"EGA"
"EGAS00001004428";"0";"10";"20";"30";"2020-05-15";"EGA"
"EGAS00001004430";"50";"1";"0";"51";"2020-05-16";"EGA"
"EGAS00001004431";"205";"83";"0";"288";"2020-05-17";"EGA"
"EGAS00001004434";"225";"166";"0";"391";"2020-05-20";"EGA"
"EGAS00001004437";"680";"679";"0";"1359";"2020-05-21";"EGA"
"EGAS00001004438";"42";"64";"30";"136";"2020-05-21";"EGA"
"EGAS00001004440";"53";"18";"0";"71";"2020-05-22";"EGA"
"EGAS00001004439";"0";"17";"0";"17";"2020-05-22";"EGA"
"EGAS00001004444";"64";"64";"0";"128";"2020-05-22";"EGA"
"EGAS00001004443";"6";"9";"0";"15";"2020-05-22";"EGA"
"EGAS00001004445";"0";"0";"1036";"1036";"2020-05-22";"EGA"
"EGAS00001004448";"332";"743";"180";"1255";"2020-05-23";"EGA"
"EGAS00001004446";"27";"38";"0";"65";"2020-05-23";"EGA"
"EGAS00001004447";"0";"0";"170";"170";"2020-05-23";"EGA"
"EGAS00001004452";"0";"21";"0";"21";"2020-05-25";"EGA"
"EGAS00001004451";"8";"0";"0";"8";"2020-05-25";"EGA"
"EGAS00001004456";"3";"0";"0";"3";"2020-05-27";"EGA"
"EGAS00001004455";"0";"0";"22";"22";"2020-05-27";"EGA"
"EGAS00001004454";"0";"0";"18";"18";"2020-05-27";"EGA"
"EGAS00001004458";"20";"0";"0";"20";"2020-05-28";"EGA"
"EGAS00001004459";"19";"6";"0";"25";"2020-05-29";"EGA"
"EGAS00001004460";"10";"8";"12";"30";"2020-05-30";"EGA"
"EGAS00001004461";"622";"476";"0";"1098";"2020-05-31";"EGA"
"EGAS00001004467";"14";"0";"0";"14";"2020-06-02";"EGA"
"EGAS00001004466";"0";"18";"0";"18";"2020-06-02";"EGA"
"EGAS00001004468";"19";"2";"0";"21";"2020-06-03";"EGA"
"EGAS00001004470";"29";"40";"0";"69";"2020-06-03";"EGA"
"EGAS00001004472";"33";"46";"5";"84";"2020-06-04";"EGA"
"EGAS00001004473";"9";"68";"0";"77";"2020-06-04";"EGA"
"EGAS00001004476";"4";"44";"0";"48";"2020-06-05";"EGA"
"EGAS00001004479";"12";"10";"0";"22";"2020-06-10";"EGA"
"EGAS00001004480";"676";"799";"20";"1495";"2020-06-11";"EGA"
"EGAS00001004481";"27";"9";"0";"36";"2020-06-11";"EGA"
"EGAS00001004482";"54";"47";"2";"103";"2020-06-11";"EGA"
"EGAS00001004484";"29";"33";"0";"62";"2020-06-12";"EGA"
"EGAS00001004485";"173";"139";"504";"816";"2020-06-13";"EGA"
"EGAS00001004491";"108";"40";"0";"148";"2020-06-17";"EGA"
"EGAS00001004492";"108";"72";"1";"181";"2020-06-18";"EGA"
"EGAS00001004494";"2";"0";"0";"2";"2020-06-19";"EGA"
"EGAS00001004495";"24";"60";"0";"84";"2020-06-20";"EGA"
"EGAS00001004502";"386";"248";"16";"650";"2020-06-23";"EGA"
"EGAS00001004503";"89";"31";"0";"120";"2020-06-23";"EGA"
"EGAS00001004499";"0";"3457";"0";"3457";"2020-06-23";"EGA"
"EGAS00001004504";"2";"0";"0";"2";"2020-06-24";"EGA"
"EGAS00001004505";"93";"28";"0";"121";"2020-06-25";"EGA"
"EGAS00001004508";"0";"0";"19";"19";"2020-06-26";"EGA"
"EGAS00001004507";"254";"76";"0";"330";"2020-06-26";"EGA"
"EGAS00001004511";"5";"10";"0";"15";"2020-06-27";"EGA"
"EGAS00001004510";"0";"66";"0";"66";"2020-06-27";"EGA"
"EGAS00001004512";"0";"0";"4";"4";"2020-06-29";"EGA"
"EGAS00001004517";"16";"16";"0";"32";"2020-06-30";"EGA"
"EGAS00001004516";"0";"9";"0";"9";"2020-06-30";"EGA"
"EGAS00001004515";"53";"19";"0";"72";"2020-06-30";"EGA"
"EGAS00001004518";"0";"2235";"0";"2235";"2020-07-01";"EGA"
"EGAS00001004519";"68";"30";"0";"98";"2020-07-01";"EGA"
"EGAS00001004524";"14";"23";"0";"37";"2020-07-02";"EGA"
"EGAS00001004523";"14";"4";"4";"22";"2020-07-02";"EGA"
"EGAS00001004521";"0";"0";"318";"318";"2020-07-02";"EGA"
"EGAS00001004525";"50";"6";"0";"56";"2020-07-02";"EGA"
"EGAS00001004528";"38";"60";"0";"98";"2020-07-03";"EGA"
"EGAS00001004527";"38";"60";"0";"98";"2020-07-03";"EGA"
"EGAS00001004532";"0";"0";"148";"148";"2020-07-07";"EGA"
"EGAS00001004533";"0";"0";"63";"63";"2020-07-07";"EGA"
"EGAS00001004535";"1";"0";"0";"1";"2020-07-08";"EGA"
"EGAS00001004538";"0";"0";"19";"19";"2020-07-08";"EGA"
"EGAS00001004536";"157";"98";"0";"255";"2020-07-08";"EGA"
"EGAS00001004540";"173";"144";"0";"317";"2020-07-09";"EGA"
"EGAS00001004541";"1";"16";"0";"17";"2020-07-10";"EGA"
"EGAS00001004542";"262";"102";"0";"364";"2020-07-10";"EGA"
"EGAS00001004545";"34";"20";"0";"54";"2020-07-13";"EGA"
"EGAS00001004544";"89";"47";"0";"136";"2020-07-13";"EGA"
"EGAS00001004546";"3";"9";"0";"12";"2020-07-14";"EGA"
"EGAS00001004548";"48";"22";"0";"70";"2020-07-14";"EGA"
"EGAS00001004550";"0";"5";"0";"5";"2020-07-15";"EGA"
"EGAS00001004554";"148";"587";"0";"735";"2020-07-16";"EGA"
"EGAS00001004555";"84";"38";"0";"122";"2020-07-17";"EGA"
"EGAS00001004570";"47";"34";"15";"96";"2020-07-25";"EGA"
"EGAS00001004564";"24";"14";"0";"38";"2020-07-25";"EGA"
"EGAS00001004567";"24";"8";"0";"32";"2020-07-25";"EGA"
"EGAS00001004562";"0";"0";"64";"64";"2020-07-25";"EGA"
"EGAS00001004558";"4";"6";"0";"10";"2020-07-25";"EGA"
"EGAS00001004571";"61";"64";"16";"141";"2020-07-25";"EGA"
"EGAS00001004561";"39";"85";"0";"124";"2020-07-25";"EGA"
"EGAS00001004572";"1192";"1099";"0";"2291";"2020-07-25";"EGA"
"EGAS00001004574";"14";"16";"0";"30";"2020-07-25";"EGA"
"EGAS00001004575";"63";"0";"0";"63";"2020-07-28";"EGA"
"EGAS00001004576";"32";"16";"0";"48";"2020-07-28";"EGA"
"EGAS00001004578";"0";"81";"0";"81";"2020-07-29";"EGA"
"EGAS00001004583";"11";"40";"0";"51";"2020-07-30";"EGA"
"EGAS00001004582";"0";"672";"0";"672";"2020-07-30";"EGA"
"EGAS00001004587";"1652";"1138";"0";"2790";"2020-07-31";"EGA"
"EGAS00001004588";"128";"38";"0";"166";"2020-08-01";"EGA"
"EGAS00001004592";"15";"19";"0";"34";"2020-08-02";"EGA"
"EGAS00001004593";"61";"57";"0";"118";"2020-08-05";"EGA"
"EGAS00001004594";"0";"612";"0";"612";"2020-08-06";"EGA"
"EGAS00001004595";"12";"2";"0";"14";"2020-08-06";"EGA"
"EGAS00001004600";"41";"121";"0";"162";"2020-08-08";"EGA"
"EGAS00001004597";"0";"56";"0";"56";"2020-08-08";"EGA"
"EGAS00001004601";"0";"69";"0";"69";"2020-08-10";"EGA"
"EGAS00001004603";"51";"9";"1";"61";"2020-08-12";"EGA"
"EGAS00001004611";"8";"0";"0";"8";"2020-08-16";"EGA"
"EGAS00001004612";"0";"0";"25";"25";"2020-08-16";"EGA"
"EGAS00001004610";"81";"46";"0";"127";"2020-08-16";"EGA"
"EGAS00001004615";"255";"49";"40";"344";"2020-08-20";"EGA"
"EGAS00001004613";"6";"0";"0";"6";"2020-08-20";"EGA"
"EGAS00001004614";"1";"1";"0";"2";"2020-08-20";"EGA"
"EGAS00001004619";"0";"0";"187";"187";"2020-08-20";"EGA"
"EGAS00001004621";"2";"2";"0";"4";"2020-08-21";"EGA"
"EGAS00001004623";"12";"12";"0";"24";"2020-08-21";"EGA"
"EGAS00001004625";"276";"1005";"1187";"2468";"2020-08-22";"EGA"
"EGAS00001004629";"157";"26";"0";"183";"2020-08-25";"EGA"
"EGAS00001004632";"12";"16";"0";"28";"2020-08-25";"EGA"
"EGAS00001004630";"0";"106";"0";"106";"2020-08-25";"EGA"
"EGAS00001004636";"224";"0";"0";"224";"2020-08-26";"EGA"
"EGAS00001004639";"40";"58";"0";"98";"2020-08-26";"EGA"
"EGAS00001004641";"0";"730";"0";"730";"2020-08-27";"EGA"
"EGAS00001004640";"292";"198";"110";"600";"2020-08-27";"EGA"
"EGAS00001004642";"0";"0";"42";"42";"2020-08-28";"EGA"
"EGAS00001004648";"4";"0";"0";"4";"2020-09-01";"EGA"
"EGAS00001004646";"0";"3";"0";"3";"2020-09-01";"EGA"
"EGAS00001004647";"11";"2";"5";"18";"2020-09-01";"EGA"
"EGAS00001004649";"33";"6";"0";"39";"2020-09-02";"EGA"
"EGAS00001004650";"109";"151";"0";"260";"2020-09-02";"EGA"
"EGAS00001004651";"18";"17";"0";"35";"2020-09-03";"EGA"
"EGAS00001004653";"17";"10";"0";"27";"2020-09-03";"EGA"
"EGAS00001004654";"18";"12";"0";"30";"2020-09-04";"EGA"
"EGAS00001004655";"135";"139";"1";"275";"2020-09-05";"EGA"
"EGAS00001004656";"22";"18";"22";"62";"2020-09-06";"EGA"
"EGAS00001004660";"33";"28";"9";"70";"2020-09-10";"EGA"
"EGAS00001004659";"68";"34";"22";"124";"2020-09-10";"EGA"
"EGAS00001004661";"10";"15";"0";"25";"2020-09-10";"EGA"
"EGAS00001004662";"0";"516";"0";"516";"2020-09-12";"EGA"
"EGAS00001004663";"12";"0";"0";"12";"2020-09-14";"EGA"
"EGAS00001004665";"0";"196";"0";"196";"2020-09-15";"EGA"
"EGAS00001004664";"231";"150";"0";"381";"2020-09-15";"EGA"
"EGAS00001004668";"14";"27";"0";"41";"2020-09-16";"EGA"
"EGAS00001004669";"0";"0";"10";"10";"2020-09-16";"EGA"
"EGAS00001004673";"87";"0";"0";"87";"2020-09-18";"EGA"
"EGAS00001004674";"0";"0";"616";"616";"2020-09-18";"EGA"
"EGAS00001004671";"0";"0";"12";"12";"2020-09-18";"EGA"
"EGAS00001004670";"0";"289";"0";"289";"2020-09-18";"EGA"
"EGAS00001004675";"26";"0";"0";"26";"2020-09-19";"EGA"
"EGAS00001004684";"320";"258";"0";"578";"2020-09-22";"EGA"
"EGAS00001004682";"315";"135";"0";"450";"2020-09-22";"EGA"
"EGAS00001004689";"7";"3";"0";"10";"2020-09-23";"EGA"
"EGAS00001004693";"414";"121";"0";"535";"2020-09-25";"EGA"
"EGAS00001004695";"14";"4";"0";"18";"2020-09-26";"EGA"
"EGAS00001004696";"0";"0";"36";"36";"2020-09-28";"EGA"
"EGAS00001004701";"0";"0";"576";"576";"2020-10-08";"EGA"
"EGAS00001004704";"0";"0";"0";"0";"2020-10-08";"EGA"
"EGAS00001004700";"0";"0";"44";"44";"2020-10-08";"EGA"
"EGAS00001004707";"0";"0";"14";"14";"2020-10-08";"EGA"
"EGAS00001004697";"8";"12";"0";"20";"2020-10-08";"EGA"
"EGAS00001004702";"4";"3";"6";"13";"2020-10-08";"EGA"
"EGAS00001004705";"95";"43";"0";"138";"2020-10-08";"EGA"
"EGAS00001004706";"196";"115";"0";"311";"2020-10-08";"EGA"
"EGAS00001004709";"3";"0";"0";"3";"2020-10-10";"EGA"
"EGAS00001004710";"178";"166";"0";"344";"2020-10-10";"EGA"
"EGAS00001004717";"23";"12";"0";"35";"2020-10-14";"EGA"
"EGAS00001004716";"9534";"20466";"0";"30000";"2020-10-14";"EGA"
"EGAS00001004719";"16";"7";"0";"23";"2020-10-14";"EGA"
"EGAS00001004714";"0";"212";"0";"212";"2020-10-14";"EGA"
"EGAS00001004724";"0";"32";"0";"32";"2020-10-15";"EGA"
"EGAS00001004727";"0";"0";"7";"7";"2020-10-15";"EGA"
"EGAS00001004729";"0";"0";"572";"572";"2020-10-16";"EGA"
"EGAS00001004728";"45";"17";"24";"86";"2020-10-16";"EGA"
"EGAS00001004742";"0";"0";"62";"62";"2020-10-18";"EGA"
"EGAS00001004733";"0";"0";"124";"124";"2020-10-18";"EGA"
"EGAS00001004736";"2";"10";"0";"12";"2020-10-18";"EGA"
"EGAS00001004735";"117";"138";"0";"255";"2020-10-18";"EGA"
"EGAS00001004741";"0";"0";"62";"62";"2020-10-18";"EGA"
"EGAS00001004744";"0";"0";"62";"62";"2020-10-18";"EGA"
"EGAS00001004739";"4";"3";"115";"122";"2020-10-18";"EGA"
"EGAS00001004743";"0";"0";"62";"62";"2020-10-18";"EGA"
"EGAS00001004740";"0";"0";"62";"62";"2020-10-18";"EGA"
"EGAS00001004745";"0";"0";"62";"62";"2020-10-18";"EGA"
"EGAS00001004752";"0";"0";"1112";"1112";"2020-10-20";"EGA"
"EGAS00001004751";"22";"26";"0";"48";"2020-10-20";"EGA"
"EGAS00001004749";"33";"28";"6";"67";"2020-10-20";"EGA"
"EGAS00001004746";"77";"47";"0";"124";"2020-10-20";"EGA"
"EGAS00001004748";"2";"2";"0";"4";"2020-10-20";"EGA"
"EGAS00001004750";"33";"24";"0";"57";"2020-10-20";"EGA"
"EGAS00001004754";"271";"663";"0";"934";"2020-10-21";"EGA"
"EGAS00001004755";"0";"710";"0";"710";"2020-10-21";"EGA"
"EGAS00001004757";"27";"12";"75";"114";"2020-10-21";"EGA"
"EGAS00001004756";"0";"48";"0";"48";"2020-10-21";"EGA"
"EGAS00001004758";"291";"0";"0";"291";"2020-10-22";"EGA"
"EGAS00001004764";"0";"0";"16";"16";"2020-10-24";"EGA"
"EGAS00001004763";"50";"6";"0";"56";"2020-10-24";"EGA"
"EGAS00001004760";"0";"0";"2328";"2328";"2020-10-24";"EGA"
"EGAS00001004766";"114";"55";"0";"169";"2020-10-27";"EGA"
"EGAS00001004765";"11";"0";"0";"11";"2020-10-27";"EGA"
"EGAS00001004769";"2";"2";"22";"26";"2020-10-27";"EGA"
"EGAS00001004768";"2";"2";"22";"26";"2020-10-27";"EGA"
"EGAS00001004767";"20";"15";"0";"35";"2020-10-27";"EGA"
"EGAS00001004773";"0";"24";"0";"24";"2020-10-30";"EGA"
"EGAS00001004772";"24";"9";"0";"33";"2020-10-30";"EGA"
"EGAS00001004770";"20";"0";"0";"20";"2020-10-30";"EGA"
"EGAS00001004780";"0";"0";"91";"91";"2020-11-03";"EGA"
"EGAS00001004777";"6";"0";"0";"6";"2020-11-03";"EGA"
"EGAS00001004782";"6";"0";"0";"6";"2020-11-04";"EGA"
"EGAS00001004784";"95";"0";"0";"95";"2020-11-05";"EGA"
"EGAS00001004783";"16";"35";"0";"51";"2020-11-05";"EGA"
"EGAS00001004796";"6";"6";"0";"12";"2020-11-15";"EGA"
"EGAS00001004797";"0";"0";"21";"21";"2020-11-15";"EGA"
"EGAS00001004793";"2";"1";"0";"3";"2020-11-15";"EGA"
"EGAS00001004798";"0";"0";"11";"11";"2020-11-15";"EGA"
"EGAS00001004800";"368";"0";"0";"368";"2020-11-15";"EGA"
"EGAS00001004795";"0";"0";"103";"103";"2020-11-15";"EGA"
"EGAS00001004794";"0";"0";"103";"103";"2020-11-15";"EGA"
"EGAS00001004805";"55";"36";"0";"91";"2020-11-15";"EGA"
"EGAS00001004789";"11";"0";"0";"11";"2020-11-15";"EGA"
"EGAS00001004808";"34";"34";"0";"68";"2020-11-15";"EGA"
"EGAS00001004792";"50";"35";"0";"85";"2020-11-15";"EGA"
"EGAS00001004791";"6";"6";"0";"12";"2020-11-15";"EGA"
"EGAS00001004788";"0";"0";"152";"152";"2020-11-15";"EGA"
"EGAS00001004812";"297";"110";"0";"407";"2020-11-18";"EGA"
"EGAS00001004814";"0";"79";"0";"79";"2020-11-18";"EGA"
"EGAS00001004810";"322";"224";"6";"552";"2020-11-18";"EGA"
"EGAS00001004809";"0";"159";"0";"159";"2020-11-18";"EGA"
"EGAS00001004816";"0";"0";"151";"151";"2020-11-18";"EGA"
"EGAS00001004824";"139";"480";"0";"619";"2020-11-20";"EGA"
"EGAS00001004820";"1147";"1191";"0";"2338";"2020-11-20";"EGA"
"EGAS00001004821";"31";"31";"0";"62";"2020-11-20";"EGA"
"EGAS00001004827";"3";"3";"6";"12";"2020-11-21";"EGA"
"EGAS00001004828";"1";"0";"0";"1";"2020-11-21";"EGA"
"EGAS00001004826";"0";"0";"6368";"6368";"2020-11-21";"EGA"
"EGAS00001004825";"0";"0";"12";"12";"2020-11-21";"EGA"
"EGAS00001004830";"60";"44";"0";"104";"2020-11-25";"EGA"
"EGAS00001004829";"0";"2";"0";"2";"2020-11-25";"EGA"
"EGAS00001004832";"0";"0";"313";"313";"2020-12-03";"EGA"
"EGAS00001004852";"400";"0";"0";"400";"2020-12-03";"EGA"
"EGAS00001004851";"5";"7";"0";"12";"2020-12-03";"EGA"
"EGAS00001004839";"1";"1";"0";"2";"2020-12-03";"EGA"
"EGAS00001004837";"2";"1";"1";"4";"2020-12-03";"EGA"
"EGAS00001004857";"9";"0";"0";"9";"2020-12-03";"EGA"
"EGAS00001004836";"0";"21";"34";"55";"2020-12-03";"EGA"
"EGAS00001004835";"0";"0";"7";"7";"2020-12-03";"EGA"
"EGAS00001004850";"0";"0";"228";"228";"2020-12-03";"EGA"
"EGAS00001004844";"0";"0";"2383";"2383";"2020-12-03";"EGA"
"EGAS00001004860";"6";"15";"0";"21";"2020-12-03";"EGA"
"EGAS00001004833";"0";"0";"258";"258";"2020-12-03";"EGA"
"EGAS00001004847";"296";"220";"0";"516";"2020-12-03";"EGA"
"EGAS00001004867";"22";"0";"0";"22";"2020-12-04";"EGA"
"EGAS00001004862";"770";"176";"0";"946";"2020-12-04";"EGA"
"EGAS00001004861";"24";"16";"0";"40";"2020-12-04";"EGA"
"EGAS00001004864";"0";"0";"1";"1";"2020-12-04";"EGA"
"EGAS00001004872";"37";"72";"0";"109";"2020-12-04";"EGA"
"EGAS00001004870";"5703";"7780";"6";"13489";"2020-12-04";"EGA"
"EGAS00001004869";"51";"83";"0";"134";"2020-12-04";"EGA"
"EGAS00001004868";"5";"10";"0";"15";"2020-12-04";"EGA"
"EGAS00001004871";"8";"7";"0";"15";"2020-12-04";"EGA"
"EGAS00001004877";"0";"0";"23";"23";"2020-12-08";"EGA"
"EGAS00001004881";"6";"14";"0";"20";"2020-12-09";"EGA"
"EGAS00001004879";"259";"162";"0";"421";"2020-12-09";"EGA"
"EGAS00001004878";"17";"9";"0";"26";"2020-12-09";"EGA"
"EGAS00001004880";"36";"38";"0";"74";"2020-12-09";"EGA"
"EGAS00001004885";"63";"37";"0";"100";"2020-12-11";"EGA"
"EGAS00001004886";"52";"96";"16";"164";"2020-12-11";"EGA"
"EGAS00001004888";"0";"0";"813";"813";"2020-12-11";"EGA"
"EGAS00001004889";"127";"47";"0";"174";"2020-12-12";"EGA"
"EGAS00001004894";"101";"10";"0";"111";"2020-12-12";"EGA"
"EGAS00001004890";"0";"130";"0";"130";"2020-12-12";"EGA"
"EGAS00001004895";"82";"111";"45";"238";"2020-12-13";"EGA"
"EGAS00001004897";"0";"0";"7";"7";"2020-12-14";"EGA"
"EGAS00001004900";"0";"158";"0";"158";"2020-12-15";"EGA"
"EGAS00001004899";"0";"2";"0";"2";"2020-12-15";"EGA"
"EGAS00001004904";"34";"0";"0";"34";"2020-12-15";"EGA"
"EGAS00001004903";"42";"0";"0";"42";"2020-12-15";"EGA"
"EGAS00001004902";"0";"8";"0";"8";"2020-12-15";"EGA"
"EGAS00001004907";"57";"0";"0";"57";"2020-12-16";"EGA"
"EGAS00001004906";"23";"10";"40";"73";"2020-12-16";"EGA"
"EGAS00001004905";"111";"107";"0";"218";"2020-12-16";"EGA"
"EGAS00001004908";"24";"12";"0";"36";"2020-12-16";"EGA"
"EGAS00001004915";"6";"0";"0";"6";"2020-12-18";"EGA"
"EGAS00001004912";"0";"0";"23";"23";"2020-12-18";"EGA"
"EGAS00001004913";"145";"125";"1";"271";"2020-12-18";"EGA"
"EGAS00001004918";"0";"0";"100";"100";"2020-12-19";"EGA"
"EGAS00001004925";"0";"86";"0";"86";"2020-12-22";"EGA"
"EGAS00001004926";"32";"9";"40";"81";"2020-12-23";"EGA"
"EGAS00001004927";"67";"19";"0";"86";"2020-12-23";"EGA"
"EGAS00001004928";"5";"3";"2";"10";"2020-12-24";"EGA"
"EGAS00001004931";"0";"0";"100";"100";"2020-12-30";"EGA"
"EGAS00001004933";"1880";"2615";"112";"4607";"2021-01-02";"EGA"
"EGAS00001004934";"0";"0";"228";"228";"2021-01-07";"EGA"
"EGAS00001004936";"124";"109";"0";"233";"2021-01-07";"EGA"
"EGAS00001004935";"0";"118";"0";"118";"2021-01-07";"EGA"
"EGAS00001004943";"271";"495";"0";"766";"2021-01-13";"EGA"
"EGAS00001004941";"39";"24";"0";"63";"2021-01-13";"EGA"
"EGAS00001004949";"151";"94";"0";"245";"2021-01-13";"EGA"
"EGAS00001004940";"2";"64";"0";"66";"2021-01-13";"EGA"
"EGAS00001004944";"0";"44";"0";"44";"2021-01-13";"EGA"
"EGAS00001004946";"0";"9";"0";"9";"2021-01-13";"EGA"
"EGAS00001004947";"0";"11";"0";"11";"2021-01-13";"EGA"
"EGAS00001004948";"0";"7";"0";"7";"2021-01-13";"EGA"
"EGAS00001004950";"31";"178";"0";"209";"2021-01-14";"EGA"
"EGAS00001004953";"0";"94";"0";"94";"2021-01-14";"EGA"
"EGAS00001004951";"176";"46";"28";"250";"2021-01-14";"EGA"
"EGAS00001004959";"112";"120";"0";"232";"2021-01-15";"EGA"
"EGAS00001004960";"0";"16";"0";"16";"2021-01-16";"EGA"
"EGAS00001004962";"168";"87";"0";"255";"2021-01-16";"EGA"
"EGAS00001004964";"150";"170";"0";"320";"2021-01-20";"EGA"
"EGAS00001004973";"0";"0";"24";"24";"2021-01-20";"EGA"
"EGAS00001004966";"16";"15";"0";"31";"2021-01-20";"EGA"
"EGAS00001004970";"0";"0";"89";"89";"2021-01-20";"EGA"
"EGAS00001004967";"0";"0";"89";"89";"2021-01-20";"EGA"
"EGAS00001004971";"0";"0";"89";"89";"2021-01-20";"EGA"
"EGAS00001004975";"10";"6";"2";"18";"2021-01-20";"EGA"
"EGAS00001004969";"0";"0";"89";"89";"2021-01-20";"EGA"
"EGAS00001004968";"0";"0";"89";"89";"2021-01-20";"EGA"
"EGAS00001004979";"0";"0";"205";"205";"2021-01-22";"EGA"
"EGAS00001004982";"130";"188";"0";"318";"2021-01-22";"EGA"
"EGAS00001004989";"10";"9";"0";"19";"2021-01-25";"EGA"
"EGAS00001004988";"0";"0";"12";"12";"2021-01-25";"EGA"
"EGAS00001004987";"0";"12";"0";"12";"2021-01-25";"EGA"
"EGAS00001004998";"127";"163";"23";"313";"2021-02-03";"EGA"
"EGAS00001005000";"13";"0";"0";"13";"2021-02-03";"EGA"
"EGAS00001004994";"0";"192";"0";"192";"2021-02-03";"EGA"
"EGAS00001004992";"12";"1";"0";"13";"2021-02-03";"EGA"
"EGAS00001004997";"4768";"1342";"0";"6110";"2021-02-03";"EGA"
"EGAS00001004996";"146";"79";"0";"225";"2021-02-03";"EGA"
"EGAS00001005008";"10";"18";"9";"37";"2021-02-03";"EGA"
"EGAS00001004990";"24";"6";"0";"30";"2021-02-03";"EGA"
"EGAS00001004999";"21";"27";"0";"48";"2021-02-03";"EGA"
"EGAS00001005001";"6";"4";"0";"10";"2021-02-03";"EGA"
"EGAS00001004995";"55";"95";"0";"150";"2021-02-03";"EGA"
"EGAS00001005004";"0";"29";"0";"29";"2021-02-03";"EGA"
"EGAS00001005021";"6";"29";"0";"35";"2021-02-04";"EGA"
"EGAS00001005020";"0";"0";"12667";"12667";"2021-02-04";"EGA"
"EGAS00001005011";"9";"8";"0";"17";"2021-02-04";"EGA"
"EGAS00001005018";"21";"0";"0";"21";"2021-02-04";"EGA"
"EGAS00001005013";"562";"329";"0";"891";"2021-02-04";"EGA"
"EGAS00001005022";"20";"17";"0";"37";"2021-02-04";"EGA"
"EGAS00001005019";"16";"15";"0";"31";"2021-02-04";"EGA"
"EGAS00001005015";"8";"7";"0";"15";"2021-02-04";"EGA"
"EGAS00001005012";"620";"671";"186";"1477";"2021-02-04";"EGA"
"EGAS00001005023";"43";"11";"0";"54";"2021-02-04";"EGA"
"EGAS00001005026";"3912";"3702";"0";"7614";"2021-02-05";"EGA"
"EGAS00001005027";"3464";"4780";"0";"8244";"2021-02-06";"EGA"
"EGAS00001005030";"22";"18";"0";"40";"2021-02-10";"EGA"
"EGAS00001005029";"5";"18";"0";"23";"2021-02-10";"EGA"
"EGAS00001005033";"0";"281";"0";"281";"2021-02-10";"EGA"
"EGAS00001005032";"328";"215";"200";"743";"2021-02-10";"EGA"
"EGAS00001005039";"0";"0";"15";"15";"2021-02-12";"EGA"
"EGAS00001005042";"1233";"1267";"13";"2513";"2021-02-12";"EGA"
"EGAS00001005040";"1";"1";"0";"2";"2021-02-12";"EGA"
"EGAS00001005038";"0";"0";"7231";"7231";"2021-02-12";"EGA"
"EGAS00001005045";"436";"2510";"0";"2946";"2021-02-13";"EGA"
"EGAS00001005046";"0";"11";"0";"11";"2021-02-13";"EGA"
"EGAS00001005050";"39";"8";"0";"47";"2021-02-17";"EGA"
"EGAS00001005051";"4";"2";"433";"439";"2021-02-17";"EGA"
"EGAS00001005052";"955";"2926";"0";"3881";"2021-02-17";"EGA"
"EGAS00001005055";"436";"5746";"0";"6182";"2021-02-17";"EGA"
"EGAS00001005054";"0";"0";"419";"419";"2021-02-17";"EGA"
"EGAS00001005057";"0";"0";"0";"0";"2021-02-18";"EGA"
"EGAS00001005060";"4";"0";"0";"4";"2021-02-19";"EGA"
"EGAS00001005061";"0";"5";"0";"5";"2021-02-19";"EGA"
"EGAS00001005065";"5";"10";"0";"15";"2021-02-20";"EGA"
"EGAS00001005070";"0";"133";"0";"133";"2021-02-24";"EGA"
"EGAS00001005071";"5";"0";"0";"5";"2021-02-24";"EGA"
"EGAS00001005073";"201";"36";"0";"237";"2021-02-24";"EGA"
"EGAS00001005068";"144";"16";"0";"160";"2021-02-24";"EGA"
"EGAS00001005069";"6";"9";"0";"15";"2021-02-24";"EGA"
"EGAS00001005066";"0";"4";"0";"4";"2021-02-24";"EGA"
"EGAS00001005075";"62";"42";"0";"104";"2021-02-25";"EGA"
"EGAS00001005077";"4";"9";"0";"13";"2021-02-26";"EGA"
"EGAS00001005076";"0";"424";"0";"424";"2021-02-26";"EGA"
"EGAS00001005084";"142";"91";"116";"349";"2021-03-02";"EGA"
"EGAS00001005081";"0";"0";"143";"143";"2021-03-02";"EGA"
"EGAS00001005083";"0";"0";"1094";"1094";"2021-03-02";"EGA"
"EGAS00001005086";"0";"9";"0";"9";"2021-03-03";"EGA"
"EGAS00001005085";"0";"0";"59";"59";"2021-03-03";"EGA"
"EGAS00001005087";"50";"19";"0";"69";"2021-03-03";"EGA"
"EGAS00001005097";"36";"2";"0";"38";"2021-03-06";"EGA"
"EGAS00001005093";"0";"0";"198";"198";"2021-03-06";"EGA"
"EGAS00001005096";"82";"103";"0";"185";"2021-03-06";"EGA"
"EGAS00001005102";"0";"0";"3";"3";"2021-03-10";"EGA"
"EGAS00001005104";"198";"225";"0";"423";"2021-03-10";"EGA"
"EGAS00001005099";"147356";"301156";"364";"448876";"2021-03-10";"EGA"
"EGAS00001005109";"72";"150";"0";"222";"2021-03-12";"EGA"
"EGAS00001005110";"0";"0";"1";"1";"2021-03-12";"EGA"
"EGAS00001005107";"51";"40";"15";"106";"2021-03-12";"EGA"
"EGAS00001005108";"140";"94";"0";"234";"2021-03-12";"EGA"
"EGAS00001005115";"0";"18";"0";"18";"2021-03-14";"EGA"
"EGAS00001005116";"0";"3";"0";"3";"2021-03-15";"EGA"
"EGAS00001005121";"2";"2";"22";"26";"2021-03-16";"EGA"
"EGAS00001005125";"20";"22";"0";"42";"2021-03-17";"EGA"
"EGAS00001005130";"0";"27";"0";"27";"2021-03-18";"EGA"
"EGAS00001005128";"0";"27";"0";"27";"2021-03-18";"EGA"
"EGAS00001005127";"207";"136";"3";"346";"2021-03-18";"EGA"
"EGAS00001005132";"141";"108";"0";"249";"2021-03-19";"EGA"
"EGAS00001005134";"0";"13";"0";"13";"2021-03-20";"EGA"
"EGAS00001005137";"17";"0";"0";"17";"2021-03-24";"EGA"
"EGAS00001005138";"0";"32";"0";"32";"2021-03-24";"EGA"
"EGAS00001005140";"15";"13";"0";"28";"2021-03-24";"EGA"
"EGAS00001005151";"0";"0";"4";"4";"2021-03-27";"EGA"
"EGAS00001005147";"63";"3";"0";"66";"2021-03-27";"EGA"
"EGAS00001005160";"0";"0";"64";"64";"2021-03-29";"EGA"
"EGAS00001005159";"0";"0";"56";"56";"2021-03-29";"EGA"
"EGAS00001005161";"0";"0";"52";"52";"2021-03-29";"EGA"
"EGAS00001005171";"0";"0";"1243";"1243";"2021-03-31";"EGA"
"EGAS00001005173";"0";"26";"0";"26";"2021-04-01";"EGA"
"EGAS00001005178";"0";"1";"0";"1";"2021-04-02";"EGA"
"EGAS00001005174";"0";"0";"2";"2";"2021-04-02";"EGA"
"EGAS00001005181";"1";"0";"0";"1";"2021-04-03";"EGA"
"EGAS00001005180";"12";"10";"0";"22";"2021-04-03";"EGA"
"EGAS00001005187";"17";"30";"0";"47";"2021-04-07";"EGA"
"EGAS00001005182";"17";"21";"0";"38";"2021-04-07";"EGA"
"EGAS00001005188";"0";"182";"0";"182";"2021-04-08";"EGA"
"EGAS00001005201";"7";"9";"0";"16";"2021-04-15";"EGA"
"EGAS00001005202";"3";"8";"17";"28";"2021-04-15";"EGA"
"EGAS00001005199";"19";"53";"0";"72";"2021-04-15";"EGA"
"EGAS00001005206";"14";"0";"0";"14";"2021-04-16";"EGA"
"EGAS00001005204";"146";"0";"0";"146";"2021-04-16";"EGA"
"EGAS00001005222";"54";"12";"0";"66";"2021-04-19";"EGA"
"EGAS00001005225";"18";"48";"0";"66";"2021-04-19";"EGA"
"EGAS00001005221";"39";"5";"0";"44";"2021-04-19";"EGA"
"EGAS00001005214";"6";"0";"0";"6";"2021-04-19";"EGA"
"EGAS00001005224";"0";"0";"5";"5";"2021-04-19";"EGA"
"EGAS00001005215";"6";"0";"0";"6";"2021-04-19";"EGA"
"EGAS00001005220";"0";"4";"0";"4";"2021-04-19";"EGA"
"EGAS00001005232";"90";"143";"16";"249";"2021-04-25";"EGA"
"EGAS00001005230";"0";"0";"661";"661";"2021-04-25";"EGA"
"EGAS00001005237";"16";"9";"0";"25";"2021-04-27";"EGA"
"EGAS00001005234";"2";"4";"0";"6";"2021-04-27";"EGA"
"EGAS00001005243";"10";"7";"0";"17";"2021-04-29";"EGA"
"EGAS00001005242";"221";"539";"0";"760";"2021-04-29";"EGA"
"EGAS00001005248";"0";"0";"182";"182";"2021-04-29";"EGA"
"EGAS00001005245";"9";"31";"0";"40";"2021-04-29";"EGA"
"EGAS00001005255";"0";"0";"43";"43";"2021-05-04";"EGA"
"EGAS00001005256";"0";"0";"3";"3";"2021-05-04";"EGA"
"EGAS00001005258";"10";"1";"0";"11";"2021-05-05";"EGA"
"EGAS00001005268";"0";"0";"142";"142";"2021-05-06";"EGA"
"EGAS00001005263";"96";"180";"0";"276";"2021-05-06";"EGA"
"EGAS00001005276";"12";"24";"0";"36";"2021-05-08";"EGA"
"EGAS00001005274";"23";"16";"0";"39";"2021-05-08";"EGA"
"EGAS00001005280";"8";"3";"0";"11";"2021-05-12";"EGA"
"EGAS00001005286";"0";"0";"19";"19";"2021-05-12";"EGA"
"EGAS00001005281";"0";"5";"1";"6";"2021-05-12";"EGA"
"EGAS00001005277";"57";"0";"0";"57";"2021-05-12";"EGA"
"EGAS00001005299";"82";"16";"0";"98";"2021-05-17";"EGA"
"EGAS00001005300";"645";"373";"0";"1018";"2021-05-17";"EGA"
"EGAS00001005304";"6373";"4493";"4";"10870";"2021-05-18";"EGA"
"EGAS00001005303";"25";"14";"0";"39";"2021-05-18";"EGA"
"EGAS00001005305";"17";"7";"0";"24";"2021-05-19";"EGA"
"EGAS00001005312";"294";"229";"0";"523";"2021-05-20";"EGA"
"EGAS00001005313";"0";"4";"0";"4";"2021-05-20";"EGA"
"EGAS00001005314";"28";"46";"0";"74";"2021-05-20";"EGA"
"EGAS00001005317";"99";"84";"1";"184";"2021-05-20";"EGA"
"EGAS00001005319";"0";"0";"491";"491";"2021-05-21";"EGA"
"EGAS00001005321";"13";"9";"0";"22";"2021-05-22";"EGA"
"EGAS00001005320";"0";"6";"0";"6";"2021-05-22";"EGA"
"EGAS00001005323";"0";"1092";"0";"1092";"2021-05-26";"EGA"
"EGAS00001005329";"0";"0";"229";"229";"2021-05-27";"EGA"
"EGAS00001005328";"70";"12";"0";"82";"2021-05-27";"EGA"
"EGAS00001005326";"46";"33";"0";"79";"2021-05-27";"EGA"
"EGAS00001005325";"0";"0";"19";"19";"2021-05-27";"EGA"
"EGAS00001005332";"476";"292";"0";"768";"2021-05-28";"EGA"
"EGAS00001005331";"6";"0";"0";"6";"2021-05-28";"EGA"
"EGAS00001005339";"56";"58";"0";"114";"2021-05-29";"EGA"
"EGAS00001005341";"23";"64";"0";"87";"2021-05-29";"EGA"
"EGAS00001005340";"420";"452";"0";"872";"2021-05-29";"EGA"
"EGAS00001005346";"3";"1";"0";"4";"2021-06-02";"EGA"
"EGAS00001005350";"58";"72";"0";"130";"2021-06-02";"EGA"
"EGAS00001005345";"1";"0";"0";"1";"2021-06-02";"EGA"
"EGAS00001005347";"0";"0";"6";"6";"2021-06-02";"EGA"
"EGAS00001005343";"310";"96";"0";"406";"2021-06-02";"EGA"
"EGAS00001005348";"1055";"1350";"5";"2410";"2021-06-02";"EGA"
"EGAS00001005356";"54";"55";"0";"109";"2021-06-03";"EGA"
"EGAS00001005354";"2";"1";"0";"3";"2021-06-03";"EGA"
"EGAS00001005357";"2";"2";"0";"4";"2021-06-03";"EGA"
"EGAS00001005355";"2";"0";"0";"2";"2021-06-03";"EGA"
"EGAS00001005352";"35";"4";"0";"39";"2021-06-03";"EGA"
"EGAS00001005359";"210";"126";"60";"396";"2021-06-04";"EGA"
"EGAS00001005358";"0";"8";"0";"8";"2021-06-04";"EGA"
"EGAS00001005366";"6";"0";"0";"6";"2021-06-09";"EGA"
"EGAS00001005368";"1";"0";"0";"1";"2021-06-09";"EGA"
"EGAS00001005369";"46";"47";"0";"93";"2021-06-09";"EGA"
"EGAS00001005363";"5";"10";"0";"15";"2021-06-09";"EGA"
"EGAS00001005372";"2";"1";"0";"3";"2021-06-11";"EGA"
"EGAS00001005373";"12429";"15593";"0";"28022";"2021-06-11";"EGA"
"EGAS00001005376";"378";"462";"148";"988";"2021-06-12";"EGA"
"EGAS00001005378";"25";"27";"0";"52";"2021-06-12";"EGA"
"EGAS00001005377";"0";"0";"8";"8";"2021-06-12";"EGA"
"EGAS00001005380";"0";"0";"11";"11";"2021-06-12";"EGA"
"EGAS00001005379";"68";"107";"2";"177";"2021-06-12";"EGA"
"EGAS00001005387";"7";"8";"1";"16";"2021-06-15";"EGA"
"EGAS00001005384";"11";"8";"0";"19";"2021-06-15";"EGA"
"EGAS00001005393";"28";"30";"0";"58";"2021-06-17";"EGA"
"EGAS00001005392";"12";"12";"0";"24";"2021-06-17";"EGA"
"EGAS00001005394";"0";"0";"161";"161";"2021-06-17";"EGA"
"EGAS00001005395";"0";"20";"0";"20";"2021-06-19";"EGA"
"EGAS00001005401";"44";"49";"6";"99";"2021-06-19";"EGA"
"EGAS00001005399";"33";"0";"0";"33";"2021-06-19";"EGA"
"EGAS00001005398";"2";"0";"0";"2";"2021-06-19";"EGA"
"EGAS00001005396";"9";"9";"0";"18";"2021-06-19";"EGA"
"EGAS00001005405";"5";"0";"1";"6";"2021-06-22";"EGA"
"EGAS00001005402";"8";"36";"0";"44";"2021-06-22";"EGA"
"EGAS00001005403";"11";"5";"0";"16";"2021-06-22";"EGA"
"EGAS00001005412";"4003";"3278";"0";"7281";"2021-06-23";"EGA"
"EGAS00001005407";"0";"0";"5";"5";"2021-06-23";"EGA"
"EGAS00001005411";"215";"167";"0";"382";"2021-06-23";"EGA"
"EGAS00001005414";"0";"36";"0";"36";"2021-06-23";"EGA"
"EGAS00001005408";"0";"0";"96";"96";"2021-06-23";"EGA"
"EGAS00001005417";"355";"200";"0";"555";"2021-06-25";"EGA"
"EGAS00001005422";"115";"106";"0";"221";"2021-06-29";"EGA"
"EGAS00001005420";"27";"27";"19";"73";"2021-06-29";"EGA"
"EGAS00001005418";"0";"0";"8";"8";"2021-06-29";"EGA"
"EGAS00001005421";"1271";"679";"0";"1950";"2021-06-29";"EGA"
"EGAS00001005424";"0";"0";"27";"27";"2021-06-30";"EGA"
"EGAS00001005432";"268";"169";"0";"437";"2021-07-03";"EGA"
"EGAS00001005437";"434";"228";"0";"662";"2021-07-03";"EGA"
"EGAS00001005435";"309";"234";"2";"545";"2021-07-03";"EGA"
"EGAS00001005436";"0";"0";"346";"346";"2021-07-03";"EGA"
"EGAS00001005433";"268";"169";"0";"437";"2021-07-03";"EGA"
"EGAS00001005431";"268";"169";"0";"437";"2021-07-03";"EGA"
"EGAS00001005434";"74";"59";"0";"133";"2021-07-03";"EGA"
"EGAS00001005430";"55";"30";"0";"85";"2021-07-03";"EGA"
"EGAS00001005448";"0";"0";"3";"3";"2021-07-07";"EGA"
"EGAS00001005453";"0";"0";"0";"0";"2021-07-07";"EGA"
"EGAS00001005455";"0";"96";"0";"96";"2021-07-08";"EGA"
"EGAS00001005454";"0";"0";"62";"62";"2021-07-08";"EGA"
"EGAS00001005458";"821";"971";"0";"1792";"2021-07-13";"EGA"
"EGAS00001005461";"43";"43";"0";"86";"2021-07-13";"EGA"
"EGAS00001005457";"0";"0";"818";"818";"2021-07-13";"EGA"
"EGAS00001005462";"0";"0";"89";"89";"2021-07-13";"EGA"
"EGAS00001005464";"54";"66";"0";"120";"2021-07-14";"EGA"
"EGAS00001005465";"79";"76";"35";"190";"2021-07-15";"EGA"
"EGAS00001005466";"0";"0";"64";"64";"2021-07-16";"EGA"
"EGAS00001005470";"117";"58";"0";"175";"2021-07-22";"EGA"
"EGAS00001005480";"21";"8";"0";"29";"2021-07-27";"EGA"
"EGAS00001005482";"65";"75";"0";"140";"2021-07-27";"EGA"
"EGAS00001005478";"94";"51";"0";"145";"2021-07-27";"EGA"
"EGAS00001005493";"989";"912";"77";"1978";"2021-07-29";"EGA"
"EGAS00001005496";"3";"0";"0";"3";"2021-07-29";"EGA"
"EGAS00001005495";"109";"52";"6";"167";"2021-07-29";"EGA"
"EGAS00001005512";"383";"217";"0";"600";"2021-08-02";"EGA"
"EGAS00001005511";"383";"217";"0";"600";"2021-08-02";"EGA"
"EGAS00001005502";"7";"3";"0";"10";"2021-08-02";"EGA"
"EGAS00001005507";"94";"40";"0";"134";"2021-08-02";"EGA"
"EGAS00001005513";"18";"6";"0";"24";"2021-08-04";"EGA"
"EGAS00001005516";"76";"43";"2";"121";"2021-08-04";"EGA"
"EGAS00001005518";"2";"10";"0";"12";"2021-08-05";"EGA"
"EGAS00001005517";"0";"1440";"0";"1440";"2021-08-05";"EGA"
"EGAS00001005522";"30";"0";"0";"30";"2021-08-08";"EGA"
"EGAS00001005530";"0";"0";"47";"47";"2021-08-10";"EGA"
"EGAS00001005533";"0";"0";"144";"144";"2021-08-10";"EGA"
"EGAS00001005532";"106";"253";"0";"359";"2021-08-10";"EGA"
"EGAS00001005535";"146";"104";"4";"254";"2021-08-16";"EGA"
"EGAS00001005524";"54";"72";"0";"126";"2021-08-16";"EGA"
"EGAS00001005540";"40";"16";"10";"66";"2021-08-16";"EGA"
"EGAS00001005539";"144";"175";"0";"319";"2021-08-16";"EGA"
"EGAS00001005536";"8";"2";"0";"10";"2021-08-16";"EGA"
"EGAS00001005541";"21";"6";"0";"27";"2021-08-17";"EGA"
"EGAS00001005498";"0";"74";"0";"74";"2021-08-17";"EGA"
"EGAS00001005499";"35";"48";"0";"83";"2021-08-17";"EGA"
"EGAS00001005543";"9";"5";"7";"21";"2021-08-19";"EGA"
"EGAS00001005550";"0";"0";"51";"51";"2021-08-20";"EGA"
"EGAS00001005554";"609";"549";"0";"1158";"2021-08-23";"EGA"
"EGAS00001005558";"76";"17";"0";"93";"2021-08-25";"EGA"
"EGAS00001005556";"0";"0";"876";"876";"2021-08-25";"EGA"
"EGAS00001005560";"0";"0";"62";"62";"2021-08-27";"EGA"
"EGAS00001005565";"0";"0";"0";"0";"2021-09-01";"EGA"
"EGAS00001005569";"78";"77";"0";"155";"2021-09-01";"EGA"
"EGAS00001005577";"0";"36";"0";"36";"2021-09-04";"EGA"
"EGAS00001005579";"0";"0";"79";"79";"2021-09-04";"EGA"
"EGAS00001005573";"67";"69";"0";"136";"2021-09-04";"EGA"
"EGAS00001005582";"9";"27";"0";"36";"2021-09-06";"EGA"
"EGAS00001005583";"27";"18";"0";"45";"2021-09-07";"EGA"
"EGAS00001005588";"14";"14";"17";"45";"2021-09-07";"EGA"
"EGAS00001005591";"6";"3";"0";"9";"2021-09-08";"EGA"
"EGAS00001005593";"19";"5";"1";"25";"2021-09-11";"EGA"
"EGAS00001005600";"14";"2";"0";"16";"2021-09-14";"EGA"
"EGAS00001005597";"0";"1";"0";"1";"2021-09-14";"EGA"
"EGAS00001005601";"0";"350";"0";"350";"2021-09-14";"EGA"
"EGAS00001005605";"2";"3";"0";"5";"2021-09-16";"EGA"
"EGAS00001005604";"84";"45";"1";"130";"2021-09-16";"EGA"
"EGAS00001005613";"0";"0";"1";"1";"2021-09-21";"EGA"
"EGAS00001005606";"95";"27";"17";"139";"2021-09-21";"EGA"
"EGAS00001005610";"0";"0";"2";"2";"2021-09-21";"EGA"
"EGAS00001005612";"17";"7";"0";"24";"2021-09-21";"EGA"
"EGAS00001005618";"0";"0";"1";"1";"2021-09-22";"EGA"
"EGAS00001005616";"140";"49";"0";"189";"2021-09-22";"EGA"
"EGAS00001005626";"0";"688";"0";"688";"2021-09-24";"EGA"
"EGAS00001005627";"76";"69";"0";"145";"2021-09-24";"EGA"
"EGAS00001005633";"12";"12";"0";"24";"2021-09-29";"EGA"
"EGAS00001005632";"83";"121";"0";"204";"2021-09-29";"EGA"
"EGAS00001005634";"4";"1";"0";"5";"2021-09-30";"EGA"
"EGAS00001005638";"64";"8";"0";"72";"2021-10-01";"EGA"
"EGAS00001005640";"64";"0";"0";"64";"2021-10-01";"EGA"
"EGAS00001005647";"22";"64";"0";"86";"2021-10-02";"EGA"
"EGAS00001005653";"0";"2";"0";"2";"2021-10-05";"EGA"
"EGAS00001005648";"0";"0";"32";"32";"2021-10-05";"EGA"
"EGAS00001005655";"85";"70";"0";"155";"2021-10-06";"EGA"
"EGAS00001005662";"41";"6";"0";"47";"2021-10-07";"EGA"
"EGAS00001005673";"0";"1";"0";"1";"2021-10-16";"EGA"
"EGAS00001005685";"6";"0";"0";"6";"2021-10-19";"EGA"
"EGAS00001005690";"2";"2";"3";"7";"2021-10-20";"EGA"
"EGAS00001005689";"0";"9";"0";"9";"2021-10-20";"EGA"
